//MAP CONVERTED BY dmm2tgm.py THIS HEADER COMMENT PREVENTS RECONVERSION, DO NOT REMOVE
"aa" = (
/turf/template_noop,
/area/template_noop)
"ab" = (
/turf/closed/wall/mineral/titanium,
/area/shuttle/escape)
"ad" = (
/obj/structure/extinguisher_cabinet/directional/north,
/obj/structure/closet,
/obj/effect/turf_decal/trimline/yellow/filled/line{
	dir = 1
	},
/turf/open/floor/iron/edge,
/area/shuttle/escape)
"ae" = (
/obj/structure/closet,
/obj/effect/turf_decal/trimline/yellow/filled/line{
	dir = 1
	},
/turf/open/floor/iron/edge,
/area/shuttle/escape)
"af" = (
/obj/machinery/vending/wallmed/directional/south,
/obj/machinery/computer/operating{
	dir = 1
	},
/obj/effect/turf_decal/trimline/blue/filled/line,
/turf/open/floor/iron/white/smooth_edge{
	dir = 1
	},
/area/shuttle/escape)
"ag" = (
/obj/structure/shuttle/engine/propulsion/right{
	dir = 4
	},
/turf/open/floor/plating/airless,
/area/shuttle/escape)
"ah" = (
/turf/closed/wall/mineral/titanium/nodiagonal,
/area/shuttle/escape)
"al" = (
/obj/structure/chair/fancy/shuttle,
/turf/open/floor/mineral/plastitanium/red/brig,
/area/shuttle/escape)
"an" = (
/obj/effect/turf_decal/tile/yellow/fourcorners,
/turf/open/floor/iron/large,
/area/shuttle/escape)
"ap" = (
/obj/structure/shuttle/engine/propulsion{
	dir = 4
	},
/turf/open/floor/plating/airless,
/area/shuttle/escape)
"aq" = (
/obj/machinery/computer/crew,
/obj/item/radio/intercom/directional/west,
/turf/open/floor/mineral/titanium/blue,
/area/shuttle/escape)
"ar" = (
/obj/structure/chair/fancy/shuttle{
	dir = 8
	},
/turf/open/floor/mineral/titanium,
/area/shuttle/escape)
"at" = (
/turf/open/floor/mineral/plastitanium/red/brig,
/area/shuttle/escape)
"au" = (
/obj/structure/shuttle/engine/propulsion/left{
	dir = 4
	},
/turf/open/floor/plating/airless,
/area/shuttle/escape)
"av" = (
/obj/machinery/computer/communications{
	dir = 1
	},
/turf/open/floor/mineral/titanium/blue,
/area/shuttle/escape)
"aw" = (
/obj/structure/closet/crate/bin,
/obj/item/radio/intercom/directional/south,
/obj/effect/turf_decal/trimline/neutral/filled/line{
	dir = 10
	},
/obj/effect/turf_decal/bot,
/turf/open/floor/iron,
/area/shuttle/escape)
"aB" = (
/obj/item/kirbyplants{
	icon_state = "plant-21"
	},
/turf/open/floor/mineral/titanium,
/area/shuttle/escape)
"aC" = (
/turf/open/floor/mineral/titanium,
/area/shuttle/escape)
"aE" = (
/obj/structure/chair/fancy/shuttle{
	dir = 4
	},
/turf/open/floor/mineral/plastitanium,
/area/shuttle/escape)
"aH" = (
/obj/structure/chair/fancy/shuttle{
	dir = 8
	},
/turf/open/floor/mineral/plastitanium,
/area/shuttle/escape)
"aI" = (
/obj/structure/table,
/obj/item/food/spaghetti/boiledspaghetti{
	name = "pasghetti";
	pixel_x = 4;
	pixel_y = 7
	},
/turf/open/floor/mineral/plastitanium,
/area/shuttle/escape)
"aL" = (
/obj/structure/table,
/turf/open/floor/mineral/plastitanium,
/area/shuttle/escape)
"aM" = (
/obj/structure/table,
/obj/item/food/chocolatebar,
/turf/open/floor/mineral/plastitanium,
/area/shuttle/escape)
"aN" = (
/obj/structure/chair/fancy/shuttle{
	dir = 1
	},
/obj/structure/window/reinforced,
/turf/open/floor/mineral/plastitanium,
/area/shuttle/escape)
"aP" = (
/obj/structure/chair/fancy/shuttle,
/obj/structure/window/reinforced{
	dir = 1
	},
/turf/open/floor/mineral/plastitanium,
/area/shuttle/escape)
"aR" = (
/obj/structure/extinguisher_cabinet/directional/north,
/obj/effect/turf_decal/trimline/blue/filled/line{
	dir = 5
	},
/turf/open/floor/iron/white,
/area/shuttle/escape)
"aS" = (
/obj/structure/chair/fancy/shuttle{
	dir = 1
	},
/turf/open/floor/mineral/plastitanium,
/area/shuttle/escape)
"aT" = (
/obj/machinery/light,
/obj/structure/chair/fancy/shuttle{
	dir = 1
	},
/obj/structure/extinguisher_cabinet/directional/south,
/turf/open/floor/mineral/plastitanium,
/area/shuttle/escape)
"aU" = (
/obj/effect/turf_decal/trimline/blue/filled/line{
	dir = 4
	},
/turf/open/floor/iron/white/smooth_edge{
	dir = 8
	},
/area/shuttle/escape)
"aV" = (
/obj/machinery/vending/cigarette,
/obj/effect/turf_decal/bot,
/turf/open/floor/mineral/titanium,
/area/shuttle/escape)
"aX" = (
/obj/machinery/stasis,
/obj/effect/turf_decal/bot,
/obj/effect/turf_decal/trimline/blue/filled/line,
/obj/machinery/camera/directional/south,
/turf/open/floor/iron/white/smooth_edge{
	dir = 1
	},
/area/shuttle/escape)
"aY" = (
/obj/structure/table/optable,
/obj/item/clothing/gloves/color/latex,
/obj/effect/turf_decal/bot,
/obj/effect/turf_decal/trimline/blue/filled/line{
	dir = 6
	},
/turf/open/floor/iron/white,
/area/shuttle/escape)
"bS" = (
/obj/structure/chair/fancy/shuttle,
/turf/open/floor/mineral/plastitanium,
/area/shuttle/escape)
"cM" = (
/obj/effect/turf_decal/trimline/neutral/filled/line{
	dir = 1
	},
/obj/machinery/light/small{
	dir = 1
	},
/turf/open/floor/iron/edge,
/area/shuttle/escape)
"eF" = (
/obj/effect/turf_decal/trimline/neutral/filled/warning{
	dir = 1
	},
/turf/open/floor/iron/edge,
/area/shuttle/escape)
"ho" = (
/obj/machinery/door/airlock/security/glass{
	name = "security Airlock";
	req_access_txt = "63"
	},
/obj/machinery/door/firedoor,
/obj/effect/turf_decal/stripes/closeup,
/turf/open/floor/iron,
/area/shuttle/escape)
"hK" = (
/obj/machinery/vending/sustenance,
/obj/effect/turf_decal/bot,
/turf/open/floor/mineral/titanium,
/area/shuttle/escape)
"im" = (
/obj/machinery/computer/secure_data{
	dir = 4
	},
/turf/open/floor/mineral/plastitanium/red/brig,
/area/shuttle/escape)
"ip" = (
/obj/machinery/holopad,
/obj/effect/turf_decal/box,
/turf/open/floor/mineral/titanium,
/area/shuttle/escape)
"iH" = (
/obj/effect/turf_decal/tile/neutral/fourcorners,
/obj/machinery/ai_slipper,
/turf/open/floor/iron/large,
/area/shuttle/escape)
"jz" = (
/obj/machinery/iv_drip,
/obj/structure/bed/roller,
/obj/effect/turf_decal/trimline/neutral/filled/line,
/turf/open/floor/iron/edge{
	dir = 1
	},
/area/shuttle/escape)
"jD" = (
/obj/machinery/button/flasher{
	id = "cockpit_flasher";
	pixel_x = 25;
	pixel_y = -25
	},
/turf/open/floor/mineral/titanium,
/area/shuttle/escape)
"jP" = (
/mob/living/simple_animal/bot/medbot{
	name = "\improper emergency medibot";
	pixel_x = -3;
	pixel_y = 2
	},
/obj/effect/turf_decal/trimline/yellow/filled/line{
	dir = 4
	},
/turf/open/floor/iron/edge{
	dir = 8
	},
/area/shuttle/escape)
"kh" = (
/obj/effect/turf_decal/trimline/neutral/filled/warning{
	dir = 8
	},
/turf/open/floor/iron/edge{
	dir = 4
	},
/area/shuttle/escape)
"li" = (
/obj/structure/table,
/obj/item/hemostat,
/obj/item/scalpel,
/obj/item/cautery,
/obj/item/surgical_drapes,
/obj/effect/turf_decal/trimline/blue/filled/line{
	dir = 10
	},
/turf/open/floor/iron/white,
/area/shuttle/escape)
"lL" = (
/turf/closed/wall/mineral/titanium,
/area/template_noop)
"lO" = (
/obj/effect/turf_decal/trimline/neutral/filled/warning{
	dir = 4
	},
/turf/open/floor/iron/edge{
	dir = 8
	},
/area/shuttle/escape)
"mk" = (
/obj/effect/turf_decal/trimline/yellow/filled/line{
	dir = 10
	},
/turf/open/floor/iron,
/area/shuttle/escape)
"mM" = (
/obj/effect/turf_decal/trimline/neutral/filled/line{
	dir = 5
	},
/turf/open/floor/iron,
/area/shuttle/escape)
"oq" = (
/obj/structure/chair/fancy/shuttle,
/turf/open/floor/mineral/titanium/blue,
/area/shuttle/escape)
"ow" = (
/obj/effect/turf_decal/trimline/yellow/filled/line{
	dir = 8
	},
/turf/open/floor/iron/edge{
	dir = 4
	},
/area/shuttle/escape)
"ra" = (
/obj/machinery/ai_slipper,
/turf/open/floor/mineral/titanium,
/area/shuttle/escape)
"ru" = (
/obj/machinery/firealarm/directional/east,
/obj/machinery/camera/directional/east,
/turf/open/floor/mineral/titanium,
/area/shuttle/escape)
"st" = (
/obj/effect/turf_decal/trimline/neutral/filled/warning,
/turf/open/floor/iron/edge{
	dir = 1
	},
/area/shuttle/escape)
"sK" = (
/obj/machinery/ai_slipper,
/turf/open/floor/mineral/plastitanium/red/brig,
/area/shuttle/escape)
"sR" = (
/obj/effect/turf_decal/trimline/yellow/filled/line{
	dir = 6
	},
/turf/open/floor/iron,
/area/shuttle/escape)
"ta" = (
/obj/machinery/light{
	dir = 1
	},
/turf/open/floor/mineral/titanium,
/area/shuttle/escape)
"uP" = (
/obj/effect/turf_decal/tile/blue/fourcorners,
/obj/machinery/holopad,
/obj/effect/turf_decal/box,
/turf/open/floor/iron/white/smooth_large,
/area/shuttle/escape)
"vj" = (
/obj/machinery/holopad,
/obj/effect/turf_decal/box,
/turf/open/floor/mineral/plastitanium/red/brig,
/area/shuttle/escape)
"vv" = (
/obj/structure/chair/fancy/shuttle,
/obj/machinery/camera/directional/north,
/turf/open/floor/mineral/plastitanium,
/area/shuttle/escape)
"vW" = (
/obj/structure/chair/fancy/shuttle{
	dir = 4
	},
/turf/open/floor/mineral/titanium,
/area/shuttle/escape)
"wJ" = (
/obj/effect/turf_decal/tile/neutral/fourcorners,
/obj/machinery/holopad,
/obj/effect/turf_decal/box,
/turf/open/floor/iron/large,
/area/shuttle/escape)
"xz" = (
/obj/machinery/door/airlock/public/glass,
/obj/machinery/door/firedoor,
/obj/effect/turf_decal/stripes/closeup{
	dir = 1
	},
/turf/open/floor/iron,
/area/shuttle/escape)
"xQ" = (
/obj/structure/shuttle/engine/heater{
	dir = 8
	},
/obj/effect/spawner/structure/window/shuttle,
/obj/machinery/door/firedoor/window,
/turf/open/floor/plating/airless,
/area/shuttle/escape)
"xV" = (
/obj/structure/chair/fancy/shuttle{
	dir = 1
	},
/obj/structure/extinguisher_cabinet/directional/east,
/turf/open/floor/mineral/plastitanium/red/brig,
/area/shuttle/escape)
"zf" = (
/obj/structure/table,
/turf/open/floor/mineral/titanium,
/area/shuttle/escape)
"zs" = (
/obj/item/kirbyplants{
	icon_state = "plant-21"
	},
/obj/item/radio/intercom/directional/west,
/turf/open/floor/mineral/titanium,
/area/shuttle/escape)
"AT" = (
/obj/structure/chair/fancy/shuttle,
/obj/machinery/camera/directional/east,
/turf/open/floor/mineral/plastitanium/red/brig,
/area/shuttle/escape)
"Bm" = (
/obj/effect/turf_decal/trimline/blue/filled/warning{
	dir = 1
	},
/turf/open/floor/iron/white/smooth_edge,
/area/shuttle/escape)
"DU" = (
/obj/structure/closet/firecloset,
/obj/effect/turf_decal/bot,
/obj/effect/turf_decal/trimline/neutral/filled/line{
	dir = 9
	},
/obj/machinery/camera/directional/north,
/turf/open/floor/iron,
/area/shuttle/escape)
"Eg" = (
/obj/structure/closet/emcloset,
/obj/effect/turf_decal/bot,
/obj/effect/turf_decal/trimline/neutral/filled/line{
	dir = 1
	},
/turf/open/floor/iron/edge,
/area/shuttle/escape)
"EQ" = (
/obj/structure/chair/fancy/shuttle{
	dir = 1
	},
/turf/open/floor/mineral/plastitanium/red/brig,
/area/shuttle/escape)
"Fg" = (
/obj/structure/chair/fancy/shuttle,
/obj/item/radio/intercom/directional/north,
/turf/open/floor/mineral/plastitanium/red/brig,
/area/shuttle/escape)
"FV" = (
/obj/effect/turf_decal/trimline/yellow/filled/warning,
/turf/open/floor/iron/edge{
	dir = 1
	},
/area/shuttle/escape)
"GP" = (
/obj/effect/turf_decal/tile/neutral/fourcorners,
/turf/open/floor/iron/large,
/area/shuttle/escape)
"Hy" = (
/obj/machinery/computer/crew{
	dir = 4
	},
/obj/item/radio/intercom/directional/north,
/obj/effect/turf_decal/trimline/blue/filled/line{
	dir = 9
	},
/turf/open/floor/iron/white,
/area/shuttle/escape)
"HU" = (
/obj/item/radio/intercom/directional/east,
/turf/open/floor/mineral/titanium,
/area/shuttle/escape)
"Ke" = (
/obj/structure/table,
/obj/item/storage/fancy/donut_box,
/turf/open/floor/mineral/titanium,
/area/shuttle/escape)
"Kr" = (
/obj/structure/table,
/obj/structure/extinguisher_cabinet/directional/west,
/turf/open/floor/mineral/plastitanium,
/area/shuttle/escape)
"KB" = (
/obj/machinery/flasher{
	id = "cockpit_flasher";
	pixel_x = 25;
	pixel_y = 25
	},
/turf/open/floor/mineral/titanium,
/area/shuttle/escape)
"KP" = (
/obj/structure/closet/crate/bin,
/obj/effect/turf_decal/bot,
/turf/open/floor/mineral/titanium,
/area/shuttle/escape)
"Lz" = (
/obj/effect/turf_decal/trimline/neutral/filled/line{
	dir = 6
	},
/turf/open/floor/iron,
/area/shuttle/escape)
"Mg" = (
/obj/machinery/door/airlock/titanium,
/obj/docking_port/mobile/emergency{
	dir = 8;
	dwidth = 6;
	height = 18;
	name = "Birdboat emergency escape shuttle";
	port_direction = 4;
	width = 14
	},
/obj/machinery/door/firedoor,
/obj/effect/turf_decal/stripes/closeup{
	dir = 1
	},
/obj/structure/fans/tiny,
/turf/open/floor/iron/white,
/area/shuttle/escape)
"Ml" = (
/obj/machinery/door/airlock/public/glass,
/obj/machinery/door/firedoor,
/obj/effect/turf_decal/stripes/closeup,
/turf/open/floor/iron,
/area/shuttle/escape)
"MM" = (
/obj/item/kirbyplants{
	icon_state = "plant-22"
	},
/turf/open/floor/mineral/titanium,
/area/shuttle/escape)
"MN" = (
/obj/effect/spawner/structure/window/shuttle,
/obj/machinery/door/firedoor/window,
/turf/open/floor/plating,
/area/shuttle/escape)
"Nj" = (
/obj/effect/turf_decal/trimline/blue/filled/line{
	dir = 1
	},
/turf/open/floor/iron/white/smooth_edge,
/area/shuttle/escape)
"Nl" = (
/obj/machinery/light{
	dir = 4
	},
/obj/structure/reagent_dispensers/peppertank/directional/east,
/turf/open/floor/mineral/plastitanium/red/brig,
/area/shuttle/escape)
"Ok" = (
/obj/structure/table,
/obj/machinery/recharger{
	active_power_usage = 0;
	idle_power_usage = 0;
	pixel_y = 4;
	use_power = 0
	},
/obj/item/restraints/handcuffs{
	pixel_y = 3
	},
/turf/open/floor/mineral/plastitanium/red/brig,
/area/shuttle/escape)
"OU" = (
/obj/machinery/computer/security{
	dir = 4
	},
/turf/open/floor/mineral/plastitanium/red/brig,
/area/shuttle/escape)
"PJ" = (
/obj/effect/turf_decal/trimline/neutral/filled/line,
/obj/machinery/light/small,
/turf/open/floor/iron/edge{
	dir = 1
	},
/area/shuttle/escape)
"QI" = (
/obj/item/storage/firstaid/fire{
	pixel_x = 5;
	pixel_y = 5
	},
/obj/item/storage/firstaid/brute,
/obj/structure/table,
/obj/effect/turf_decal/trimline/blue/filled/line{
	dir = 8
	},
/turf/open/floor/iron/white/smooth_edge{
	dir = 4
	},
/area/shuttle/escape)
"Re" = (
/obj/machinery/light{
	dir = 4
	},
/obj/structure/chair/fancy/shuttle{
	dir = 8
	},
/obj/structure/extinguisher_cabinet/directional/east,
/turf/open/floor/mineral/titanium,
/area/shuttle/escape)
"RD" = (
/obj/machinery/door/airlock/command/glass{
	name = "bridge Door";
	req_access_txt = "19"
	},
/obj/machinery/door/firedoor,
/obj/effect/turf_decal/stripes/closeup,
/turf/open/floor/iron,
/area/shuttle/escape)
"SQ" = (
/obj/effect/turf_decal/tile/blue/fourcorners,
/obj/machinery/ai_slipper,
/turf/open/floor/iron/white/smooth_large,
/area/shuttle/escape)
"Tf" = (
/obj/effect/turf_decal/tile/yellow/fourcorners,
/obj/machinery/ai_slipper,
/turf/open/floor/iron/large,
/area/shuttle/escape)
"Ti" = (
/obj/machinery/door/airlock/titanium,
/obj/machinery/door/firedoor,
/obj/effect/turf_decal/stripes/closeup{
	dir = 1
	},
/obj/structure/fans/tiny,
/turf/open/floor/iron/white,
/area/shuttle/escape)
"UE" = (
/obj/machinery/computer/emergency_shuttle{
	dir = 1
	},
/turf/open/floor/mineral/titanium/blue,
/area/shuttle/escape)
"Vg" = (
/obj/effect/spawner/structure/window/shuttle,
/obj/machinery/door/firedoor/window,
/turf/open/floor/plating,
/area/template_noop)
"Yo" = (
/obj/structure/closet/crate,
/obj/effect/turf_decal/trimline/yellow/filled/line{
	dir = 9
	},
/turf/open/floor/iron,
/area/shuttle/escape)
"YX" = (
/obj/item/radio/intercom/directional/south,
/obj/effect/turf_decal/trimline/yellow/filled/line,
/turf/open/floor/iron/edge{
	dir = 1
	},
/area/shuttle/escape)
"ZR" = (
/obj/structure/closet/crate/medical,
/obj/item/storage/firstaid/regular,
/obj/item/storage/firstaid/o2{
	pixel_x = 3;
	pixel_y = 3
	},
/obj/item/storage/firstaid/toxin{
	pixel_x = -4;
	pixel_y = 3
	},
/obj/item/healthanalyzer{
	pixel_x = 3;
	pixel_y = 3
	},
/obj/item/lazarus_injector,
/obj/effect/turf_decal/trimline/yellow/filled/line{
	dir = 5
	},
/turf/open/floor/iron,
/area/shuttle/escape)

(1,1,1) = {"
aa
aa
ab
ab
MN
MN
ab
MN
MN
MN
ab
ab
aa
aa
"}
(2,1,1) = {"
aa
ab
ah
aq
oq
UE
ab
bS
aL
aS
zs
ah
ab
aa
"}
(3,1,1) = {"
aa
ab
vW
vW
ra
av
MN
bS
aL
aS
aC
aS
ab
aa
"}
(4,1,1) = {"
aa
MN
zf
Ke
ip
jD
RD
KB
aC
ra
aC
aS
MN
aa
"}
(5,1,1) = {"
aa
MN
ar
Re
ru
MM
ab
ta
aC
aC
aC
aS
MN
aa
"}
(6,1,1) = {"
lL
ab
ab
ab
ab
MN
ah
aE
aM
aC
aC
aT
ah
ab
"}
(7,1,1) = {"
lL
Ok
im
OU
ab
aB
Kr
aL
aI
aC
aC
aC
hK
ab
"}
(8,1,1) = {"
lL
Fg
sK
at
MN
KP
aC
aC
aC
aC
aC
aC
aV
ab
"}
(9,1,1) = {"
Vg
al
at
at
ho
aC
aC
ip
aC
ra
aC
aE
aE
MN
"}
(10,1,1) = {"
Vg
al
vj
EQ
MN
bS
aC
aC
aN
aP
aC
aL
aL
MN
"}
(11,1,1) = {"
Vg
AT
Nl
xV
ab
vv
aC
aC
aN
aP
HU
aH
aH
MN
"}
(12,1,1) = {"
lL
ab
ab
ab
ab
ab
xz
xz
ab
ab
ab
MN
ab
ab
"}
(13,1,1) = {"
ab
Yo
ow
mk
ab
DU
kh
kh
aw
ab
Hy
QI
li
ab
"}
(14,1,1) = {"
ab
ad
an
YX
ab
Eg
GP
GP
jz
MN
Nj
uP
aX
ab
"}
(15,1,1) = {"
ab
ae
Tf
FV
Ml
eF
iH
wJ
st
Ml
Bm
SQ
af
ab
"}
(16,1,1) = {"
ab
ZR
jP
sR
ab
cM
GP
GP
PJ
ab
aR
aU
aY
ab
"}
(17,1,1) = {"
ab
xQ
xQ
xQ
ab
mM
lO
lO
Lz
ab
xQ
xQ
xQ
ab
"}
(18,1,1) = {"
ab
ag
ap
au
ab
ab
Ti
Mg
ab
ab
ag
ap
au
ab
"}
