//MAP CONVERTED BY dmm2tgm.py THIS HEADER COMMENT PREVENTS RECONVERSION, DO NOT REMOVE
"aa" = (
/turf/template_noop,
/area/template_noop)
"ab" = (
/turf/closed/wall/mineral/titanium,
/area/shuttle/escape)
"ai" = (
/obj/structure/sign/warning/biohazard,
/turf/closed/wall/mineral/titanium,
/area/shuttle/escape)
"ak" = (
/obj/structure/chair/fancy/shuttle{
	dir = 4
	},
/turf/open/floor/mineral/plastitanium/red/brig,
/area/shuttle/escape)
"al" = (
/turf/open/floor/mineral/plastitanium/red/brig,
/area/shuttle/escape)
"am" = (
/obj/structure/chair/fancy/shuttle{
	dir = 8
	},
/turf/open/floor/mineral/plastitanium/red/brig,
/area/shuttle/escape)
"an" = (
/obj/structure/table/wood,
/obj/item/candle/infinite,
/turf/open/floor/cult,
/area/shuttle/escape)
"ao" = (
/obj/structure/barricade/wooden,
/turf/open/floor/cult,
/area/shuttle/escape)
"ap" = (
/turf/open/floor/cult,
/area/shuttle/escape)
"aq" = (
/turf/open/floor/mineral/titanium,
/area/shuttle/escape)
"ar" = (
/obj/structure/table,
/obj/item/storage/firstaid/fire,
/obj/item/storage/firstaid/regular{
	pixel_x = 2;
	pixel_y = 3
	},
/obj/item/crowbar,
/turf/open/floor/mineral/titanium,
/area/shuttle/escape)
"as" = (
/obj/effect/spawner/structure/window/reinforced/shuttle,
/turf/open/floor/plating,
/area/shuttle/escape)
"at" = (
/obj/machinery/flasher{
	id = "shuttle_flasher";
	pixel_x = -24;
	pixel_y = 6
	},
/obj/machinery/button/flasher{
	id = "shuttle_flasher";
	pixel_x = -24;
	pixel_y = -6
	},
/obj/structure/chair/fancy/shuttle{
	dir = 4
	},
/turf/open/floor/mineral/plastitanium/red/brig,
/area/shuttle/escape)
"au" = (
/obj/structure/chair/wood,
/turf/open/floor/cult,
/area/shuttle/escape)
"av" = (
/obj/structure/chair/fancy/shuttle,
/turf/open/floor/mineral/titanium,
/area/shuttle/escape)
"aw" = (
/obj/structure/chair/fancy/shuttle{
	dir = 8
	},
/turf/open/floor/mineral/titanium,
/area/shuttle/escape)
"ay" = (
/obj/structure/table,
/obj/item/paper_bin,
/obj/item/pen{
	pixel_x = -2;
	pixel_y = 4
	},
/turf/open/floor/mineral/titanium,
/area/shuttle/escape)
"az" = (
/obj/machinery/computer/emergency_shuttle{
	dir = 1
	},
/turf/open/floor/mineral/titanium,
/area/shuttle/escape)
"aA" = (
/obj/structure/table,
/obj/item/coin/mythril,
/turf/open/floor/mineral/titanium,
/area/shuttle/escape)
"aF" = (
/obj/machinery/door/window/eastleft,
/turf/open/floor/mineral/titanium,
/area/shuttle/escape)
"aG" = (
/obj/structure/extinguisher_cabinet{
	pixel_x = 27
	},
/obj/structure/table/glass,
/obj/item/storage/box/syringes{
	pixel_x = 3;
	pixel_y = 3
	},
/obj/item/storage/box/beakers,
/turf/open/floor/mineral/titanium/white,
/area/shuttle/escape)
"aH" = (
/obj/machinery/status_display/evac,
/turf/closed/wall/mineral/titanium,
/area/shuttle/escape)
"aI" = (
/obj/structure/chair/fancy/shuttle{
	dir = 4
	},
/turf/open/floor/mineral/titanium/blue,
/area/shuttle/escape)
"aJ" = (
/obj/structure/chair/fancy/shuttle{
	dir = 8
	},
/obj/structure/window/reinforced/spawner/directional/east,
/turf/open/floor/mineral/titanium/blue,
/area/shuttle/escape)
"aK" = (
/obj/machinery/stasis,
/turf/open/floor/mineral/titanium/white,
/area/shuttle/escape)
"aL" = (
/obj/structure/table/reinforced,
/turf/open/floor/mineral/titanium,
/area/shuttle/escape)
"aM" = (
/obj/machinery/chem_dispenser,
/obj/machinery/light/small{
	dir = 4
	},
/turf/open/floor/mineral/titanium/white,
/area/shuttle/escape)
"aN" = (
/obj/structure/table,
/obj/item/storage/toolbox/mechanical,
/obj/item/storage/firstaid/regular{
	pixel_x = -1;
	pixel_y = 1
	},
/obj/item/wrench/medical,
/turf/open/floor/mineral/titanium/white,
/area/shuttle/escape)
"aO" = (
/turf/open/floor/plating,
/area/shuttle/escape)
"aP" = (
/obj/structure/chair/office/light{
	dir = 8
	},
/turf/open/floor/mineral/titanium,
/area/shuttle/escape)
"aQ" = (
/obj/machinery/chem_heater,
/turf/open/floor/mineral/titanium/white,
/area/shuttle/escape)
"aR" = (
/obj/machinery/chem_master,
/turf/open/floor/mineral/titanium/white,
/area/shuttle/escape)
"aS" = (
/obj/machinery/door/window/eastright,
/turf/open/floor/mineral/titanium,
/area/shuttle/escape)
"aT" = (
/obj/structure/table/glass,
/obj/item/reagent_containers/cup/bottle/epinephrine{
	pixel_x = 2;
	pixel_y = 2
	},
/obj/item/reagent_containers/cup/bottle/charcoal,
/turf/open/floor/mineral/titanium/white,
/area/shuttle/escape)
"be" = (
/obj/structure/window/reinforced/spawner/directional/north{
	resistance_flags = 33
	},
/turf/open/lava/smooth/airless,
/area/shuttle/escape)
"bf" = (
/obj/structure/shuttle/engine/heater,
/turf/open/lava/smooth/airless,
/area/shuttle/escape)
"bg" = (
/obj/structure/shuttle/engine/propulsion,
/turf/open/floor/plating/airless,
/area/shuttle/escape)
"bj" = (
/obj/machinery/light/small{
	dir = 1
	},
/turf/open/floor/mineral/plastitanium/red/brig,
/area/shuttle/escape)
"bk" = (
/obj/structure/chair/wood,
/obj/machinery/light{
	dir = 8
	},
/turf/open/floor/cult,
/area/shuttle/escape)
"bl" = (
/obj/machinery/light{
	dir = 1
	},
/turf/open/floor/mineral/titanium,
/area/shuttle/escape)
"bm" = (
/obj/structure/chair/fancy/shuttle{
	dir = 4
	},
/obj/machinery/light/small{
	dir = 8
	},
/turf/open/floor/mineral/titanium/blue,
/area/shuttle/escape)
"bn" = (
/obj/machinery/light,
/turf/open/floor/mineral/titanium,
/area/shuttle/escape)
"bo" = (
/obj/structure/chair/fancy/shuttle{
	dir = 4
	},
/obj/machinery/light/small{
	brightness = 3;
	dir = 8
	},
/turf/open/floor/mineral/titanium/blue,
/area/shuttle/escape)
"bp" = (
/obj/machinery/light/small{
	dir = 4
	},
/turf/open/floor/mineral/titanium,
/area/shuttle/escape)
"bK" = (
/obj/machinery/door/airlock/public/glass{
	name = "Emergency Shuttle Brig";
	req_access_txt = "2"
	},
/obj/machinery/door/firedoor,
/turf/open/floor/mineral/plastitanium/red/brig,
/area/shuttle/escape)
"dm" = (
/obj/machinery/light,
/obj/effect/turf_decal/tile/green/fourcorners/contrasted,
/turf/open/floor/iron/dark,
/area/shuttle/escape)
"dV" = (
/obj/effect/turf_decal/stripes/line{
	dir = 9
	},
/obj/effect/turf_decal/tile/red/fourcorners/contrasted,
/turf/open/floor/iron/white,
/area/shuttle/escape)
"dW" = (
/obj/structure/table/abductor/wabbajack/right,
/obj/effect/turf_decal/tile/green/fourcorners/contrasted,
/turf/open/floor/iron/dark,
/area/shuttle/escape)
"el" = (
/obj/machinery/door/airlock/titanium,
/obj/machinery/door/firedoor,
/turf/open/floor/mineral/titanium,
/area/shuttle/escape)
"ft" = (
/obj/structure/grille,
/obj/structure/window/shuttle/tinted,
/turf/open/floor/plating,
/area/shuttle/escape)
"ji" = (
/obj/structure/chair/fancy/shuttle{
	dir = 8
	},
/turf/open/floor/mineral/titanium/blue,
/area/shuttle/escape)
"kt" = (
/obj/effect/turf_decal/stripes/line{
	dir = 8
	},
/obj/effect/turf_decal/tile/red/fourcorners/contrasted,
/turf/open/floor/iron/white,
/area/shuttle/escape)
"kv" = (
/obj/effect/turf_decal/stripes/line{
	dir = 4
	},
/obj/effect/turf_decal/tile/yellow/fourcorners/contrasted,
/turf/open/floor/iron,
/area/shuttle/escape)
"nX" = (
/obj/effect/turf_decal/stripes/line{
	dir = 1
	},
/obj/effect/turf_decal/tile/red/fourcorners/contrasted,
/turf/open/floor/iron/white,
/area/shuttle/escape)
"oh" = (
/obj/machinery/door/airlock/titanium{
	name = "Emergency Shuttle Airlock"
	},
/obj/structure/fans/tiny,
/turf/open/floor/plating,
/area/shuttle/escape)
"rT" = (
/obj/machinery/power/emitter/energycannon/magical,
/obj/effect/turf_decal/tile/green/fourcorners/contrasted,
/turf/open/floor/iron/dark,
/area/shuttle/escape)
"tN" = (
/obj/effect/turf_decal/tile/green/fourcorners/contrasted,
/turf/open/floor/iron,
/area/shuttle/escape)
"uR" = (
/obj/structure/barricade/wooden,
/obj/machinery/door/airlock/titanium,
/obj/machinery/door/firedoor,
/turf/open/floor/cult,
/area/shuttle/escape)
"wf" = (
/obj/effect/turf_decal/stripes/line{
	dir = 1
	},
/obj/effect/turf_decal/tile/yellow/fourcorners/contrasted,
/turf/open/floor/iron,
/area/shuttle/escape)
"AO" = (
/obj/machinery/door/airlock/titanium{
	name = "Emergency Shuttle Airlock";
	req_access_txt = "2"
	},
/obj/structure/fans/tiny,
/turf/open/floor/plating,
/area/shuttle/escape)
"Ec" = (
/obj/structure/chair/fancy/shuttle{
	dir = 8
	},
/obj/structure/window/reinforced/spawner/directional/east,
/turf/open/floor/mineral/titanium/white,
/area/shuttle/escape)
"EC" = (
/obj/structure/destructible/cult/forge{
	desc = "An engine used in powering the shuttle.";
	name = "magma engine"
	},
/obj/effect/turf_decal/tile/yellow/fourcorners/contrasted,
/turf/open/floor/iron,
/area/shuttle/escape)
"Hm" = (
/obj/effect/turf_decal/tile/green/fourcorners/contrasted,
/turf/open/floor/iron/dark,
/area/shuttle/escape)
"Jj" = (
/obj/structure/destructible/cult/forge{
	desc = "An engine used in powering the shuttle.";
	name = "magma engine"
	},
/obj/effect/turf_decal/tile/red/fourcorners/contrasted,
/turf/open/floor/iron/white,
/area/shuttle/escape)
"JM" = (
/obj/machinery/door/airlock/titanium{
	name = "Emergency Shuttle Airlock"
	},
/obj/docking_port/mobile/emergency{
	name = "NT Lepton Violet"
	},
/obj/structure/fans/tiny,
/turf/open/floor/plating,
/area/shuttle/escape)
"MK" = (
/obj/structure/chair/fancy/shuttle,
/turf/open/floor/mineral/titanium/blue,
/area/shuttle/escape)
"Re" = (
/obj/machinery/door/airlock/public/glass,
/obj/machinery/door/firedoor,
/turf/open/floor/mineral/titanium,
/area/shuttle/escape)
"Uk" = (
/obj/effect/turf_decal/stripes/line{
	dir = 5
	},
/obj/effect/turf_decal/tile/yellow/fourcorners/contrasted,
/turf/open/floor/iron,
/area/shuttle/escape)
"Vj" = (
/obj/structure/table/abductor/wabbajack/left,
/obj/effect/turf_decal/tile/green/fourcorners/contrasted,
/turf/open/floor/iron/dark,
/area/shuttle/escape)

(1,1,1) = {"
aa
aa
aa
aa
ab
ab
ab
AO
ab
JM
ab
as
as
as
ab
oh
ab
oh
ab
ab
ab
aa
"}
(2,1,1) = {"
aa
ab
ab
ab
ab
ak
at
al
as
aq
bm
aI
aI
aq
ab
aq
bo
wf
EC
be
ab
ab
"}
(3,1,1) = {"
ab
ab
Vj
Hm
ab
bj
al
al
bK
aq
aq
aq
aq
aq
ab
aq
aq
Uk
kv
be
bf
bg
"}
(4,1,1) = {"
ft
tN
Hm
tN
ab
am
am
am
as
aq
aJ
aJ
aJ
aq
Re
aq
aq
aq
aq
be
bf
bg
"}
(5,1,1) = {"
ft
Hm
tN
Hm
ab
ab
ab
ab
ab
aq
aK
aN
aK
aq
ab
ji
ji
ji
ji
be
bf
bg
"}
(6,1,1) = {"
ft
rT
tN
dm
ai
an
bk
ay
ab
bl
aq
aq
aq
bn
aH
ab
ab
ab
ab
be
bf
bg
"}
(7,1,1) = {"
ft
Hm
tN
Hm
uR
ao
au
az
ab
aF
Ec
aq
Ec
aS
as
aI
aI
aI
aI
be
bf
bg
"}
(8,1,1) = {"
ft
tN
Hm
tN
ai
ap
av
aA
ab
aq
aL
aO
aL
aq
Re
aq
aq
aq
aq
be
bf
bg
"}
(9,1,1) = {"
ab
ab
dW
Hm
aH
aq
aq
aq
el
aq
aq
aP
aq
aq
as
MK
aq
dV
kt
be
bf
bg
"}
(10,1,1) = {"
aa
ab
ab
ab
ab
ar
aw
aw
ab
aG
aM
aQ
aR
aT
as
MK
bp
nX
Jj
be
ab
ab
"}
(11,1,1) = {"
aa
aa
aa
aa
ab
as
ab
as
ab
ab
ab
as
as
as
ab
ab
ab
as
ab
ab
ab
aa
"}
