//MAP CONVERTED BY dmm2tgm.py THIS HEADER COMMENT PREVENTS RECONVERSION, DO NOT REMOVE
"at" = (
/obj/structure/chair/fancy/shuttle{
	dir = 4
	},
/obj/effect/turf_decal/siding/dark_blue{
	dir = 10
	},
/turf/open/floor/mineral/plastitanium,
/area/shuttle/escape)
"bM" = (
/obj/machinery/door/airlock/security/glass{
	name = "Brig";
	req_access_txt = "2"
	},
/obj/effect/turf_decal/stripes/line{
	dir = 8
	},
/obj/effect/turf_decal/stripes/line{
	dir = 4
	},
/obj/machinery/door/firedoor,
/turf/open/floor/iron,
/area/shuttle/escape)
"ct" = (
/obj/effect/turf_decal/tile/dark_blue/fourcorners/contrasted,
/obj/effect/turf_decal/box,
/obj/machinery/holopad,
/turf/open/floor/iron/smooth,
/area/shuttle/escape)
"cY" = (
/obj/structure/window/reinforced{
	dir = 1
	},
/obj/structure/closet/crate/freezer/surplus_limbs,
/obj/effect/turf_decal/tile/blue/fourcorners,
/turf/open/floor/iron/white/smooth_large,
/area/shuttle/escape)
"dr" = (
/obj/machinery/shieldgen,
/turf/open/floor/mineral/plastitanium/red/brig,
/area/shuttle/escape)
"dP" = (
/obj/structure/chair/fancy/shuttle{
	dir = 8
	},
/obj/effect/turf_decal/tile/dark/fourcorners/contrasted,
/obj/effect/turf_decal/siding/thinplating_new{
	dir = 10
	},
/turf/open/floor/iron/white,
/area/shuttle/escape)
"ee" = (
/obj/effect/turf_decal/stripes/line{
	dir = 4
	},
/obj/effect/turf_decal/stripes/line{
	dir = 8
	},
/obj/machinery/door/airlock/command{
	name = "Cockpit";
	req_access_txt = "19"
	},
/obj/machinery/door/firedoor,
/turf/open/floor/mineral/plastitanium,
/area/shuttle/escape)
"eX" = (
/obj/structure/table/reinforced,
/obj/item/storage/firstaid/regular{
	pixel_x = 2;
	pixel_y = 3
	},
/obj/item/storage/firstaid/random,
/obj/item/crowbar,
/obj/effect/turf_decal/siding/dark_blue{
	dir = 8
	},
/turf/open/floor/mineral/plastitanium,
/area/shuttle/escape)
"fc" = (
/obj/structure/table/reinforced,
/obj/item/storage/firstaid{
	pixel_x = 3;
	pixel_y = 3
	},
/obj/effect/turf_decal/tile/blue/fourcorners,
/turf/open/floor/iron/white/smooth_large,
/area/shuttle/escape)
"fI" = (
/turf/template_noop,
/area/shuttle/escape)
"ga" = (
/obj/effect/turf_decal/caution/stand_clear/white{
	color = "#408fb8";
	dir = 8
	},
/obj/effect/turf_decal/trimline/blue/filled/warning{
	dir = 8
	},
/turf/open/floor/iron/white/smooth_large,
/area/shuttle/escape)
"gh" = (
/obj/effect/turf_decal/tile/dark_blue/fourcorners/contrasted,
/turf/open/floor/iron/smooth,
/area/shuttle/escape)
"gk" = (
/obj/effect/turf_decal/tile/dark/fourcorners/contrasted,
/obj/structure/closet/firecloset,
/obj/effect/turf_decal/siding/thinplating_new{
	dir = 1
	},
/turf/open/floor/iron/white,
/area/shuttle/escape)
"gP" = (
/obj/effect/turf_decal/tile/dark/fourcorners/contrasted,
/obj/structure/closet/emcloset,
/obj/effect/turf_decal/siding/thinplating_new{
	dir = 1
	},
/turf/open/floor/iron/white,
/area/shuttle/escape)
"gX" = (
/obj/machinery/newscaster/directional/south,
/obj/effect/turf_decal/siding/dark_blue/corner{
	dir = 4
	},
/obj/structure/table/reinforced,
/obj/item/paper_bin,
/obj/item/pen,
/turf/open/floor/mineral/plastitanium,
/area/shuttle/escape)
"hb" = (
/obj/structure/table/optable,
/obj/item/storage/backpack/duffelbag/med/surgery{
	pixel_y = 7
	},
/obj/effect/turf_decal/box,
/obj/effect/turf_decal/tile/blue/fourcorners,
/turf/open/floor/iron/white/textured_large,
/area/shuttle/escape)
"hu" = (
/obj/structure/chair/fancy/shuttle{
	dir = 4
	},
/obj/structure/reagent_dispensers/peppertank/directional/west,
/obj/machinery/light{
	dir = 1
	},
/turf/open/floor/mineral/plastitanium/red/brig,
/area/shuttle/escape)
"hG" = (
/obj/machinery/stasis,
/obj/effect/turf_decal/bot,
/obj/effect/turf_decal/tile/blue/fourcorners,
/turf/open/floor/iron/white/smooth_large,
/area/shuttle/escape)
"hQ" = (
/obj/structure/chair/fancy/shuttle{
	dir = 8
	},
/obj/effect/turf_decal/siding/dark_blue{
	dir = 6
	},
/turf/open/floor/mineral/plastitanium,
/area/shuttle/escape)
"iS" = (
/obj/machinery/status_display/evac/directional/north,
/obj/machinery/shieldgen,
/obj/effect/turf_decal/siding/dark_blue{
	dir = 4
	},
/obj/machinery/firealarm/directional/west,
/turf/open/floor/mineral/plastitanium,
/area/shuttle/escape)
"jl" = (
/obj/machinery/camera/directional/south,
/obj/structure/extinguisher_cabinet/directional/south,
/obj/structure/chair/fancy/shuttle{
	dir = 1
	},
/obj/effect/turf_decal/siding/dark_blue{
	dir = 1
	},
/turf/open/floor/mineral/plastitanium,
/area/shuttle/escape)
"kg" = (
/obj/effect/turf_decal/tile/dark/fourcorners/contrasted,
/obj/structure/chair/fancy/shuttle{
	dir = 1
	},
/obj/effect/turf_decal/siding/thinplating_new{
	dir = 1
	},
/turf/open/floor/iron/white,
/area/shuttle/escape)
"kz" = (
/obj/structure/chair/fancy/shuttle{
	dir = 1
	},
/obj/effect/turf_decal/siding/dark_blue{
	dir = 1
	},
/turf/open/floor/mineral/plastitanium,
/area/shuttle/escape)
"lt" = (
/obj/machinery/door/airlock/titanium{
	name = "Emergency Shuttle Airlock";
	req_access_txt = "2"
	},
/obj/structure/fans/tiny,
/obj/effect/turf_decal/stripes/closeup{
	dir = 1
	},
/obj/docking_port/mobile/emergency,
/turf/open/floor/iron/white,
/area/shuttle/escape)
"lu" = (
/obj/machinery/vending/wallmed{
	name = "Emergency NanoMed";
	use_power = 0
	},
/turf/closed/wall/mineral/titanium,
/area/shuttle/escape)
"lx" = (
/obj/effect/turf_decal/tile/dark/fourcorners/contrasted,
/obj/structure/closet/firecloset,
/obj/effect/turf_decal/siding/thinplating_new{
	dir = 4
	},
/turf/open/floor/iron/white,
/area/shuttle/escape)
"lJ" = (
/obj/effect/turf_decal/tile/dark/fourcorners/contrasted,
/obj/effect/turf_decal/tile/dark/fourcorners/contrasted,
/obj/machinery/vending/wallmed{
	name = "Emergency NanoMed";
	use_power = 0
	},
/turf/closed/wall/mineral/titanium,
/area/shuttle/escape)
"ml" = (
/obj/structure/extinguisher_cabinet/directional/south,
/obj/structure/chair/fancy/shuttle{
	dir = 1
	},
/turf/open/floor/mineral/plastitanium/red/brig,
/area/shuttle/escape)
"mK" = (
/obj/structure/window/reinforced{
	dir = 8
	},
/obj/structure/chair/fancy/bench{
	pixel_y = 13
	},
/turf/open/floor/mineral/plastitanium/red/brig,
/area/shuttle/escape)
"oH" = (
/obj/structure/shuttle/engine/heater,
/obj/effect/turf_decal/stripes/line{
	dir = 1
	},
/obj/structure/window/reinforced{
	dir = 1
	},
/turf/open/floor/plating/airless,
/area/shuttle/escape)
"oJ" = (
/obj/effect/turf_decal/siding/dark_blue{
	dir = 4
	},
/turf/open/floor/mineral/plastitanium,
/area/shuttle/escape)
"pb" = (
/obj/effect/turf_decal/tile/dark/fourcorners/contrasted,
/obj/structure/chair/fancy/shuttle{
	dir = 1
	},
/obj/machinery/light,
/obj/effect/turf_decal/siding/thinplating_new{
	dir = 1
	},
/turf/open/floor/iron/white,
/area/shuttle/escape)
"pr" = (
/obj/structure/window/reinforced{
	dir = 8
	},
/obj/machinery/stasis{
	dir = 1
	},
/obj/effect/turf_decal/bot,
/obj/effect/turf_decal/tile/blue/fourcorners,
/turf/open/floor/iron/white/smooth_large,
/area/shuttle/escape)
"pM" = (
/obj/effect/turf_decal/siding/dark_blue{
	dir = 1
	},
/obj/structure/chair/fancy/shuttle{
	dir = 1
	},
/turf/open/floor/mineral/plastitanium,
/area/shuttle/escape)
"pP" = (
/obj/machinery/light{
	dir = 1
	},
/turf/closed/wall/mineral/titanium,
/area/shuttle/escape)
"qn" = (
/turf/open/floor/iron/white/smooth_large,
/area/shuttle/escape)
"qM" = (
/obj/machinery/computer/communications{
	dir = 8
	},
/obj/machinery/light{
	dir = 1
	},
/obj/effect/turf_decal/siding/dark_blue/corner{
	dir = 8
	},
/turf/open/floor/mineral/plastitanium,
/area/shuttle/escape)
"rt" = (
/obj/structure/window/reinforced{
	dir = 1
	},
/obj/effect/turf_decal/tile/blue/fourcorners,
/turf/open/floor/iron/white/smooth_large,
/area/shuttle/escape)
"ru" = (
/obj/structure/extinguisher_cabinet,
/obj/effect/turf_decal/tile/dark/fourcorners/contrasted,
/obj/effect/turf_decal/tile/dark/fourcorners/contrasted,
/turf/closed/wall/mineral/titanium,
/area/shuttle/escape)
"sD" = (
/obj/structure/chair/fancy/shuttle{
	dir = 8
	},
/obj/effect/turf_decal/tile/dark/fourcorners/contrasted,
/obj/effect/turf_decal/siding/thinplating_new{
	dir = 8
	},
/turf/open/floor/iron/white,
/area/shuttle/escape)
"sV" = (
/obj/effect/turf_decal/tile/blue/fourcorners,
/turf/open/floor/iron/white/textured_large,
/area/shuttle/escape)
"tN" = (
/obj/structure/chair/fancy/shuttle{
	dir = 4
	},
/obj/effect/turf_decal/tile/dark/fourcorners/contrasted,
/obj/effect/turf_decal/siding/thinplating_new{
	dir = 6
	},
/turf/open/floor/iron/white,
/area/shuttle/escape)
"ux" = (
/obj/effect/turf_decal/caution/stand_clear,
/obj/effect/turf_decal/bot,
/turf/open/floor/mineral/titanium,
/area/shuttle/escape)
"vt" = (
/obj/effect/turf_decal/tile/dark/fourcorners/contrasted,
/obj/effect/turf_decal/siding/thinplating_new{
	dir = 6
	},
/turf/open/floor/iron/white,
/area/shuttle/escape)
"vI" = (
/obj/structure/window/reinforced{
	dir = 1
	},
/obj/structure/window/reinforced{
	dir = 8
	},
/obj/structure/table/reinforced,
/obj/item/storage/firstaid{
	pixel_x = 3;
	pixel_y = 3
	},
/obj/effect/turf_decal/trimline/blue/filled/line{
	dir = 9
	},
/obj/effect/turf_decal/tile/blue/fourcorners,
/turf/open/floor/iron/white/smooth_large,
/area/shuttle/escape)
"vJ" = (
/obj/machinery/holopad,
/obj/effect/turf_decal/box,
/turf/open/floor/mineral/plastitanium/red/brig,
/area/shuttle/escape)
"wn" = (
/obj/structure/window/reinforced,
/obj/structure/table/reinforced,
/obj/item/storage/firstaid/random,
/obj/machinery/light{
	dir = 4
	},
/obj/effect/turf_decal/tile/blue/fourcorners,
/turf/open/floor/iron/white/smooth_large,
/area/shuttle/escape)
"ww" = (
/obj/machinery/light{
	dir = 1
	},
/obj/structure/chair/fancy/bench{
	pixel_y = 13
	},
/turf/open/floor/mineral/plastitanium/red/brig,
/area/shuttle/escape)
"xm" = (
/obj/effect/spawner/structure/window/shuttle,
/turf/open/floor/plating,
/area/shuttle/escape)
"xR" = (
/obj/effect/turf_decal/arrows{
	dir = 1
	},
/turf/open/floor/mineral/titanium,
/area/shuttle/escape)
"yx" = (
/obj/structure/chair/fancy/shuttle{
	dir = 4
	},
/turf/open/floor/mineral/plastitanium/red/brig,
/area/shuttle/escape)
"yC" = (
/obj/machinery/computer/emergency_shuttle,
/obj/machinery/light{
	dir = 1
	},
/obj/effect/turf_decal/siding/dark_blue,
/turf/open/floor/mineral/plastitanium,
/area/shuttle/escape)
"yE" = (
/obj/effect/turf_decal/caution/stand_clear/white{
	color = "#408fb8";
	dir = 1
	},
/obj/effect/turf_decal/trimline/blue/filled/warning{
	dir = 1
	},
/turf/open/floor/iron/white/smooth_large,
/area/shuttle/escape)
"yG" = (
/obj/machinery/status_display/evac/directional/north,
/obj/machinery/shieldgen,
/obj/effect/turf_decal/siding/dark_blue{
	dir = 8
	},
/turf/open/floor/mineral/plastitanium,
/area/shuttle/escape)
"zb" = (
/turf/closed/wall/mineral/plastitanium,
/area/shuttle/escape)
"zd" = (
/obj/structure/reagent_dispensers/peppertank/directional/west,
/obj/item/storage/box/handcuffs,
/obj/structure/table/reinforced,
/turf/open/floor/mineral/plastitanium/red/brig,
/area/shuttle/escape)
"zM" = (
/obj/machinery/door/window/brigdoor/security{
	req_access_txt = "1"
	},
/turf/open/floor/mineral/plastitanium/red/brig,
/area/shuttle/escape)
"AU" = (
/obj/effect/turf_decal/tile/blue/fourcorners,
/obj/structure/bed/roller,
/turf/open/floor/iron/white/textured_large,
/area/shuttle/escape)
"Bb" = (
/obj/structure/table/reinforced,
/obj/item/storage/firstaid{
	pixel_x = 3;
	pixel_y = 3
	},
/obj/structure/window/reinforced{
	dir = 1
	},
/obj/machinery/light{
	dir = 4
	},
/obj/effect/turf_decal/tile/blue/fourcorners,
/turf/open/floor/iron/white/smooth_large,
/area/shuttle/escape)
"Bq" = (
/obj/effect/turf_decal/tile/blue/fourcorners,
/obj/machinery/iv_drip,
/turf/open/floor/iron/white/textured_large,
/area/shuttle/escape)
"Ce" = (
/obj/effect/turf_decal/arrows,
/turf/open/floor/mineral/titanium,
/area/shuttle/escape)
"Cj" = (
/obj/structure/table/reinforced,
/obj/machinery/recharger,
/turf/open/floor/mineral/plastitanium/red/brig,
/area/shuttle/escape)
"CG" = (
/obj/structure/chair/fancy/shuttle{
	dir = 1
	},
/obj/machinery/firealarm/directional/south,
/turf/open/floor/mineral/plastitanium/red/brig,
/area/shuttle/escape)
"CQ" = (
/obj/machinery/computer/security,
/obj/effect/turf_decal/siding/dark_blue,
/turf/open/floor/mineral/plastitanium,
/area/shuttle/escape)
"CZ" = (
/obj/machinery/newscaster/directional/south,
/obj/structure/chair/fancy/shuttle{
	dir = 1
	},
/turf/open/floor/mineral/plastitanium/red/brig,
/area/shuttle/escape)
"DN" = (
/turf/closed/wall/mineral/titanium,
/area/shuttle/escape)
"Ef" = (
/obj/structure/chair/fancy/shuttle{
	dir = 4
	},
/obj/effect/turf_decal/tile/dark/fourcorners/contrasted,
/obj/machinery/light{
	dir = 8
	},
/obj/effect/turf_decal/siding/thinplating_new{
	dir = 5
	},
/turf/open/floor/iron/white,
/area/shuttle/escape)
"Eq" = (
/obj/structure/window/reinforced,
/obj/effect/turf_decal/tile/blue/fourcorners,
/turf/open/floor/iron/white/smooth_large,
/area/shuttle/escape)
"EG" = (
/obj/effect/turf_decal/tile/dark/fourcorners/contrasted,
/obj/structure/closet/emcloset,
/obj/effect/turf_decal/siding/thinplating_new{
	dir = 4
	},
/turf/open/floor/iron/white,
/area/shuttle/escape)
"EW" = (
/obj/structure/chair/fancy/shuttle{
	dir = 4
	},
/obj/effect/turf_decal/tile/dark/fourcorners/contrasted,
/obj/machinery/light{
	dir = 8
	},
/obj/effect/turf_decal/siding/thinplating_new{
	dir = 4
	},
/turf/open/floor/iron/white,
/area/shuttle/escape)
"FC" = (
/obj/structure/extinguisher_cabinet,
/turf/closed/wall/mineral/titanium,
/area/shuttle/escape)
"FX" = (
/obj/effect/turf_decal/tile/dark/fourcorners/contrasted,
/obj/item/kirbyplants{
	icon_state = "plant-10"
	},
/obj/machinery/light,
/obj/effect/turf_decal/siding/thinplating_new{
	dir = 1
	},
/turf/open/floor/iron/white,
/area/shuttle/escape)
"Hb" = (
/obj/machinery/door/airlock/titanium{
	name = "Emergency Shuttle Airlock";
	req_access_txt = "2"
	},
/obj/structure/fans/tiny,
/obj/effect/turf_decal/stripes/closeup{
	dir = 1
	},
/turf/open/floor/iron/white,
/area/shuttle/escape)
"Hk" = (
/obj/effect/turf_decal/tile/dark/fourcorners/contrasted,
/obj/structure/closet/firecloset,
/obj/effect/turf_decal/siding/thinplating_new,
/turf/open/floor/iron/white,
/area/shuttle/escape)
"Hq" = (
/obj/structure/window/reinforced,
/obj/structure/closet/crate/freezer/blood,
/obj/effect/turf_decal/tile/blue/fourcorners,
/turf/open/floor/iron/white/smooth_large,
/area/shuttle/escape)
"HN" = (
/obj/item/storage/belt/medical,
/obj/item/storage/belt/medical,
/obj/item/reagent_containers/spray/cleaner{
	pixel_x = -3;
	pixel_y = 2
	},
/obj/item/clothing/neck/stethoscope,
/obj/item/clothing/neck/stethoscope,
/obj/item/clothing/glasses/hud/health,
/obj/item/clothing/glasses/hud/health,
/obj/effect/turf_decal/bot,
/obj/structure/table/reinforced,
/obj/machinery/light{
	dir = 4
	},
/turf/open/floor/iron/white/smooth_large,
/area/shuttle/escape)
"HP" = (
/obj/machinery/computer/crew{
	dir = 4
	},
/obj/machinery/light{
	dir = 1
	},
/obj/effect/turf_decal/siding/dark_blue/corner,
/turf/open/floor/mineral/plastitanium,
/area/shuttle/escape)
"HR" = (
/obj/structure/window/reinforced{
	dir = 8
	},
/obj/structure/window/reinforced,
/obj/structure/table/reinforced,
/obj/item/storage/firstaid/random,
/obj/effect/turf_decal/tile/blue/fourcorners,
/turf/open/floor/iron/white/smooth_large,
/area/shuttle/escape)
"IG" = (
/obj/effect/turf_decal/tile/dark/fourcorners/contrasted,
/obj/item/kirbyplants{
	icon_state = "plant-10"
	},
/obj/machinery/light{
	dir = 1
	},
/obj/effect/turf_decal/siding/thinplating_new,
/turf/open/floor/iron/white,
/area/shuttle/escape)
"IK" = (
/obj/machinery/computer/atmos_alert,
/obj/effect/turf_decal/siding/dark_blue,
/turf/open/floor/mineral/plastitanium,
/area/shuttle/escape)
"IL" = (
/obj/effect/turf_decal/tile/dark/fourcorners/contrasted,
/obj/machinery/light{
	dir = 8
	},
/obj/structure/chair/fancy/shuttle{
	dir = 4
	},
/obj/effect/turf_decal/siding/thinplating_new{
	dir = 4
	},
/turf/open/floor/iron/white,
/area/shuttle/escape)
"Jb" = (
/obj/item/radio/intercom/directional/south,
/obj/structure/chair/fancy/shuttle{
	dir = 1
	},
/turf/open/floor/mineral/plastitanium/red/brig,
/area/shuttle/escape)
"Jn" = (
/obj/effect/turf_decal/tile/dark/fourcorners/contrasted,
/obj/item/kirbyplants{
	icon_state = "plant-10"
	},
/obj/machinery/light{
	dir = 1
	},
/obj/effect/turf_decal/siding/thinplating_new/corner,
/turf/open/floor/iron/white,
/area/shuttle/escape)
"Js" = (
/obj/structure/window/reinforced{
	dir = 8
	},
/obj/machinery/stasis{
	dir = 1
	},
/obj/effect/turf_decal/bot,
/obj/item/stack/medical/gauze,
/obj/effect/turf_decal/tile/blue/fourcorners,
/turf/open/floor/iron/white/smooth_large,
/area/shuttle/escape)
"JG" = (
/obj/structure/chair/fancy/shuttle{
	dir = 8
	},
/obj/effect/turf_decal/tile/dark/fourcorners/contrasted,
/obj/effect/turf_decal/siding/thinplating_new{
	dir = 9
	},
/turf/open/floor/iron/white,
/area/shuttle/escape)
"JO" = (
/obj/structure/chair/fancy/shuttle{
	dir = 8
	},
/obj/machinery/light{
	dir = 1
	},
/turf/open/floor/mineral/plastitanium/red/brig,
/area/shuttle/escape)
"Ki" = (
/obj/structure/window/reinforced{
	dir = 8
	},
/obj/structure/table/reinforced,
/obj/item/storage/firstaid/random,
/obj/effect/turf_decal/tile/blue/fourcorners,
/turf/open/floor/iron/white/smooth_large,
/area/shuttle/escape)
"Ld" = (
/obj/effect/turf_decal/tile/dark/fourcorners/contrasted,
/obj/effect/turf_decal/siding/thinplating_new,
/turf/open/floor/iron/white,
/area/shuttle/escape)
"Lm" = (
/obj/structure/table/reinforced,
/obj/item/assembly/flash,
/turf/open/floor/mineral/plastitanium/red/brig,
/area/shuttle/escape)
"Lq" = (
/obj/structure/table/reinforced,
/obj/item/storage/firstaid/random,
/obj/effect/turf_decal/tile/blue/fourcorners,
/turf/open/floor/iron/white/smooth_large,
/area/shuttle/escape)
"LQ" = (
/obj/structure/chair/fancy/shuttle{
	dir = 4
	},
/obj/effect/turf_decal/tile/dark/fourcorners/contrasted,
/obj/effect/turf_decal/siding/thinplating_new{
	dir = 4
	},
/turf/open/floor/iron/white,
/area/shuttle/escape)
"Nn" = (
/obj/effect/turf_decal/arrows{
	dir = 4
	},
/turf/open/floor/mineral/titanium,
/area/shuttle/escape)
"Nw" = (
/obj/machinery/computer/operating{
	dir = 4
	},
/obj/effect/turf_decal/bot,
/obj/effect/turf_decal/tile/blue/fourcorners,
/obj/item/defibrillator/compact/loaded,
/turf/open/floor/iron/white/textured_large,
/area/shuttle/escape)
"NH" = (
/obj/structure/window/reinforced{
	dir = 4
	},
/obj/structure/window/reinforced,
/turf/open/floor/mineral/plastitanium/red/brig,
/area/shuttle/escape)
"NJ" = (
/obj/machinery/status_display/ai/directional/west,
/obj/effect/turf_decal/tile/dark/fourcorners/contrasted,
/obj/structure/closet/emcloset,
/obj/effect/turf_decal/siding/thinplating_new{
	dir = 6
	},
/turf/open/floor/iron/white,
/area/shuttle/escape)
"NX" = (
/obj/structure/window/reinforced{
	dir = 4
	},
/obj/structure/chair/fancy/bench{
	pixel_y = 13
	},
/turf/open/floor/mineral/plastitanium/red/brig,
/area/shuttle/escape)
"Om" = (
/obj/structure/window/reinforced{
	dir = 1
	},
/obj/structure/closet/crate/freezer/blood,
/obj/effect/turf_decal/tile/blue/fourcorners,
/turf/open/floor/iron/white/smooth_large,
/area/shuttle/escape)
"OI" = (
/obj/structure/table/reinforced,
/obj/effect/turf_decal/siding/dark_blue/corner{
	dir = 1
	},
/obj/machinery/recharger,
/turf/open/floor/mineral/plastitanium,
/area/shuttle/escape)
"Pk" = (
/obj/structure/window/reinforced{
	dir = 8
	},
/obj/effect/turf_decal/bot,
/obj/machinery/stasis{
	dir = 1
	},
/obj/effect/turf_decal/tile/blue/fourcorners,
/turf/open/floor/iron/white/smooth_large,
/area/shuttle/escape)
"PH" = (
/obj/structure/window/reinforced,
/obj/structure/closet/crate/freezer/surplus_limbs,
/obj/effect/turf_decal/tile/blue/fourcorners,
/turf/open/floor/iron/white/smooth_large,
/area/shuttle/escape)
"PK" = (
/obj/effect/turf_decal/tile/dark/fourcorners/contrasted,
/obj/machinery/light,
/obj/item/kirbyplants{
	icon_state = "plant-10"
	},
/obj/effect/turf_decal/siding/thinplating_new{
	dir = 1
	},
/turf/open/floor/iron/white,
/area/shuttle/escape)
"Qj" = (
/obj/machinery/shieldgen,
/turf/open/floor/mineral/titanium,
/area/shuttle/escape)
"Qp" = (
/obj/structure/chair/fancy/shuttle{
	dir = 4
	},
/obj/effect/turf_decal/tile/dark/fourcorners/contrasted,
/obj/effect/turf_decal/siding/thinplating_new/end{
	dir = 4
	},
/turf/open/floor/iron/white,
/area/shuttle/escape)
"Rv" = (
/obj/structure/shuttle/engine/propulsion,
/obj/effect/turf_decal/stripes/line{
	dir = 1
	},
/turf/open/floor/plating/airless,
/area/shuttle/escape)
"RK" = (
/obj/structure/flora/ausbushes/grassybush,
/obj/structure/flora/ausbushes/brflowers,
/obj/structure/window/reinforced{
	dir = 4
	},
/obj/structure/window/reinforced{
	dir = 8;
	pixel_y = 1
	},
/obj/structure/window/reinforced,
/turf/open/floor/grass/no_border,
/area/shuttle/escape)
"Sk" = (
/obj/effect/turf_decal/bot,
/obj/machinery/stasis,
/obj/item/stack/medical/gauze,
/obj/effect/turf_decal/tile/blue/fourcorners,
/turf/open/floor/iron/white/smooth_large,
/area/shuttle/escape)
"SP" = (
/turf/open/floor/mineral/plastitanium/red/brig,
/area/shuttle/escape)
"SS" = (
/obj/effect/turf_decal/bot,
/obj/machinery/stasis,
/obj/effect/turf_decal/tile/blue/fourcorners,
/turf/open/floor/iron/white/smooth_large,
/area/shuttle/escape)
"Tx" = (
/obj/structure/flora/ausbushes/grassybush,
/obj/structure/flora/ausbushes/lavendergrass,
/obj/structure/flora/ausbushes/brflowers,
/obj/structure/flora/ausbushes/leafybush,
/obj/structure/window/reinforced{
	dir = 4
	},
/obj/structure/window/reinforced{
	dir = 1;
	pixel_y = 1
	},
/obj/structure/window/reinforced{
	dir = 8
	},
/turf/open/floor/grass/no_border,
/area/shuttle/escape)
"TW" = (
/obj/machinery/computer/operating{
	dir = 8
	},
/obj/effect/turf_decal/bot,
/obj/effect/turf_decal/tile/blue/fourcorners,
/obj/item/defibrillator/compact/loaded,
/turf/open/floor/iron/white/textured_large,
/area/shuttle/escape)
"Ve" = (
/obj/structure/window/reinforced{
	dir = 8
	},
/obj/structure/window/reinforced,
/turf/open/floor/mineral/plastitanium/red/brig,
/area/shuttle/escape)
"Vk" = (
/obj/item/radio/intercom/directional/south,
/obj/effect/turf_decal/siding/dark_blue{
	dir = 1
	},
/obj/structure/chair/fancy/shuttle{
	dir = 1
	},
/turf/open/floor/mineral/plastitanium,
/area/shuttle/escape)
"Vx" = (
/obj/effect/turf_decal/tile/dark/fourcorners/contrasted,
/obj/effect/turf_decal/siding/thinplating_new{
	dir = 10
	},
/turf/open/floor/iron/white,
/area/shuttle/escape)
"VZ" = (
/turf/open/floor/mineral/titanium,
/area/shuttle/escape)
"Xc" = (
/obj/structure/chair/fancy/shuttle{
	dir = 1
	},
/obj/effect/turf_decal/tile/dark_blue/fourcorners/contrasted,
/turf/open/floor/iron/smooth,
/area/shuttle/escape)
"XG" = (
/obj/effect/turf_decal/bot,
/obj/machinery/vending/medical,
/turf/open/floor/iron/white/smooth_large,
/area/shuttle/escape)
"XP" = (
/obj/effect/turf_decal/caution/stand_clear/white{
	color = "#408fb8"
	},
/obj/effect/turf_decal/trimline/blue/filled/warning,
/turf/open/floor/iron/white/smooth_large,
/area/shuttle/escape)
"Yv" = (
/obj/effect/turf_decal/stripes/line{
	dir = 1
	},
/turf/closed/wall/mineral/plastitanium,
/area/shuttle/escape)
"Zg" = (
/obj/structure/chair/fancy/shuttle{
	dir = 4
	},
/obj/effect/turf_decal/tile/dark/fourcorners/contrasted,
/obj/effect/turf_decal/siding/thinplating_new{
	dir = 5
	},
/turf/open/floor/iron/white,
/area/shuttle/escape)
"Zo" = (
/obj/structure/window/reinforced{
	dir = 8
	},
/obj/structure/table/reinforced,
/obj/item/storage/firstaid{
	pixel_x = 3;
	pixel_y = 3
	},
/obj/effect/turf_decal/tile/blue/fourcorners,
/turf/open/floor/iron/white/smooth_large,
/area/shuttle/escape)
"ZW" = (
/obj/effect/turf_decal/siding/dark_blue{
	dir = 1
	},
/turf/open/floor/mineral/plastitanium,
/area/shuttle/escape)

(1,1,1) = {"
fI
fI
DN
DN
xm
DN
DN
xm
DN
Hb
DN
lt
DN
xm
xm
xm
xm
Hb
DN
Hb
DN
DN
fI
"}
(2,1,1) = {"
fI
DN
DN
hu
yx
zd
DN
Jn
NJ
VZ
Qp
VZ
Ef
EG
lx
LQ
tN
VZ
Qp
VZ
PK
DN
fI
"}
(3,1,1) = {"
DN
DN
dr
SP
SP
CZ
DN
Hk
VZ
VZ
VZ
VZ
VZ
VZ
VZ
VZ
VZ
VZ
VZ
VZ
gP
zb
Yv
"}
(4,1,1) = {"
xm
mK
Ve
SP
SP
ml
DN
Ld
VZ
JG
sD
sD
dP
Nn
Nn
JG
sD
sD
dP
VZ
kg
oH
Rv
"}
(5,1,1) = {"
xm
ww
zM
SP
vJ
SP
bM
ux
VZ
Tx
lu
ru
RK
VZ
VZ
Tx
FC
lJ
RK
VZ
kg
oH
Rv
"}
(6,1,1) = {"
xm
NX
NH
SP
SP
Jb
DN
Ld
VZ
Zg
LQ
EW
tN
Nn
Nn
Zg
IL
LQ
tN
VZ
kg
oH
Rv
"}
(7,1,1) = {"
DN
DN
Cj
SP
SP
CG
DN
Ld
VZ
VZ
VZ
VZ
VZ
VZ
VZ
VZ
VZ
VZ
VZ
VZ
kg
oH
Rv
"}
(8,1,1) = {"
fI
DN
DN
JO
SP
Lm
DN
Ld
VZ
JG
sD
sD
dP
Nn
Nn
JG
sD
sD
dP
VZ
pb
zb
Yv
"}
(9,1,1) = {"
fI
fI
DN
xm
ee
xm
DN
IG
VZ
vI
pr
pr
Ki
ga
ga
Zo
Js
Pk
HR
VZ
gk
oH
Rv
"}
(10,1,1) = {"
fI
DN
DN
HP
oJ
gX
DN
Ld
VZ
rt
qn
qn
qn
sV
sV
qn
qn
qn
Eq
VZ
kg
oH
Rv
"}
(11,1,1) = {"
DN
DN
iS
hQ
gh
kz
xm
Ld
VZ
cY
qn
qn
qn
sV
sV
qn
qn
qn
PH
VZ
pb
zb
Yv
"}
(12,1,1) = {"
xm
IK
Xc
gh
gh
jl
DN
vt
Ce
yE
qn
sV
AU
hb
TW
Bq
sV
qn
XP
xR
kg
oH
Rv
"}
(13,1,1) = {"
xm
yC
Xc
gh
ct
ZW
ee
ux
Ce
yE
qn
sV
Bq
Nw
hb
AU
sV
qn
XP
xR
kg
oH
Rv
"}
(14,1,1) = {"
xm
CQ
Xc
gh
gh
Vk
DN
Vx
VZ
Om
qn
qn
qn
sV
sV
qn
qn
qn
Hq
VZ
kg
oH
Rv
"}
(15,1,1) = {"
DN
DN
yG
at
gh
pM
xm
Ld
VZ
rt
qn
qn
qn
sV
sV
qn
qn
qn
Eq
VZ
kg
oH
Rv
"}
(16,1,1) = {"
fI
DN
DN
qM
eX
OI
DN
IG
Qj
Bb
hG
Sk
Lq
XG
HN
fc
hG
SS
wn
Qj
FX
DN
fI
"}
(17,1,1) = {"
fI
fI
DN
DN
xm
pP
DN
xm
xm
DN
DN
DN
xm
xm
lu
xm
xm
xm
DN
xm
DN
DN
fI
"}
