//MAP CONVERTED BY dmm2tgm.py THIS HEADER COMMENT PREVENTS RECONVERSION, DO NOT REMOVE
"aa" = (
/turf/template_noop,
/area/template_noop)
"ac" = (
/obj/effect/spawner/structure/window/shuttle,
/turf/open/floor/plating,
/area/shuttle/escape)
"ad" = (
/turf/closed/wall/mineral/titanium,
/area/shuttle/escape)
"ag" = (
/obj/structure/sign/warning/nosmoking,
/turf/closed/wall/mineral/titanium,
/area/shuttle/escape)
"al" = (
/obj/structure/table,
/obj/item/storage/fancy/donut_box,
/turf/open/floor/iron/dark/side{
	dir = 4
	},
/area/shuttle/escape)
"am" = (
/obj/effect/turf_decal/siding/thinplating_new/dark{
	dir = 9
	},
/turf/open/floor/carpet/blue,
/area/shuttle/escape)
"an" = (
/obj/effect/turf_decal/siding/thinplating_new/dark{
	dir = 1
	},
/obj/structure/chair/fancy/corp{
	dir = 1
	},
/turf/open/floor/carpet/blue,
/area/shuttle/escape)
"ao" = (
/obj/structure/table,
/obj/item/restraints/handcuffs{
	pixel_y = 3
	},
/obj/machinery/light{
	dir = 4
	},
/obj/effect/turf_decal/siding/thinplating_new/dark{
	dir = 1
	},
/turf/open/floor/carpet/blue,
/area/shuttle/escape)
"ap" = (
/obj/machinery/light{
	dir = 8
	},
/obj/structure/closet/firecloset,
/obj/effect/turf_decal/box,
/turf/open/floor/mineral/plastitanium,
/area/shuttle/escape)
"aq" = (
/obj/effect/turf_decal/siding/thinplating_new/dark{
	dir = 8
	},
/obj/structure/chair/fancy/corp{
	dir = 8
	},
/turf/open/floor/carpet/blue,
/area/shuttle/escape)
"ar" = (
/turf/open/floor/iron/dark/side{
	dir = 1
	},
/area/shuttle/escape)
"as" = (
/obj/effect/decal/cleanable/dirt,
/obj/machinery/holopad{
	pixel_x = 16
	},
/turf/open/floor/iron,
/area/shuttle/escape)
"at" = (
/obj/machinery/status_display/evac{
	dir = 8;
	pixel_x = 32
	},
/turf/open/floor/iron,
/area/shuttle/escape)
"au" = (
/obj/structure/shuttle/engine/propulsion{
	dir = 8
	},
/turf/open/floor/plating/airless,
/area/shuttle/escape)
"av" = (
/obj/structure/shuttle/engine/heater{
	dir = 8
	},
/obj/structure/window/reinforced{
	dir = 4
	},
/turf/open/floor/plating/airless,
/area/shuttle/escape)
"aw" = (
/obj/machinery/computer/communications{
	dir = 4
	},
/turf/open/floor/iron/dark/side{
	dir = 4
	},
/area/shuttle/escape)
"ax" = (
/turf/open/floor/carpet/blue,
/area/shuttle/escape)
"az" = (
/obj/machinery/status_display/evac,
/turf/closed/wall/mineral/titanium,
/area/shuttle/escape)
"aA" = (
/obj/effect/turf_decal/box,
/obj/structure/tank_dispenser/oxygen,
/turf/open/floor/mineral/plastitanium,
/area/shuttle/escape)
"aB" = (
/obj/machinery/computer/emergency_shuttle{
	dir = 4
	},
/turf/open/floor/iron/dark/side{
	dir = 4
	},
/area/shuttle/escape)
"aC" = (
/obj/structure/table,
/obj/item/folder/blue,
/obj/structure/extinguisher_cabinet{
	dir = 4;
	pixel_y = -27
	},
/turf/open/floor/iron/dark/side{
	dir = 1
	},
/area/shuttle/escape)
"aE" = (
/obj/structure/flora/ausbushes/grassybush,
/obj/structure/flora/ausbushes/lavendergrass,
/obj/structure/flora/ausbushes/brflowers,
/obj/structure/flora/ausbushes/leafybush,
/obj/structure/window/shuttle,
/turf/open/floor/grass,
/area/shuttle/escape)
"aF" = (
/obj/machinery/computer/station_alert{
	dir = 4
	},
/turf/open/floor/iron/dark/side{
	dir = 4
	},
/area/shuttle/escape)
"aG" = (
/obj/machinery/recharge_station,
/obj/effect/turf_decal/delivery,
/obj/machinery/light{
	dir = 1
	},
/turf/open/floor/iron,
/area/shuttle/escape)
"aI" = (
/obj/machinery/vending/wallmed{
	name = "Emergency NanoMed";
	use_power = 0
	},
/turf/closed/wall/mineral/titanium,
/area/shuttle/escape)
"aJ" = (
/obj/structure/extinguisher_cabinet,
/turf/closed/wall/mineral/titanium,
/area/shuttle/escape)
"aL" = (
/obj/structure/table,
/obj/item/storage/toolbox/emergency{
	pixel_y = 3
	},
/turf/open/floor/iron/dark/side{
	dir = 4
	},
/area/shuttle/escape)
"aN" = (
/obj/machinery/door/firedoor,
/obj/effect/turf_decal/tile/blue{
	dir = 1
	},
/obj/machinery/door/airlock/medical/glass{
	name = "Escape Shuttle Infirmary"
	},
/turf/open/floor/iron/white,
/area/shuttle/escape)
"aO" = (
/obj/structure/table,
/obj/machinery/recharger{
	active_power_usage = 0;
	idle_power_usage = 0;
	pixel_y = 4;
	use_power = 0
	},
/turf/open/floor/iron/dark/corner{
	dir = 4
	},
/area/shuttle/escape)
"aP" = (
/turf/open/floor/iron/dark,
/area/shuttle/escape)
"aR" = (
/obj/machinery/holopad,
/turf/open/floor/carpet/blue,
/area/shuttle/escape)
"aS" = (
/obj/item/radio/intercom{
	name = "Station Intercom (General)";
	pixel_y = -31
	},
/obj/structure/chair/fancy/shuttle{
	dir = 1
	},
/obj/machinery/light,
/obj/effect/turf_decal/bot,
/turf/open/floor/mineral/titanium,
/area/shuttle/escape)
"aT" = (
/obj/structure/chair/fancy/shuttle,
/obj/effect/turf_decal/bot,
/turf/open/floor/mineral/titanium,
/area/shuttle/escape)
"ba" = (
/obj/structure/sign/departments/medbay/alt,
/turf/closed/wall/mineral/titanium,
/area/shuttle/escape)
"bd" = (
/obj/structure/chair/fancy/shuttle{
	dir = 4
	},
/obj/effect/decal/cleanable/dirt,
/turf/open/floor/iron,
/area/shuttle/escape)
"be" = (
/obj/effect/decal/cleanable/dirt,
/turf/open/floor/iron,
/area/shuttle/escape)
"bf" = (
/obj/machinery/door/airlock/external{
	name = "Emergency Recovery Airlock"
	},
/obj/effect/decal/cleanable/dirt,
/turf/open/floor/iron,
/area/shuttle/escape)
"bh" = (
/obj/structure/chair/fancy/shuttle{
	dir = 4
	},
/turf/open/floor/mineral/plastitanium/red/brig,
/area/shuttle/escape)
"bi" = (
/obj/structure/chair/fancy/shuttle,
/turf/open/floor/mineral/plastitanium/red/brig,
/area/shuttle/escape)
"bj" = (
/obj/item/defibrillator/loaded,
/obj/structure/table,
/obj/effect/turf_decal/bot,
/turf/open/floor/mineral/titanium/blue,
/area/shuttle/escape)
"bk" = (
/obj/effect/turf_decal/tile/blue,
/obj/effect/turf_decal/siding/thinplating_new/light{
	dir = 4
	},
/turf/open/floor/mineral/titanium/blue,
/area/shuttle/escape)
"bl" = (
/obj/effect/turf_decal/tile/blue,
/turf/open/floor/iron/white,
/area/shuttle/escape)
"bm" = (
/obj/effect/turf_decal/siding/thinplating_new/light,
/obj/structure/closet/crate/freezer/blood,
/turf/open/floor/mineral/titanium/blue,
/area/shuttle/escape)
"bn" = (
/obj/effect/turf_decal/delivery,
/obj/machinery/portable_atmospherics/canister/oxygen,
/turf/open/floor/iron,
/area/shuttle/escape)
"bo" = (
/obj/structure/rack,
/obj/effect/turf_decal/stripes/line{
	dir = 4
	},
/obj/item/storage/toolbox/electrical{
	pixel_x = -3;
	pixel_y = 1
	},
/obj/item/storage/toolbox/mechanical{
	pixel_y = -1
	},
/obj/item/storage/toolbox/emergency{
	pixel_x = 3;
	pixel_y = -5
	},
/obj/item/radio,
/obj/item/flashlight/flare{
	pixel_x = -6;
	pixel_y = -2
	},
/obj/item/flashlight/flare{
	pixel_x = 3;
	pixel_y = 3
	},
/turf/open/floor/iron,
/area/shuttle/escape)
"bp" = (
/obj/effect/turf_decal/delivery,
/turf/open/floor/iron,
/area/shuttle/escape)
"bq" = (
/obj/effect/turf_decal/delivery,
/obj/structure/reagent_dispensers/watertank,
/turf/open/floor/iron,
/area/shuttle/escape)
"bs" = (
/obj/structure/chair/fancy/shuttle{
	dir = 8
	},
/turf/open/floor/mineral/plastitanium/red/brig,
/area/shuttle/escape)
"bt" = (
/obj/structure/reagent_dispensers/peppertank,
/turf/closed/wall/mineral/titanium,
/area/shuttle/escape)
"bu" = (
/obj/machinery/stasis,
/obj/effect/turf_decal/siding/thinplating_new/light,
/obj/effect/turf_decal/box,
/turf/open/floor/mineral/titanium/blue,
/area/shuttle/escape)
"bv" = (
/obj/effect/turf_decal/tile/blue/opposingcorners,
/obj/effect/turf_decal/tile/blue{
	dir = 4
	},
/turf/open/floor/iron/white,
/area/shuttle/escape)
"bw" = (
/obj/item/cigbutt,
/obj/effect/decal/cleanable/dirt,
/turf/open/floor/iron,
/area/shuttle/escape)
"by" = (
/obj/machinery/suit_storage_unit/standard_unit,
/obj/effect/decal/cleanable/dirt,
/turf/open/floor/iron,
/area/shuttle/escape)
"bz" = (
/obj/machinery/computer/crew{
	dir = 4
	},
/turf/open/floor/iron/white,
/area/shuttle/escape)
"bA" = (
/obj/effect/turf_decal/stripes/line{
	dir = 4
	},
/turf/open/floor/iron,
/area/shuttle/escape)
"bD" = (
/obj/structure/table,
/obj/item/folder/red{
	pixel_x = 3
	},
/obj/item/folder/white{
	pixel_x = -4;
	pixel_y = 2
	},
/obj/item/radio/intercom{
	name = "Station Intercom (General)";
	pixel_y = -31
	},
/obj/item/book/manual/wiki/security_space_law{
	pixel_x = -4;
	pixel_y = 4
	},
/turf/open/floor/mineral/plastitanium/red/brig,
/area/shuttle/escape)
"bE" = (
/obj/structure/table,
/obj/item/restraints/handcuffs{
	pixel_y = 3
	},
/turf/open/floor/mineral/plastitanium/red/brig,
/area/shuttle/escape)
"bF" = (
/obj/structure/table,
/obj/machinery/recharger{
	active_power_usage = 0;
	idle_power_usage = 0;
	use_power = 0
	},
/turf/open/floor/mineral/plastitanium/red/brig,
/area/shuttle/escape)
"bG" = (
/obj/structure/table,
/obj/item/storage/box/handcuffs{
	pixel_x = 2;
	pixel_y = 2
	},
/turf/open/floor/mineral/plastitanium/red/brig,
/area/shuttle/escape)
"bH" = (
/obj/item/radio/intercom{
	name = "Station Intercom (General)";
	pixel_x = -27
	},
/obj/machinery/shower{
	dir = 4
	},
/obj/effect/turf_decal/tile/blue{
	dir = 1
	},
/obj/effect/turf_decal/bot,
/turf/open/floor/noslip/blue,
/area/shuttle/escape)
"bI" = (
/obj/effect/turf_decal/tile/blue/opposingcorners,
/obj/effect/turf_decal/tile/blue{
	dir = 4
	},
/obj/effect/turf_decal/arrows{
	dir = 8
	},
/obj/structure/sink,
/turf/open/floor/iron/white,
/area/shuttle/escape)
"bJ" = (
/obj/structure/table,
/obj/item/reagent_containers/glass/bottle/epinephrine{
	pixel_x = 6
	},
/obj/item/reagent_containers/glass/bottle/charcoal{
	pixel_x = -3
	},
/obj/item/reagent_containers/glass/bottle/epinephrine{
	pixel_x = -3;
	pixel_y = 8
	},
/obj/item/reagent_containers/glass/bottle/charcoal{
	pixel_x = 6;
	pixel_y = 8
	},
/obj/item/reagent_containers/syringe/epinephrine{
	pixel_x = 3;
	pixel_y = -2
	},
/obj/item/reagent_containers/syringe/epinephrine{
	pixel_x = 4;
	pixel_y = 1
	},
/obj/item/reagent_containers/syringe/epinephrine{
	pixel_x = -2;
	pixel_y = 5
	},
/obj/item/reagent_containers/syringe/epinephrine{
	pixel_x = 2;
	pixel_y = 8
	},
/obj/effect/turf_decal/siding/thinplating_new/light{
	dir = 9
	},
/turf/open/floor/mineral/titanium/blue,
/area/shuttle/escape)
"bK" = (
/obj/structure/table,
/obj/item/storage/firstaid/toxin,
/obj/item/storage/firstaid/o2{
	pixel_x = 3;
	pixel_y = 3
	},
/obj/effect/turf_decal/siding/thinplating_new/light{
	dir = 1
	},
/turf/open/floor/mineral/titanium/blue,
/area/shuttle/escape)
"bL" = (
/obj/structure/extinguisher_cabinet,
/turf/closed/wall/mineral/titanium/nodiagonal,
/area/shuttle/escape)
"bM" = (
/obj/effect/turf_decal/tile/blue/half/contrasted{
	dir = 8
	},
/obj/structure/bed/roller,
/obj/machinery/iv_drip,
/obj/effect/turf_decal/siding/thinplating_new/light{
	dir = 1
	},
/turf/open/floor/mineral/titanium/blue,
/area/shuttle/escape)
"bN" = (
/obj/structure/chair/fancy/shuttle{
	dir = 1
	},
/obj/effect/turf_decal/bot,
/turf/open/floor/mineral/titanium,
/area/shuttle/escape)
"bO" = (
/obj/structure/rack,
/obj/item/tank/internals/oxygen/red,
/obj/item/clothing/suit/utility/fire/firefighter,
/obj/item/clothing/mask/gas,
/obj/item/clothing/head/utility/hardhat/red,
/obj/effect/turf_decal/stripes/line{
	dir = 4
	},
/obj/structure/extinguisher_cabinet{
	dir = 4;
	pixel_y = -27
	},
/turf/open/floor/iron,
/area/shuttle/escape)
"bP" = (
/obj/structure/closet/crate/medical,
/obj/item/storage/firstaid/regular,
/obj/item/storage/firstaid/o2{
	pixel_x = 3;
	pixel_y = 3
	},
/obj/item/storage/firstaid/toxin{
	pixel_x = -4;
	pixel_y = 3
	},
/obj/item/healthanalyzer{
	pixel_x = 3;
	pixel_y = 3
	},
/obj/item/lazarus_injector,
/obj/effect/turf_decal/bot,
/mob/living/simple_animal/bot/medbot{
	name = "\improper emergency medibot";
	pixel_x = -3;
	pixel_y = 2
	},
/turf/open/floor/iron,
/area/shuttle/escape)
"bQ" = (
/obj/machinery/advanced_airlock_controller{
	pixel_y = 24
	},
/obj/machinery/atmospherics/pipe/simple/orange/hidden,
/obj/effect/decal/cleanable/dirt,
/turf/open/floor/iron,
/area/shuttle/escape)
"bR" = (
/obj/structure/table,
/obj/item/clipboard,
/obj/item/folder/yellow,
/obj/item/pen,
/obj/item/hand_labeler_refill,
/obj/effect/turf_decal/bot,
/turf/open/floor/iron,
/area/shuttle/escape)
"bU" = (
/turf/open/floor/mineral/plastitanium/red/brig,
/area/shuttle/escape)
"bV" = (
/turf/open/floor/iron/dark/side,
/area/shuttle/escape)
"bW" = (
/obj/item/clothing/suit/hazardvest{
	desc = "A high-visibility lifejacket complete with whistle and slot for oxygen tanks.";
	name = "emergency lifejacket"
	},
/obj/item/clothing/suit/hazardvest{
	desc = "A high-visibility lifejacket complete with whistle and slot for oxygen tanks.";
	name = "emergency lifejacket"
	},
/obj/item/clothing/suit/hazardvest{
	desc = "A high-visibility lifejacket complete with whistle and slot for oxygen tanks.";
	name = "emergency lifejacket"
	},
/obj/item/clothing/suit/hazardvest{
	desc = "A high-visibility lifejacket complete with whistle and slot for oxygen tanks.";
	name = "emergency lifejacket"
	},
/obj/item/clothing/suit/hazardvest{
	desc = "A high-visibility lifejacket complete with whistle and slot for oxygen tanks.";
	name = "emergency lifejacket"
	},
/obj/item/tank/internals/emergency_oxygen{
	pixel_x = 3
	},
/obj/item/tank/internals/emergency_oxygen{
	pixel_x = 3
	},
/obj/item/tank/internals/emergency_oxygen{
	pixel_x = 3
	},
/obj/item/tank/internals/emergency_oxygen{
	pixel_x = 3
	},
/obj/item/tank/internals/emergency_oxygen{
	pixel_x = 3
	},
/obj/item/clothing/mask/breath{
	pixel_x = -3;
	pixel_y = -3
	},
/obj/item/clothing/mask/breath{
	pixel_x = -3;
	pixel_y = -3
	},
/obj/item/clothing/mask/breath{
	pixel_x = -3;
	pixel_y = -3
	},
/obj/item/clothing/mask/breath{
	pixel_x = -3;
	pixel_y = -3
	},
/obj/item/clothing/mask/breath{
	pixel_x = -3;
	pixel_y = -3
	},
/obj/item/clothing/head/utility/hardhat/orange{
	name = "protective hat";
	pixel_y = 9
	},
/obj/item/clothing/head/utility/hardhat/orange{
	name = "protective hat";
	pixel_y = 9
	},
/obj/item/clothing/head/utility/hardhat/orange{
	name = "protective hat";
	pixel_y = 9
	},
/obj/item/clothing/head/utility/hardhat/orange{
	name = "protective hat";
	pixel_y = 9
	},
/obj/item/clothing/head/utility/hardhat/orange{
	name = "protective hat";
	pixel_y = 9
	},
/obj/structure/closet/crate{
	name = "lifejackets"
	},
/obj/effect/turf_decal/bot,
/turf/open/floor/mineral/plastitanium,
/area/shuttle/escape)
"bX" = (
/obj/structure/closet/emcloset,
/obj/effect/turf_decal/box,
/turf/open/floor/mineral/plastitanium,
/area/shuttle/escape)
"bY" = (
/turf/open/floor/iron/dark/corner,
/area/shuttle/escape)
"ca" = (
/obj/machinery/space_heater,
/obj/effect/turf_decal/bot,
/turf/open/floor/iron,
/area/shuttle/escape)
"cb" = (
/obj/machinery/light/small{
	dir = 4
	},
/obj/effect/decal/cleanable/dirt,
/turf/open/floor/iron,
/area/shuttle/escape)
"cd" = (
/obj/structure/chair/fancy/shuttle{
	dir = 8
	},
/obj/machinery/light{
	dir = 4
	},
/turf/open/floor/mineral/plastitanium/red/brig,
/area/shuttle/escape)
"cl" = (
/obj/machinery/holopad{
	pixel_x = 16;
	pixel_y = -16
	},
/turf/open/floor/mineral/plastitanium/red/brig,
/area/shuttle/escape)
"cO" = (
/turf/open/floor/iron,
/area/shuttle/escape)
"cW" = (
/obj/structure/table,
/obj/effect/turf_decal/siding/thinplating_new/light{
	dir = 8
	},
/obj/item/storage/backpack/duffelbag/med/surgery{
	pixel_y = 7
	},
/turf/open/floor/mineral/titanium/blue,
/area/shuttle/escape)
"dy" = (
/obj/item/stack/medical/bruise_pack,
/obj/item/stack/medical/ointment,
/obj/item/stack/medical/gauze,
/obj/structure/table,
/turf/open/floor/mineral/plastitanium,
/area/shuttle/escape)
"dE" = (
/obj/machinery/light{
	dir = 4
	},
/obj/effect/turf_decal/siding/thinplating_new/dark,
/turf/open/floor/carpet/blue,
/area/shuttle/escape)
"ef" = (
/obj/machinery/door/airlock/security/glass{
	name = "Brig";
	req_access_txt = "2"
	},
/obj/machinery/door/firedoor,
/turf/open/floor/mineral/plastitanium/red/brig,
/area/shuttle/escape)
"eB" = (
/turf/open/floor/iron/dark/corner{
	dir = 4
	},
/area/shuttle/escape)
"fb" = (
/obj/machinery/holopad,
/turf/open/floor/iron/dark,
/area/shuttle/escape)
"fi" = (
/obj/structure/chair/fancy/shuttle{
	dir = 1
	},
/obj/machinery/light,
/obj/effect/turf_decal/bot,
/turf/open/floor/mineral/titanium,
/area/shuttle/escape)
"fr" = (
/obj/effect/decal/cleanable/dirt,
/obj/machinery/atmospherics/pipe/simple/orange/hidden{
	dir = 9
	},
/turf/open/floor/iron,
/area/shuttle/escape)
"gU" = (
/obj/machinery/door/airlock/command/glass{
	name = "Cockpit";
	req_access_txt = "19"
	},
/obj/machinery/door/firedoor,
/turf/open/floor/carpet/blue,
/area/shuttle/escape)
"hJ" = (
/obj/machinery/light{
	dir = 4
	},
/obj/effect/decal/cleanable/dirt,
/obj/machinery/atmospherics/pipe/simple/orange/hidden{
	dir = 6
	},
/turf/open/floor/iron,
/area/shuttle/escape)
"jb" = (
/turf/open/floor/iron/white,
/area/shuttle/escape)
"mw" = (
/obj/effect/turf_decal/siding/thinplating_new/dark,
/obj/structure/chair/fancy/corp,
/turf/open/floor/carpet/blue,
/area/shuttle/escape)
"mV" = (
/obj/effect/turf_decal/siding/thinplating_new/light{
	dir = 10
	},
/turf/open/floor/mineral/titanium/blue,
/area/shuttle/escape)
"pq" = (
/obj/machinery/door/airlock/command{
	name = "Emergency Recovery Airlock";
	req_access_txt = "19"
	},
/obj/effect/decal/cleanable/dirt,
/obj/machinery/door/firedoor,
/turf/open/floor/iron,
/area/shuttle/escape)
"rl" = (
/obj/machinery/door/airlock/titanium{
	name = "Emergency Shuttle Airlock"
	},
/obj/structure/fans/tiny,
/turf/open/floor/iron/white,
/area/shuttle/escape)
"rp" = (
/obj/item/radio/intercom{
	dir = 4;
	name = "Station Intercom (General)";
	pixel_y = 27
	},
/obj/structure/chair/fancy/shuttle,
/obj/machinery/light{
	dir = 1
	},
/obj/effect/turf_decal/bot,
/turf/open/floor/mineral/titanium,
/area/shuttle/escape)
"sb" = (
/obj/effect/turf_decal/siding/thinplating_new/light{
	dir = 4
	},
/turf/open/floor/mineral/titanium/blue,
/area/shuttle/escape)
"uD" = (
/obj/structure/chair/fancy/shuttle,
/obj/machinery/light{
	dir = 1
	},
/obj/effect/turf_decal/bot,
/turf/open/floor/mineral/titanium,
/area/shuttle/escape)
"ve" = (
/obj/effect/turf_decal/tile/blue{
	dir = 1
	},
/obj/machinery/holopad{
	pixel_x = 16;
	pixel_y = -16
	},
/turf/open/floor/iron/white,
/area/shuttle/escape)
"wu" = (
/obj/effect/turf_decal/siding/thinplating_new/light,
/turf/open/floor/mineral/titanium/blue,
/area/shuttle/escape)
"AT" = (
/obj/structure/table,
/obj/item/paper_bin{
	pixel_x = -2;
	pixel_y = 8
	},
/obj/item/radio/intercom{
	name = "Station Intercom (General)";
	pixel_y = -31
	},
/turf/open/floor/iron/dark/side{
	dir = 1
	},
/area/shuttle/escape)
"Bg" = (
/obj/effect/turf_decal/siding/thinplating_new/dark{
	dir = 10
	},
/turf/open/floor/carpet/blue,
/area/shuttle/escape)
"BK" = (
/turf/open/floor/iron/dark/corner{
	dir = 8
	},
/area/shuttle/escape)
"BN" = (
/obj/effect/decal/cleanable/dirt,
/obj/machinery/atmospherics/components/binary/dp_vent_pump,
/turf/open/floor/iron,
/area/shuttle/escape)
"Ce" = (
/obj/machinery/atmospherics/pipe/simple/orange/hidden{
	dir = 10
	},
/turf/closed/wall/mineral/titanium/nodiagonal,
/area/shuttle/escape)
"CQ" = (
/obj/effect/decal/cleanable/dirt,
/obj/machinery/atmospherics/pipe/simple/orange/hidden,
/turf/open/floor/iron,
/area/shuttle/escape)
"DK" = (
/obj/effect/decal/cleanable/dirt,
/obj/machinery/atmospherics/components/unary/tank/air,
/turf/open/floor/iron,
/area/shuttle/escape)
"Eg" = (
/obj/structure/table,
/obj/item/storage/firstaid/regular{
	pixel_x = 2;
	pixel_y = 3
	},
/obj/item/storage/firstaid/fire,
/obj/effect/turf_decal/siding/thinplating_new/light{
	dir = 1
	},
/turf/open/floor/mineral/titanium/blue,
/area/shuttle/escape)
"EG" = (
/obj/structure/table,
/obj/item/phone{
	pixel_x = -3;
	pixel_y = 3
	},
/obj/item/cigbutt/cigarbutt{
	pixel_x = 5;
	pixel_y = -1
	},
/turf/open/floor/iron/dark/corner,
/area/shuttle/escape)
"Gk" = (
/obj/effect/turf_decal/delivery,
/obj/structure/reagent_dispensers/fueltank,
/turf/open/floor/iron,
/area/shuttle/escape)
"Kc" = (
/obj/machinery/light{
	dir = 4
	},
/obj/item/kirbyplants{
	icon_state = "plant-10"
	},
/turf/open/floor/mineral/plastitanium,
/area/shuttle/escape)
"Kk" = (
/turf/open/floor/iron/dark/side{
	dir = 8
	},
/area/shuttle/escape)
"Li" = (
/obj/effect/spawner/structure/window/shuttle,
/obj/machinery/door/firedoor/window,
/turf/open/floor/plating,
/area/shuttle/escape)
"LY" = (
/turf/open/floor/iron/dark/side{
	dir = 4
	},
/area/shuttle/escape)
"Ml" = (
/obj/machinery/stasis,
/obj/effect/turf_decal/box,
/obj/machinery/light{
	dir = 1
	},
/turf/open/floor/mineral/titanium/blue,
/area/shuttle/escape)
"PE" = (
/obj/machinery/door/airlock/medical/glass{
	name = "Escape Shuttle Infirmary"
	},
/obj/machinery/door/firedoor,
/turf/open/floor/iron/white,
/area/shuttle/escape)
"PV" = (
/obj/effect/turf_decal/tile/blue{
	dir = 1
	},
/turf/open/floor/iron/white,
/area/shuttle/escape)
"Qj" = (
/obj/machinery/computer/security,
/turf/open/floor/iron/dark/side,
/area/shuttle/escape)
"Rb" = (
/obj/structure/table/optable,
/obj/item/surgical_drapes,
/turf/open/floor/mineral/titanium/blue,
/area/shuttle/escape)
"Rg" = (
/obj/structure/table,
/obj/item/storage/firstaid/regular,
/turf/open/floor/iron/dark/side,
/area/shuttle/escape)
"Ro" = (
/obj/structure/flora/ausbushes/grassybush,
/obj/structure/flora/ausbushes/brflowers,
/turf/open/floor/grass,
/area/shuttle/escape)
"RM" = (
/obj/effect/decal/cleanable/dirt,
/obj/structure/chair/fancy/shuttle{
	dir = 4
	},
/turf/open/floor/iron,
/area/shuttle/escape)
"Sy" = (
/obj/machinery/door/firedoor,
/obj/machinery/door/airlock/medical/glass{
	name = "Escape Shuttle Infirmary"
	},
/turf/open/floor/iron/white,
/area/shuttle/escape)
"TI" = (
/obj/machinery/computer/crew,
/turf/open/floor/iron/dark/side,
/area/shuttle/escape)
"Ui" = (
/turf/open/floor/iron/dark/corner{
	dir = 1
	},
/area/shuttle/escape)
"Vh" = (
/obj/machinery/door/airlock/titanium{
	name = "Emergency Shuttle Airlock"
	},
/obj/docking_port/mobile/emergency{
	dir = 2;
	dwidth = 5;
	height = 14;
	name = "Meta emergency shuttle";
	width = 25
	},
/obj/structure/fans/tiny,
/turf/open/floor/iron/white,
/area/shuttle/escape)
"Vs" = (
/obj/effect/turf_decal/siding/thinplating_new/light{
	dir = 6
	},
/turf/open/floor/mineral/titanium/blue,
/area/shuttle/escape)
"VU" = (
/obj/effect/turf_decal/stripes/line{
	dir = 4
	},
/obj/machinery/recharge_station,
/obj/effect/turf_decal/delivery,
/obj/machinery/light{
	dir = 1
	},
/turf/open/floor/iron,
/area/shuttle/escape)
"Xm" = (
/obj/machinery/door/airlock/titanium{
	name = "Emergency Shuttle Cargo Bay Airlock"
	},
/obj/effect/turf_decal/delivery,
/obj/machinery/door/firedoor,
/turf/open/floor/iron,
/area/shuttle/escape)
"Yo" = (
/obj/effect/decal/cleanable/dirt,
/obj/machinery/atmospherics/pipe/manifold/orange/hidden,
/turf/open/floor/iron,
/area/shuttle/escape)
"Yp" = (
/obj/item/kirbyplants{
	icon_state = "plant-10"
	},
/turf/open/floor/mineral/plastitanium,
/area/shuttle/escape)
"YP" = (
/obj/machinery/computer/operating{
	dir = 8
	},
/obj/machinery/light{
	dir = 1
	},
/turf/open/floor/mineral/titanium/blue,
/area/shuttle/escape)
"ZP" = (
/obj/structure/chair/fancy/shuttle,
/obj/effect/turf_decal/bot,
/turf/open/floor/carpet/grimy,
/area/shuttle/escape)
"ZQ" = (
/obj/effect/decal/cleanable/dirt,
/obj/machinery/suit_storage_unit/standard_unit,
/turf/open/floor/iron,
/area/shuttle/escape)

(1,1,1) = {"
aa
ad
au
au
au
au
au
ad
au
au
au
au
au
ad
aa
"}
(2,1,1) = {"
aa
ad
av
av
av
av
av
ad
av
av
av
av
av
ad
aa
"}
(3,1,1) = {"
ad
ad
ad
Li
Li
Li
ad
ad
ad
Li
Li
Li
ad
ad
ad
"}
(4,1,1) = {"
Li
EG
al
aw
aB
aF
aL
aO
aJ
bd
bd
RM
bd
DK
Li
"}
(5,1,1) = {"
Li
TI
am
aq
aq
aq
Bg
AT
ad
be
hJ
BN
CQ
Yo
bf
"}
(6,1,1) = {"
Li
Qj
an
ax
aR
ax
mw
aC
ad
bf
Ce
bQ
CQ
fr
bf
"}
(7,1,1) = {"
Li
Rg
ao
ax
ax
ax
dE
ar
pq
cb
ad
ZQ
by
by
Li
"}
(8,1,1) = {"
ad
ad
az
ad
gU
ad
az
ad
ad
ad
ad
ad
az
ad
ad
"}
(9,1,1) = {"
ad
bX
ap
Yp
cO
Yp
ap
bX
ad
bh
bh
bh
bh
bD
ad
"}
(10,1,1) = {"
Li
cO
bY
LY
LY
LY
eB
cO
ef
bU
cl
bU
bU
bE
Li
"}
(11,1,1) = {"
ad
aT
bV
bN
aE
aT
ar
bN
ac
bi
bU
bU
bU
bF
Li
"}
(12,1,1) = {"
rl
cO
bV
bN
aI
aT
ar
bN
ad
bs
cd
bs
bs
bG
ad
"}
(13,1,1) = {"
ad
uD
bV
bN
Ro
aT
ar
aS
ad
ad
bt
ad
az
ad
ad
"}
(14,1,1) = {"
rl
cO
bV
bN
aJ
aT
ar
bN
ad
Ml
bj
bu
bz
bH
ad
"}
(15,1,1) = {"
ag
ZP
bV
bN
aE
aT
ar
bN
ac
sb
bk
Vs
bl
bI
Li
"}
(16,1,1) = {"
Li
aT
bV
aP
fb
aP
ar
cO
PE
PV
jb
ve
jb
bJ
Li
"}
(17,1,1) = {"
Li
aT
bV
bN
aE
aT
ar
bN
ac
cW
mV
bl
bv
bK
ad
"}
(18,1,1) = {"
Li
aT
bV
bN
bL
aT
ar
bN
ac
Rb
wu
jb
PV
Eg
ac
"}
(19,1,1) = {"
ad
rp
bV
bN
aE
aT
ar
fi
ad
YP
bm
bv
bl
bM
ac
"}
(20,1,1) = {"
Vh
cO
bV
aP
aP
aP
ar
bN
ba
ad
ac
aN
Sy
ba
ad
"}
(21,1,1) = {"
ad
aT
bV
bN
aE
aT
ar
bN
aJ
VU
bo
bA
bA
bO
ad
"}
(22,1,1) = {"
rl
cO
BK
Kk
Kk
Kk
Ui
cO
Xm
bp
bw
as
be
ca
Li
"}
(23,1,1) = {"
ad
LY
LY
LY
cO
LY
LY
LY
Xm
bp
be
be
be
bP
Li
"}
(24,1,1) = {"
ad
Kc
bW
aA
at
dy
bW
Kc
ag
aG
bq
Gk
bn
bR
ad
"}
(25,1,1) = {"
ad
ad
Li
Li
ad
Li
Li
ad
ad
ad
Li
Li
Li
ad
ad
"}
