//MAP CONVERTED BY dmm2tgm.py THIS HEADER COMMENT PREVENTS RECONVERSION, DO NOT REMOVE
"a" = (
/obj/item/grown/bananapeel,
/turf/open/floor/mineral/bananium,
/area/shuttle/escape)
"c" = (
/mob/living/simple_animal/hostile/retaliate/clown/banana,
/obj/structure/chair/stool/bar,
/turf/open/floor/mineral/bananium,
/area/shuttle/escape)
"d" = (
/turf/closed/wall/mineral/bananium,
/area/shuttle/escape)
"e" = (
/obj/item/grown/bananapeel,
/obj/structure/chair/stool/bar,
/mob/living/simple_animal/hostile/retaliate/clown/mutant/blob,
/turf/open/floor/mineral/bananium,
/area/shuttle/escape)
"f" = (
/obj/effect/decal/cleanable/crayon{
	icon_state = "line";
	color = "#ff0000"
	},
/obj/effect/decal/cleanable/crayon{
	icon_state = "s";
	color = "#ff0000";
	pixel_x = 17;
	pixel_y = 11
	},
/turf/open/floor/mineral/bananium,
/area/shuttle/escape)
"g" = (
/obj/structure/chair/stool/bar{
	dir = 4
	},
/obj/item/grown/bananapeel,
/turf/open/floor/mineral/bananium,
/area/shuttle/escape)
"h" = (
/mob/living/simple_animal/hostile/retaliate/clown,
/obj/effect/decal/cleanable/crayon{
	icon_state = "line";
	color = "#ff0000"
	},
/obj/effect/decal/cleanable/crayon{
	icon_state = "y";
	color = "#ff0000";
	pixel_x = 17;
	pixel_y = 8
	},
/turf/open/floor/mineral/bananium,
/area/shuttle/escape)
"i" = (
/mob/living/simple_animal/hostile/retaliate/clown,
/turf/open/floor/mineral/bananium,
/area/shuttle/escape)
"j" = (
/mob/living/simple_animal/hostile/retaliate/clown,
/obj/item/grown/bananapeel,
/obj/structure/chair/stool/bar,
/turf/open/floor/mineral/bananium,
/area/shuttle/escape)
"k" = (
/turf/open/floor/mineral/bananium,
/area/shuttle/escape)
"l" = (
/obj/structure/shuttle/engine/heater{
	dir = 8
	},
/obj/structure/window/reinforced{
	dir = 4
	},
/turf/closed/wall/mineral/bananium,
/area/shuttle/escape)
"m" = (
/obj/item/grown/bananapeel,
/mob/living/simple_animal/hostile/retaliate/clown/mutant/blob,
/turf/open/floor/mineral/bananium,
/area/shuttle/escape)
"n" = (
/obj/item/grown/bananapeel,
/mob/living/simple_animal/hostile/retaliate/clown/clownhulk/honcmunculus,
/turf/open/floor/mineral/bananium,
/area/shuttle/escape)
"o" = (
/obj/structure/chair/stool/bar,
/turf/open/floor/mineral/bananium,
/area/shuttle/escape)
"p" = (
/mob/living/simple_animal/hostile/retaliate/clown,
/obj/structure/chair/stool/bar{
	dir = 1
	},
/turf/open/floor/mineral/bananium,
/area/shuttle/escape)
"q" = (
/obj/machinery/door/airlock/bananium/glass,
/obj/docking_port/mobile/emergency{
	dir = 2
	},
/turf/open/floor/mineral/bananium,
/area/shuttle/escape)
"r" = (
/obj/machinery/door/airlock/bananium/glass,
/turf/open/floor/mineral/bananium,
/area/shuttle/escape)
"t" = (
/obj/item/grown/bananapeel,
/obj/structure/chair/stool/bar,
/turf/open/floor/mineral/bananium,
/area/shuttle/escape)
"v" = (
/obj/item/grown/bananapeel,
/obj/effect/decal/cleanable/crayon{
	icon_state = "n";
	color = "#0d2dff";
	pixel_x = 17;
	pixel_y = -4
	},
/obj/effect/decal/cleanable/crayon{
	icon_state = "d";
	color = "#0d2dff";
	pixel_x = 17;
	pixel_y = -17
	},
/turf/open/floor/mineral/bananium,
/area/shuttle/escape)
"w" = (
/obj/item/grown/bananapeel,
/obj/effect/decal/cleanable/crayon{
	icon_state = "line";
	color = "#0d2dff"
	},
/mob/living/simple_animal/hostile/retaliate/clown/banana,
/obj/effect/decal/cleanable/crayon{
	icon_state = "line";
	color = "#0d2dff"
	},
/turf/open/floor/mineral/bananium,
/area/shuttle/escape)
"x" = (
/mob/living/simple_animal/hostile/retaliate/clown/mutant,
/turf/open/floor/mineral/bananium,
/area/shuttle/escape)
"y" = (
/obj/structure/chair/stool/bar{
	dir = 4
	},
/turf/open/floor/mineral/bananium,
/area/shuttle/escape)
"z" = (
/obj/structure/table/wood/fancy/orange,
/obj/item/clothing/mask/gas/clown_hat,
/obj/item/clothing/mask/gas/clown_hat,
/obj/item/clothing/mask/gas/clown_hat,
/obj/item/clothing/mask/gas/clown_hat,
/obj/item/clothing/mask/gas/clown_hat,
/obj/item/clothing/mask/gas/clown_hat,
/obj/item/clothing/mask/gas/clown_hat,
/obj/item/clothing/mask/gas/clown_hat,
/obj/item/clothing/mask/gas/clown_hat,
/obj/item/clothing/mask/gas/clown_hat,
/obj/item/clothing/mask/gas/clown_hat,
/obj/item/clothing/mask/gas/clown_hat,
/obj/item/gun/magic/staff/honk,
/turf/open/floor/mineral/bananium,
/area/shuttle/escape)
"A" = (
/obj/structure/chair/stool/bar{
	dir = 1
	},
/turf/open/floor/mineral/bananium,
/area/shuttle/escape)
"B" = (
/obj/machinery/nuclearbomb/syndicate/bananium,
/turf/open/floor/mineral/bananium,
/area/shuttle/escape)
"C" = (
/obj/effect/spawner/structure/window/shuttle,
/turf/open/floor/plating,
/area/shuttle/escape)
"D" = (
/obj/effect/decal/cleanable/crayon{
	icon_state = "line";
	color = "#ff0000"
	},
/turf/open/floor/mineral/bananium,
/area/shuttle/escape)
"E" = (
/mob/living/simple_animal/hostile/retaliate/clown/fleshclown,
/obj/item/grown/bananapeel,
/turf/open/floor/mineral/bananium,
/area/shuttle/escape)
"F" = (
/mob/living/simple_animal/hostile/retaliate/clown,
/obj/item/grown/bananapeel,
/turf/open/floor/mineral/bananium,
/area/shuttle/escape)
"G" = (
/mob/living/simple_animal/hostile/retaliate/clown/clownhulk/destroyer,
/turf/open/floor/mineral/bananium,
/area/shuttle/escape)
"H" = (
/obj/machinery/computer/emergency_shuttle{
	dir = 8
	},
/turf/open/floor/mineral/bananium,
/area/shuttle/escape)
"I" = (
/obj/structure/shuttle/engine/propulsion{
	dir = 8
	},
/turf/closed/wall/mineral/bananium,
/area/shuttle/escape)
"J" = (
/mob/living/simple_animal/hostile/retaliate/clown/clownhulk,
/turf/open/floor/mineral/bananium,
/area/shuttle/escape)
"K" = (
/turf/open/space/basic,
/area/space)
"L" = (
/obj/effect/decal/cleanable/crayon{
	icon_state = "line";
	color = "#ff0000"
	},
/mob/living/simple_animal/hostile/retaliate/clown,
/obj/effect/decal/cleanable/crayon{
	icon_state = "e";
	color = "#ff0000";
	pixel_x = 17;
	pixel_y = 29
	},
/obj/effect/decal/cleanable/crayon{
	icon_state = "c";
	color = "#ff0000";
	pixel_x = 17;
	pixel_y = 16
	},
/obj/effect/decal/cleanable/crayon{
	icon_state = "u";
	color = "#ff0000";
	pixel_x = 17;
	pixel_y = 4
	},
/obj/effect/decal/cleanable/crayon{
	icon_state = "r";
	color = "#ff0000";
	pixel_x = 17;
	pixel_y = -8
	},
/turf/open/floor/mineral/bananium,
/area/shuttle/escape)
"M" = (
/obj/item/grown/bananapeel,
/mob/living/simple_animal/hostile/retaliate/clown,
/obj/effect/decal/cleanable/crayon{
	icon_state = "c";
	color = "#0d2dff";
	pixel_x = 17;
	pixel_y = 18
	},
/obj/effect/decal/cleanable/crayon{
	icon_state = "o";
	color = "#0d2dff";
	pixel_x = 17;
	pixel_y = 6
	},
/obj/effect/decal/cleanable/crayon{
	icon_state = "m";
	color = "#0d2dff";
	pixel_x = 17;
	pixel_y = -4
	},
/obj/effect/decal/cleanable/crayon{
	icon_state = "m";
	color = "#0d2dff";
	pixel_x = 17;
	pixel_y = -16
	},
/obj/effect/decal/cleanable/crayon{
	icon_state = "a";
	color = "#0d2dff";
	pixel_x = 17;
	pixel_y = -26
	},
/turf/open/floor/mineral/bananium,
/area/shuttle/escape)
"N" = (
/obj/item/grown/bananapeel,
/obj/effect/decal/cleanable/crayon{
	icon_state = "line";
	color = "#ff0000"
	},
/turf/open/floor/mineral/bananium,
/area/shuttle/escape)
"O" = (
/mob/living/simple_animal/hostile/retaliate/clown,
/obj/structure/chair/stool/bar{
	dir = 4
	},
/turf/open/floor/mineral/bananium,
/area/shuttle/escape)
"P" = (
/obj/structure/statue/bananium/clown,
/turf/open/floor/mineral/bananium,
/area/shuttle/escape)
"Q" = (
/obj/item/grown/bananapeel,
/obj/item/grown/bananapeel,
/mob/living/simple_animal/hostile/retaliate/clown/banana,
/turf/open/floor/mineral/bananium,
/area/shuttle/escape)
"R" = (
/obj/effect/decal/cleanable/crayon{
	icon_state = "line";
	color = "#0d2dff"
	},
/turf/open/floor/mineral/bananium,
/area/shuttle/escape)
"T" = (
/mob/living/simple_animal/hostile/retaliate/clown,
/obj/structure/chair/stool/bar,
/turf/open/floor/mineral/bananium,
/area/shuttle/escape)
"V" = (
/obj/effect/decal/cleanable/crayon{
	icon_state = "line";
	color = "#ff0000"
	},
/obj/effect/decal/cleanable/crayon{
	icon_state = "i";
	color = "#ff0000";
	pixel_x = 17;
	pixel_y = 10
	},
/obj/effect/decal/cleanable/crayon{
	icon_state = "t";
	color = "#ff0000";
	pixel_x = 17;
	pixel_y = -8
	},
/turf/open/floor/mineral/bananium,
/area/shuttle/escape)
"W" = (
/obj/item/grown/bananapeel,
/obj/effect/decal/cleanable/crayon{
	icon_state = "line";
	color = "#0d2dff"
	},
/turf/open/floor/mineral/bananium,
/area/shuttle/escape)
"X" = (
/obj/structure/chair/stool/bar{
	dir = 1
	},
/mob/living/simple_animal/hostile/retaliate/clown/longface,
/turf/open/floor/mineral/bananium,
/area/shuttle/escape)

(1,1,1) = {"
K
K
I
I
I
I
I
I
I
K
K
"}
(2,1,1) = {"
K
d
l
l
l
l
l
l
l
d
K
"}
(3,1,1) = {"
d
d
P
g
g
g
g
g
P
d
d
"}
(4,1,1) = {"
d
P
z
k
k
J
k
k
z
P
d
"}
(5,1,1) = {"
r
k
N
N
f
L
V
h
D
A
d
"}
(6,1,1) = {"
d
o
k
e
a
t
E
A
k
A
d
"}
(7,1,1) = {"
r
k
x
j
a
t
a
A
k
A
d
"}
(8,1,1) = {"
d
o
k
t
F
t
Q
A
a
A
d
"}
(9,1,1) = {"
d
o
i
o
k
o
G
A
a
A
d
"}
(10,1,1) = {"
d
o
k
o
k
c
k
X
m
A
d
"}
(11,1,1) = {"
d
o
k
o
x
o
i
A
k
A
d
"}
(12,1,1) = {"
d
o
k
T
a
t
a
p
k
A
d
"}
(13,1,1) = {"
q
k
k
a
M
v
n
k
J
A
d
"}
(14,1,1) = {"
d
k
R
w
W
R
W
R
R
A
d
"}
(15,1,1) = {"
d
P
z
y
O
y
O
y
z
P
d
"}
(16,1,1) = {"
d
d
P
k
k
H
B
k
P
d
d
"}
(17,1,1) = {"
K
d
d
C
C
C
C
C
d
d
K
"}
