//MAP CONVERTED BY dmm2tgm.py THIS HEADER COMMENT PREVENTS RECONVERSION, DO NOT REMOVE
"ac" = (
/obj/effect/turf_decal/bot,
/obj/structure/chair/fancy/shuttle{
	dir = 1
	},
/turf/open/floor/mineral/plastitanium/red/brig,
/area/shuttle/escape)
"bh" = (
/obj/machinery/door/airlock/security{
	req_access_txt = "2"
	},
/obj/effect/turf_decal/stripes/closeup{
	dir = 1
	},
/obj/structure/fans/tiny,
/obj/docking_port/mobile/emergency{
	name = "Echo emergency shuttle";
	width = 16
	},
/turf/open/floor/iron/white,
/area/shuttle/escape)
"bm" = (
/obj/structure/table/reinforced,
/obj/item/clothing/head/utility/chefhat{
	pixel_y = 5;
	pixel_x = -3
	},
/turf/open/floor/mineral/plastitanium,
/area/shuttle/escape)
"cg" = (
/obj/effect/turf_decal/trimline/dark/warning{
	dir = 4
	},
/obj/effect/turf_decal/box/corners{
	dir = 4;
	pixel_x = -16;
	pixel_y = -16
	},
/turf/open/floor/mineral/titanium/white,
/area/shuttle/escape)
"ci" = (
/obj/item/kirbyplants{
	icon_state = "plant-21";
	pixel_x = -1;
	pixel_y = 20
	},
/turf/open/floor/mineral/plastitanium,
/area/shuttle/escape)
"cq" = (
/obj/machinery/computer/communications{
	dir = 8
	},
/turf/open/floor/mineral/plastitanium,
/area/shuttle/escape)
"cB" = (
/obj/effect/turf_decal/stripes/line,
/obj/structure/window/reinforced,
/obj/structure/table/reinforced,
/obj/item/bikehorn/rubberducky{
	pixel_y = 10;
	pixel_x = -5
	},
/obj/item/toy/eightball{
	pixel_y = -2;
	pixel_x = 2
	},
/turf/open/floor/mineral/plastitanium,
/area/shuttle/escape)
"ey" = (
/obj/effect/turf_decal/delivery,
/obj/machinery/stasis,
/obj/effect/turf_decal/tile/blue/opposingcorners{
	dir = 1
	},
/obj/machinery/defibrillator_mount/loaded/directional/east,
/turf/open/floor/iron/white,
/area/shuttle/escape)
"gg" = (
/obj/effect/turf_decal/trimline/dark/warning,
/turf/open/floor/mineral/titanium/white,
/area/shuttle/escape)
"gk" = (
/obj/structure/chair/fancy/shuttle,
/obj/effect/turf_decal/bot,
/obj/effect/turf_decal/stripes/line{
	dir = 8
	},
/obj/structure/window/reinforced{
	dir = 8
	},
/turf/open/floor/mineral/plastitanium,
/area/shuttle/escape)
"gy" = (
/obj/effect/turf_decal/trimline/dark/warning{
	dir = 8
	},
/turf/open/floor/mineral/titanium/white,
/area/shuttle/escape)
"hG" = (
/obj/machinery/status_display/evac,
/turf/closed/wall/mineral/titanium/nodiagonal,
/area/shuttle/escape)
"hR" = (
/obj/structure/table/reinforced,
/obj/item/restraints/handcuffs{
	pixel_x = 4;
	pixel_y = 7
	},
/obj/machinery/recharger,
/obj/item/restraints/handcuffs{
	pixel_y = 2
	},
/obj/machinery/light{
	dir = 4
	},
/obj/machinery/camera/directional/east,
/turf/open/floor/mineral/plastitanium/red/brig,
/area/shuttle/escape)
"hT" = (
/obj/effect/turf_decal/bot,
/obj/structure/chair/fancy/shuttle{
	dir = 1
	},
/turf/open/floor/mineral/plastitanium,
/area/shuttle/escape)
"jd" = (
/obj/effect/spawner/structure/window/shuttle,
/obj/structure/grille,
/obj/structure/shuttle/engine/heater,
/obj/machinery/door/firedoor/window,
/turf/open/floor/plating,
/area/shuttle/escape)
"kF" = (
/obj/structure/flora/ausbushes/grassybush,
/obj/structure/flora/ausbushes/lavendergrass,
/obj/structure/flora/ausbushes/ywflowers,
/obj/structure/flora/ausbushes/fernybush,
/obj/structure/window/shuttle,
/turf/open/floor/grass/no_border,
/area/shuttle/escape)
"lm" = (
/obj/effect/turf_decal/bot,
/obj/effect/turf_decal/stripes/line{
	dir = 6
	},
/obj/structure/window/reinforced,
/obj/structure/chair/fancy/shuttle{
	dir = 8
	},
/turf/open/floor/mineral/plastitanium,
/area/shuttle/escape)
"nH" = (
/obj/effect/spawner/structure/window/shuttle,
/obj/machinery/door/firedoor/window,
/obj/structure/curtain/directional{
	dir = 4
	},
/turf/open/floor/plating,
/area/shuttle/escape)
"nL" = (
/turf/closed/wall/mineral/titanium/nodiagonal,
/area/shuttle/escape)
"ot" = (
/obj/machinery/door/airlock/medical/glass{
	name = "Shuttle Infirmary"
	},
/obj/machinery/door/firedoor,
/obj/effect/turf_decal/stripes/closeup{
	dir = 1
	},
/turf/open/floor/iron,
/area/shuttle/escape)
"oC" = (
/obj/structure/table/reinforced,
/obj/item/storage/box/zipties{
	pixel_y = 4
	},
/obj/machinery/recharger,
/obj/structure/window/reinforced{
	dir = 8
	},
/obj/item/storage/fancy/donut_box,
/turf/open/floor/mineral/plastitanium,
/area/shuttle/escape)
"pJ" = (
/obj/effect/turf_decal/stripes/line{
	dir = 8
	},
/turf/open/floor/plating/airless,
/area/shuttle/escape)
"qo" = (
/obj/structure/sign/departments/security{
	pixel_y = 32
	},
/obj/structure/table/reinforced,
/obj/item/flashlight/lamp/green{
	pixel_x = -4;
	pixel_y = 11
	},
/obj/item/toy/crayon/red,
/obj/item/toy/crayon/blue{
	pixel_x = 3
	},
/turf/open/floor/mineral/plastitanium,
/area/shuttle/escape)
"qq" = (
/obj/effect/turf_decal/trimline/dark/warning{
	dir = 4
	},
/turf/open/floor/mineral/titanium/white,
/area/shuttle/escape)
"qV" = (
/obj/effect/turf_decal/stripes/line{
	dir = 10
	},
/obj/effect/turf_decal/bot,
/obj/machinery/camera/directional/north,
/obj/structure/closet/firecloset/full,
/turf/open/floor/mineral/plastitanium,
/area/shuttle/escape)
"rc" = (
/obj/effect/turf_decal/stripes/line{
	dir = 6
	},
/turf/open/floor/plating/airless,
/area/shuttle/escape)
"rp" = (
/obj/effect/turf_decal/trimline/dark/warning{
	dir = 4
	},
/obj/effect/turf_decal/trimline/dark/warning{
	dir = 8
	},
/obj/structure/sink{
	dir = 4;
	pixel_x = 11
	},
/turf/open/floor/mineral/titanium/white,
/area/shuttle/escape)
"rB" = (
/obj/structure/flora/ausbushes/grassybush,
/obj/structure/flora/ausbushes/lavendergrass,
/obj/structure/flora/ausbushes/ywflowers,
/obj/structure/flora/ausbushes/fernybush,
/obj/structure/window/shuttle,
/obj/machinery/door/firedoor/window,
/turf/open/floor/grass/no_border,
/area/shuttle/escape)
"rX" = (
/obj/effect/turf_decal/stripes/line{
	dir = 8
	},
/obj/effect/turf_decal/bot,
/obj/structure/chair/fancy/shuttle{
	dir = 1
	},
/obj/structure/window/reinforced{
	dir = 8
	},
/turf/open/floor/mineral/plastitanium,
/area/shuttle/escape)
"sv" = (
/obj/effect/turf_decal/trimline/dark/warning{
	dir = 4
	},
/obj/effect/turf_decal/trimline/dark/warning{
	dir = 8
	},
/turf/open/floor/mineral/titanium/white,
/area/shuttle/escape)
"ty" = (
/obj/structure/window/shuttle,
/obj/structure/flora/ausbushes/grassybush,
/obj/structure/flora/ausbushes/lavendergrass,
/obj/structure/flora/ausbushes/palebush,
/obj/machinery/door/firedoor/window,
/turf/open/floor/grass/no_border,
/area/shuttle/escape)
"tQ" = (
/obj/structure/chair/fancy/shuttle{
	dir = 4
	},
/obj/effect/turf_decal/bot,
/obj/structure/fireaxecabinet{
	pixel_y = -32
	},
/turf/open/floor/mineral/plastitanium,
/area/shuttle/escape)
"vi" = (
/obj/structure/sign/nanotrasen,
/turf/closed/wall/mineral/titanium/nodiagonal,
/area/shuttle/escape)
"wh" = (
/obj/structure/chair/fancy/shuttle{
	dir = 1
	},
/obj/effect/turf_decal/bot,
/turf/open/floor/mineral/plastitanium/red/brig,
/area/shuttle/escape)
"wR" = (
/turf/closed/wall/mineral/titanium,
/area/shuttle/escape)
"wY" = (
/obj/effect/turf_decal/stripes/closeup{
	dir = 1
	},
/obj/machinery/door/airlock/command{
	name = "Cockpit";
	req_access_txt = "19"
	},
/turf/open/floor/iron,
/area/shuttle/escape)
"xB" = (
/obj/structure/table,
/obj/item/storage/firstaid/fire{
	pixel_x = -2;
	pixel_y = 12
	},
/obj/item/storage/firstaid/regular{
	pixel_x = -6;
	pixel_y = 2
	},
/obj/item/reagent_containers/hypospray/medipen{
	pixel_x = 6
	},
/obj/item/reagent_containers/hypospray/medipen{
	pixel_x = 5;
	pixel_y = -3
	},
/obj/item/reagent_containers/hypospray/medipen{
	pixel_x = 4
	},
/obj/effect/turf_decal/tile/blue/opposingcorners{
	dir = 1
	},
/obj/machinery/light{
	dir = 8
	},
/obj/machinery/vending/wallmed{
	pixel_x = -32;
	pixel_y = 1;
	products = list(/obj/item/stack/medical/gauze = 4, /obj/item/reagent_containers/hypospray/medipen = 6, /obj/item/reagent_containers/hypospray/medipen/dexalin = 3, /obj/item/reagent_containers/glass/bottle/epinephrine = 2, /obj/item/reagent_containers/glass/bottle/charcoal = 2)
	},
/turf/open/floor/iron/white,
/area/shuttle/escape)
"xC" = (
/obj/machinery/shower{
	name = "emergency shower";
	pixel_y = 7
	},
/obj/effect/turf_decal/stripes/line{
	dir = 10
	},
/obj/item/radio/intercom/directional/north,
/turf/open/floor/noslip/dark,
/area/shuttle/escape)
"xX" = (
/turf/template_noop,
/area/shuttle/escape)
"zE" = (
/obj/structure/chair/office/light,
/obj/effect/turf_decal/tile/blue/opposingcorners{
	dir = 1
	},
/turf/open/floor/iron/white,
/area/shuttle/escape)
"zN" = (
/obj/structure/window/shuttle,
/obj/structure/flora/ausbushes/grassybush,
/obj/structure/flora/ausbushes/lavendergrass,
/obj/structure/flora/ausbushes/brflowers,
/obj/machinery/door/firedoor/window,
/turf/open/floor/grass/no_border,
/area/shuttle/escape)
"Ae" = (
/obj/effect/turf_decal/bot,
/obj/effect/turf_decal/stripes/line{
	dir = 1
	},
/obj/structure/chair/fancy/shuttle,
/obj/structure/window/reinforced{
	dir = 1
	},
/turf/open/floor/mineral/plastitanium,
/area/shuttle/escape)
"BB" = (
/obj/machinery/light,
/obj/structure/chair/fancy/shuttle{
	dir = 1
	},
/obj/effect/turf_decal/bot,
/obj/effect/turf_decal/stripes/line{
	dir = 4
	},
/obj/item/storage/pod{
	pixel_x = 6;
	pixel_y = -32
	},
/turf/open/floor/mineral/plastitanium,
/area/shuttle/escape)
"BK" = (
/obj/structure/window/shuttle,
/obj/structure/flora/ausbushes/grassybush,
/obj/structure/flora/ausbushes/lavendergrass,
/obj/structure/flora/ausbushes/ywflowers,
/obj/machinery/door/firedoor/window,
/turf/open/floor/grass/no_border,
/area/shuttle/escape)
"CB" = (
/obj/machinery/light{
	dir = 8
	},
/obj/machinery/camera/directional/west,
/turf/open/floor/circuit/green{
	luminosity = 2
	},
/area/shuttle/escape)
"CD" = (
/obj/effect/turf_decal/stripes/line{
	dir = 4
	},
/obj/effect/turf_decal/caution/stand_clear{
	dir = 4
	},
/turf/open/floor/mineral/plastitanium/red,
/area/shuttle/escape)
"CU" = (
/obj/effect/turf_decal/bot,
/obj/structure/chair/fancy/shuttle{
	dir = 4
	},
/turf/open/floor/mineral/plastitanium,
/area/shuttle/escape)
"Dx" = (
/obj/machinery/door/airlock/security{
	req_access_txt = "2;19"
	},
/obj/effect/turf_decal/stripes/closeup,
/turf/open/floor/iron,
/area/shuttle/escape)
"EA" = (
/obj/effect/turf_decal/stripes/line{
	dir = 4
	},
/turf/open/floor/plating/airless,
/area/shuttle/escape)
"EZ" = (
/obj/structure/reagent_dispensers/peppertank/directional/north,
/turf/open/floor/mineral/plastitanium/red/brig,
/area/shuttle/escape)
"HD" = (
/turf/open/floor/mineral/plastitanium,
/area/shuttle/escape)
"IS" = (
/obj/effect/spawner/structure/window/shuttle,
/obj/machinery/door/firedoor/window,
/turf/open/floor/plating,
/area/shuttle/escape)
"Ju" = (
/obj/machinery/computer/emergency_shuttle{
	dir = 8
	},
/turf/open/floor/mineral/plastitanium,
/area/shuttle/escape)
"JL" = (
/obj/effect/turf_decal/bot,
/obj/structure/chair/fancy/shuttle{
	dir = 1
	},
/obj/machinery/computer/security/telescreen/evac{
	pixel_x = 32;
	dir = 8
	},
/obj/item/radio/intercom/directional/south,
/turf/open/floor/mineral/plastitanium,
/area/shuttle/escape)
"KD" = (
/obj/effect/turf_decal/stripes/line{
	dir = 8
	},
/obj/machinery/door/window/eastright{
	dir = 8
	},
/turf/open/floor/mineral/plastitanium,
/area/shuttle/escape)
"Lv" = (
/obj/effect/turf_decal/bot,
/obj/effect/turf_decal/stripes/line{
	dir = 5
	},
/obj/structure/chair/fancy/shuttle,
/obj/structure/window/reinforced{
	dir = 1
	},
/turf/open/floor/mineral/plastitanium,
/area/shuttle/escape)
"LR" = (
/obj/effect/turf_decal/tile/blue/opposingcorners{
	dir = 1
	},
/turf/open/floor/iron/white,
/area/shuttle/escape)
"Me" = (
/obj/machinery/door/airlock/shuttle{
	name = "Emergency Shuttle Airlock"
	},
/obj/structure/fans/tiny,
/obj/effect/turf_decal/stripes/closeup{
	dir = 1
	},
/turf/open/floor/iron/white,
/area/shuttle/escape)
"Mh" = (
/obj/machinery/button/flasher{
	id = "cockpit_flasher";
	pixel_x = 25;
	pixel_y = -25
	},
/turf/open/floor/mineral/plastitanium/red/brig,
/area/shuttle/escape)
"Ml" = (
/obj/effect/turf_decal/trimline/dark/corner{
	dir = 1
	},
/obj/machinery/holopad{
	pixel_x = 16;
	pixel_y = -16
	},
/obj/effect/turf_decal/box/corners{
	dir = 1;
	pixel_x = 16;
	pixel_y = -16
	},
/turf/open/floor/mineral/titanium/white,
/area/shuttle/escape)
"Ns" = (
/obj/effect/turf_decal/bot,
/obj/machinery/light{
	dir = 1
	},
/obj/effect/turf_decal/stripes/line{
	dir = 4
	},
/obj/structure/chair/fancy/shuttle{
	dir = 8
	},
/turf/open/floor/mineral/plastitanium,
/area/shuttle/escape)
"NC" = (
/obj/structure/flora/ausbushes/grassybush,
/obj/structure/flora/ausbushes/lavendergrass,
/obj/structure/flora/ausbushes/brflowers,
/obj/structure/flora/ausbushes/leafybush,
/obj/structure/window/shuttle,
/turf/open/floor/grass/no_border,
/area/shuttle/escape)
"Og" = (
/obj/structure/chair/fancy/shuttle,
/obj/effect/turf_decal/bot,
/obj/item/storage/pod{
	pixel_x = 5;
	pixel_y = 31
	},
/obj/structure/extinguisher_cabinet/directional/east,
/turf/open/floor/mineral/plastitanium,
/area/shuttle/escape)
"Ow" = (
/obj/effect/turf_decal/trimline/dark/warning{
	dir = 1
	},
/turf/open/floor/mineral/titanium/white,
/area/shuttle/escape)
"OV" = (
/obj/effect/turf_decal/stripes/line{
	dir = 8
	},
/obj/machinery/door/window/eastleft{
	dir = 8
	},
/turf/open/floor/mineral/plastitanium,
/area/shuttle/escape)
"OX" = (
/obj/structure/chair/fancy/shuttle,
/obj/effect/turf_decal/bot,
/turf/open/floor/mineral/plastitanium/red/brig,
/area/shuttle/escape)
"Pm" = (
/obj/effect/turf_decal/trimline/dark/warning{
	dir = 8
	},
/obj/machinery/flasher{
	id = "cockpit_flasher";
	pixel_x = 25;
	pixel_y = 25
	},
/turf/open/floor/mineral/titanium/white,
/area/shuttle/escape)
"Pq" = (
/obj/machinery/light{
	dir = 1
	},
/obj/structure/chair/fancy/shuttle,
/obj/effect/turf_decal/bot,
/turf/open/floor/mineral/plastitanium,
/area/shuttle/escape)
"PI" = (
/obj/effect/turf_decal/trimline/dark/warning,
/obj/effect/turf_decal/box/corners{
	pixel_y = 16;
	dir = 8;
	pixel_x = 16
	},
/turf/open/floor/mineral/titanium/white,
/area/shuttle/escape)
"QB" = (
/obj/effect/turf_decal/tile/blue/opposingcorners{
	dir = 1
	},
/obj/machinery/camera/directional/north,
/turf/open/floor/iron/white,
/area/shuttle/escape)
"QY" = (
/obj/effect/turf_decal/stripes/line{
	dir = 4
	},
/turf/open/floor/mineral/plastitanium,
/area/shuttle/escape)
"RR" = (
/obj/effect/turf_decal/trimline/dark/warning{
	dir = 4
	},
/obj/effect/turf_decal/trimline/dark/corner{
	dir = 8
	},
/obj/structure/sign/departments/medbay/alt{
	pixel_x = 32
	},
/obj/effect/turf_decal/box/corners{
	pixel_x = -16;
	pixel_y = 16
	},
/turf/open/floor/mineral/titanium/white,
/area/shuttle/escape)
"Up" = (
/obj/effect/spawner/structure/window/shuttle,
/obj/structure/grille,
/turf/open/floor/plating,
/area/shuttle/escape)
"UW" = (
/turf/open/floor/mineral/plastitanium/red/brig,
/area/shuttle/escape)
"UX" = (
/obj/machinery/holopad,
/obj/effect/turf_decal/box,
/turf/open/floor/mineral/plastitanium/red/brig,
/area/shuttle/escape)
"Vn" = (
/turf/closed/wall/mineral/plastitanium,
/area/shuttle/escape)
"XA" = (
/obj/structure/closet/emcloset,
/obj/effect/turf_decal/bot,
/obj/effect/turf_decal/trimline/dark/warning{
	dir = 4
	},
/obj/effect/turf_decal/trimline/dark/warning{
	dir = 8
	},
/obj/item/lazarus_injector,
/mob/living/simple_animal/bot/medbot{
	name = "\improper emergency medibot";
	pixel_x = -3;
	pixel_y = 2
	},
/obj/structure/sign/poster/official/help_others{
	pixel_y = -32
	},
/obj/structure/extinguisher_cabinet/directional/east,
/turf/open/floor/mineral/titanium/white,
/area/shuttle/escape)
"Ys" = (
/obj/structure/shuttle/engine/large,
/obj/effect/turf_decal/stripes/line{
	dir = 10
	},
/turf/open/floor/plating/airless,
/area/shuttle/escape)
"Yt" = (
/obj/effect/turf_decal/bot,
/obj/effect/turf_decal/stripes/line{
	dir = 4
	},
/obj/structure/chair/fancy/shuttle{
	dir = 8
	},
/turf/open/floor/mineral/plastitanium,
/area/shuttle/escape)
"YI" = (
/obj/structure/sign/poster/official/state_laws{
	pixel_y = -32
	},
/obj/machinery/holopad,
/obj/effect/turf_decal/box,
/turf/open/floor/mineral/plastitanium,
/area/shuttle/escape)

(1,1,1) = {"
xX
wR
bh
IS
nL
ty
zN
BK
Me
Me
BK
ty
rB
vi
Vn
xX
"}
(2,1,1) = {"
wR
wR
EZ
ac
nL
qo
bm
cB
CD
CD
Ae
HD
hT
jd
pJ
Ys
"}
(3,1,1) = {"
IS
OX
UX
wh
IS
Ns
Yt
lm
Ow
gg
Ae
HD
hT
jd
EA
rc
"}
(4,1,1) = {"
IS
hR
UW
Mh
Dx
Pm
gy
gy
Ml
PI
Lv
QY
BB
nL
wR
xX
"}
(5,1,1) = {"
nL
hG
nH
wY
wR
qV
qq
qq
cg
RR
sv
sv
rp
XA
nL
xX
"}
(6,1,1) = {"
IS
CB
HD
YI
nL
gk
KD
OV
rX
nL
IS
ot
nL
nL
wR
xX
"}
(7,1,1) = {"
IS
oC
CU
tQ
nL
Pq
HD
HD
hT
hG
QB
LR
xB
jd
pJ
Ys
"}
(8,1,1) = {"
wR
wR
Ju
cq
nL
Og
HD
ci
JL
nL
xC
zE
ey
jd
EA
rc
"}
(9,1,1) = {"
xX
wR
Up
Up
nL
nL
kF
NC
nL
nL
IS
IS
nL
vi
Vn
xX
"}
