//MAP CONVERTED BY dmm2tgm.py THIS HEADER COMMENT PREVENTS RECONVERSION, DO NOT REMOVE
"aa" = (
/turf/template_noop,
/area/template_noop)
"ab" = (
/turf/closed/indestructible/riveted/uranium,
/area/shuttle/escape/luxury)
"ac" = (
/obj/machinery/door/airlock/external,
/obj/structure/fans/tiny,
/turf/open/floor/wood{
	broken = 1
	},
/area/shuttle/escape/luxury)
"ad" = (
/obj/machinery/door/airlock/gold,
/obj/effect/forcefield/luxury_shuttle{
	name = "Ticket Booth"
	},
/turf/open/floor/mineral/gold,
/area/shuttle/escape/luxury)
"ae" = (
/obj/docking_port/mobile/emergency{
	dir = 2;
	dwidth = 5;
	height = 14;
	name = "Luxury emergency shuttle";
	width = 25
	},
/obj/machinery/door/airlock/gold,
/obj/effect/forcefield/luxury_shuttle{
	name = "Ticket Booth"
	},
/turf/open/floor/mineral/gold,
/area/shuttle/escape/luxury)
"ag" = (
/turf/open/floor/wood,
/area/shuttle/escape/luxury)
"aj" = (
/turf/open/floor/mineral/gold,
/area/shuttle/escape/luxury)
"ak" = (
/obj/item/kirbyplants{
	icon_state = "plant-10"
	},
/turf/open/floor/mineral/gold,
/area/shuttle/escape/luxury)
"al" = (
/obj/structure/mirror{
	pixel_y = 32
	},
/turf/open/floor/mineral/gold,
/area/shuttle/escape/luxury)
"ap" = (
/obj/structure/toilet{
	dir = 4
	},
/turf/open/floor/mineral/gold,
/area/shuttle/escape/luxury)
"aq" = (
/obj/machinery/door/airlock/gold,
/turf/open/floor/mineral/gold,
/area/shuttle/escape/luxury)
"ar" = (
/obj/structure/shuttle/engine/propulsion{
	dir = 8
	},
/turf/open/floor/plating/airless,
/area/shuttle/escape/luxury)
"as" = (
/obj/structure/shuttle/engine/heater{
	dir = 8
	},
/obj/structure/window/reinforced/spawner/directional/east,
/turf/open/floor/plating/airless,
/area/shuttle/escape/luxury)
"at" = (
/turf/open/floor/carpet,
/area/shuttle/escape/luxury)
"au" = (
/obj/structure/chair/fancy/comfy,
/turf/open/floor/carpet,
/area/shuttle/escape/luxury)
"av" = (
/obj/structure/chair/fancy/comfy{
	dir = 4
	},
/turf/open/floor/mineral/gold,
/area/shuttle/escape/luxury)
"aw" = (
/obj/machinery/computer/communications{
	dir = 8
	},
/turf/open/floor/mineral/gold,
/area/shuttle/escape/luxury)
"ax" = (
/obj/structure/table/wood/fancy,
/obj/item/food/spaghetti/meatballspaghetti,
/turf/open/floor/carpet,
/area/shuttle/escape/luxury)
"ay" = (
/obj/structure/table/wood/fancy,
/obj/item/food/notasandwich,
/turf/open/floor/carpet,
/area/shuttle/escape/luxury)
"az" = (
/obj/structure/table/wood/fancy,
/obj/item/food/spaghetti/pastatomato,
/turf/open/floor/carpet,
/area/shuttle/escape/luxury)
"aC" = (
/obj/structure/table/wood/fancy,
/obj/item/food/enchiladas,
/turf/open/floor/carpet,
/area/shuttle/escape/luxury)
"aE" = (
/obj/structure/table/wood/fancy,
/obj/item/food/burger/baconburger,
/turf/open/floor/carpet,
/area/shuttle/escape/luxury)
"aF" = (
/obj/structure/table/wood/fancy,
/obj/item/food/benedict,
/turf/open/floor/carpet,
/area/shuttle/escape/luxury)
"aG" = (
/obj/structure/table/wood/fancy,
/obj/item/food/cakeslice/chocolate,
/turf/open/floor/carpet,
/area/shuttle/escape/luxury)
"aH" = (
/obj/structure/table/wood/fancy,
/obj/item/food/spaghetti/chowmein,
/turf/open/floor/carpet,
/area/shuttle/escape/luxury)
"aI" = (
/obj/structure/table/wood/fancy,
/obj/item/food/pieslice/dulcedebatata,
/turf/open/floor/carpet,
/area/shuttle/escape/luxury)
"aJ" = (
/obj/structure/table/wood/fancy,
/obj/item/food/salad/validsalad,
/turf/open/floor/carpet,
/area/shuttle/escape/luxury)
"aK" = (
/obj/structure/table/wood/fancy,
/obj/item/food/carneburrito,
/turf/open/floor/carpet,
/area/shuttle/escape/luxury)
"aL" = (
/obj/structure/table/wood/fancy,
/obj/item/food/chawanmushi,
/turf/open/floor/carpet,
/area/shuttle/escape/luxury)
"aM" = (
/obj/machinery/computer/emergency_shuttle{
	dir = 8
	},
/turf/open/floor/mineral/gold,
/area/shuttle/escape/luxury)
"aO" = (
/obj/structure/table/wood/fancy,
/obj/item/food/khachapuri,
/turf/open/floor/carpet,
/area/shuttle/escape/luxury)
"aP" = (
/obj/structure/table/wood/fancy,
/obj/item/food/grilled_cheese_sandwich,
/turf/open/floor/carpet,
/area/shuttle/escape/luxury)
"aQ" = (
/obj/structure/table/wood/fancy,
/obj/item/food/jelliedtoast/cherry,
/turf/open/floor/carpet,
/area/shuttle/escape/luxury)
"aR" = (
/obj/structure/table/wood/fancy,
/obj/item/food/honeybun,
/turf/open/floor/carpet,
/area/shuttle/escape/luxury)
"aT" = (
/obj/structure/table/wood/fancy,
/obj/item/food/spaghetti/copypasta,
/turf/open/floor/carpet,
/area/shuttle/escape/luxury)
"aV" = (
/obj/structure/table/wood/fancy,
/obj/item/food/spaghetti/boiledspaghetti,
/turf/open/floor/carpet,
/area/shuttle/escape/luxury)
"aW" = (
/obj/structure/table/wood/fancy,
/obj/item/food/cherrycupcake,
/turf/open/floor/carpet,
/area/shuttle/escape/luxury)
"aX" = (
/obj/structure/table/wood/fancy,
/obj/item/food/pizza/dank,
/turf/open/floor/carpet,
/area/shuttle/escape/luxury)
"aY" = (
/obj/structure/table/wood/fancy,
/obj/item/food/hotdog,
/turf/open/floor/carpet,
/area/shuttle/escape/luxury)
"aZ" = (
/obj/structure/table/wood/fancy,
/obj/item/food/pie/grapetart,
/turf/open/floor/carpet,
/area/shuttle/escape/luxury)
"ba" = (
/obj/structure/table/wood/fancy,
/obj/item/food/burger/superbite,
/turf/open/floor/carpet,
/area/shuttle/escape/luxury)
"bb" = (
/obj/structure/table/wood/fancy,
/obj/item/food/cakeslice/slimecake,
/turf/open/floor/carpet,
/area/shuttle/escape/luxury)
"bc" = (
/obj/machinery/computer/station_alert{
	dir = 8
	},
/turf/open/floor/mineral/gold,
/area/shuttle/escape/luxury)
"bd" = (
/obj/structure/chair/fancy/comfy{
	dir = 1
	},
/turf/open/floor/carpet,
/area/shuttle/escape/luxury)
"be" = (
/obj/machinery/computer/crew{
	dir = 8
	},
/turf/open/floor/mineral/gold,
/area/shuttle/escape/luxury)
"bf" = (
/obj/machinery/stasis,
/turf/open/floor/mineral/gold,
/area/shuttle/escape/luxury)
"bi" = (
/obj/machinery/light,
/turf/open/floor/mineral/gold,
/area/shuttle/escape/luxury)
"bj" = (
/obj/machinery/light{
	dir = 8
	},
/turf/open/floor/mineral/gold,
/area/shuttle/escape/luxury)
"bk" = (
/obj/machinery/light{
	dir = 4
	},
/turf/open/floor/mineral/gold,
/area/shuttle/escape/luxury)
"bl" = (
/obj/item/kirbyplants{
	icon_state = "plant-10"
	},
/obj/machinery/light{
	dir = 8
	},
/turf/open/floor/mineral/gold,
/area/shuttle/escape/luxury)
"cu" = (
/obj/item/kirbyplants{
	icon_state = "plant-21";
	pixel_x = -3;
	pixel_y = 3
	},
/obj/effect/turf_decal/pool{
	dir = 4
	},
/turf/open/floor/mineral/gold,
/area/shuttle/escape/luxury)
"cx" = (
/obj/structure/table/wood/fancy,
/obj/item/food/honkdae,
/turf/open/floor/carpet,
/area/shuttle/escape/luxury)
"ex" = (
/obj/machinery/light/small,
/turf/open/floor/wood{
	broken = 1
	},
/area/shuttle/escape/luxury)
"hA" = (
/obj/structure/table/optable,
/obj/item/surgical_drapes,
/turf/open/floor/mineral/gold,
/area/shuttle/escape/luxury)
"js" = (
/obj/structure/table/wood/fancy,
/obj/item/food/candiedapple,
/turf/open/floor/carpet,
/area/shuttle/escape/luxury)
"nZ" = (
/obj/item/pool/pool_noodle,
/turf/open/indestructible/sound/pool,
/area/shuttle/escape/luxury)
"rw" = (
/obj/structure/table/wood/fancy,
/obj/item/food/bearsteak,
/turf/open/floor/carpet,
/area/shuttle/escape/luxury)
"vB" = (
/obj/item/kirbyplants{
	icon_state = "plant-21";
	pixel_x = -3;
	pixel_y = 3
	},
/obj/machinery/light,
/obj/effect/turf_decal/pool{
	dir = 8
	},
/turf/open/floor/mineral/gold,
/area/shuttle/escape/luxury)
"wf" = (
/obj/item/kirbyplants{
	icon_state = "plant-21";
	pixel_x = -3;
	pixel_y = 3
	},
/obj/machinery/light,
/obj/effect/turf_decal/pool{
	dir = 4
	},
/turf/open/floor/mineral/gold,
/area/shuttle/escape/luxury)
"zg" = (
/obj/machinery/vending/wallmed,
/turf/closed/indestructible/riveted/uranium,
/area/shuttle/escape/luxury)
"Be" = (
/obj/structure/table/wood/fancy,
/obj/item/food/eggplantparm,
/turf/open/floor/carpet,
/area/shuttle/escape/luxury)
"Cx" = (
/turf/open/floor/wood{
	broken = 1
	},
/area/shuttle/escape/luxury)
"CU" = (
/obj/effect/turf_decal/pool/corner,
/turf/open/floor/mineral/gold,
/area/shuttle/escape/luxury)
"Eg" = (
/obj/structure/table/wood/fancy,
/obj/item/food/melonfruitbowl,
/turf/open/floor/carpet,
/area/shuttle/escape/luxury)
"Jr" = (
/obj/effect/turf_decal/pool,
/turf/open/floor/mineral/gold,
/area/shuttle/escape/luxury)
"OL" = (
/obj/item/surgicaldrill,
/obj/item/scalpel,
/obj/item/retractor,
/obj/item/cautery,
/obj/item/hemostat,
/obj/item/circular_saw,
/obj/structure/table/wood/fancy,
/turf/open/floor/mineral/gold,
/area/shuttle/escape/luxury)
"SN" = (
/obj/structure/table/wood/fancy,
/obj/item/food/kebab/tofu,
/turf/open/floor/carpet,
/area/shuttle/escape/luxury)
"Ui" = (
/obj/item/pool/rubber_ring,
/turf/open/indestructible/sound/pool,
/area/shuttle/escape/luxury)
"Vf" = (
/turf/open/indestructible/sound/pool,
/area/shuttle/escape/luxury)
"Vm" = (
/obj/effect/turf_decal/pool/corner{
	dir = 4
	},
/turf/open/floor/mineral/gold,
/area/shuttle/escape/luxury)
"Vq" = (
/obj/item/kirbyplants{
	icon_state = "plant-21";
	pixel_x = -3;
	pixel_y = 3
	},
/obj/effect/turf_decal/pool{
	dir = 8
	},
/turf/open/floor/mineral/gold,
/area/shuttle/escape/luxury)

(1,1,1) = {"
aa
ab
ab
ab
ab
ar
ar
ar
ar
ab
ab
ab
ab
aa
"}
(2,1,1) = {"
ab
ab
Cx
ab
ab
as
as
as
as
ab
bf
hA
ab
ab
"}
(3,1,1) = {"
ab
Cx
ag
ab
ab
ab
ab
ab
ab
zg
aj
aj
zg
ab
"}
(4,1,1) = {"
ab
ag
ex
ab
bl
aj
aj
aj
aj
bj
aj
aj
OL
ab
"}
(5,1,1) = {"
ab
ag
ag
ab
aj
at
at
at
at
aj
aj
aj
aj
ab
"}
(6,1,1) = {"
ab
ag
ag
ab
aj
au
ax
Eg
bd
aj
CU
cu
wf
ab
"}
(7,1,1) = {"
ab
Cx
ag
ab
aj
au
ay
aO
bd
aj
Jr
Vf
Vf
ab
"}
(8,1,1) = {"
ab
ag
ag
ab
aj
au
az
aP
bd
aj
Jr
nZ
Vf
ab
"}
(9,1,1) = {"
ab
ag
ag
ab
aj
au
SN
aQ
bd
aj
Jr
Vf
Vf
ab
"}
(10,1,1) = {"
ab
Cx
ex
ab
aj
au
cx
aR
bd
aj
Jr
Vf
Ui
ab
"}
(11,1,1) = {"
ab
ag
ag
ab
aj
au
aC
Be
bd
aj
Jr
Vf
Vf
ab
"}
(12,1,1) = {"
ac
ag
Cx
ab
aj
au
js
aT
bd
aj
Jr
Vf
Vf
ab
"}
(13,1,1) = {"
ab
ab
ab
ab
aj
au
aE
rw
bd
aj
Jr
Vf
Vf
ab
"}
(14,1,1) = {"
ad
aj
aj
bj
aj
au
aF
aV
bd
aj
Jr
nZ
Vf
ab
"}
(15,1,1) = {"
ab
aj
aj
aj
aj
au
aG
aW
bd
aj
Jr
Vf
Vf
ab
"}
(16,1,1) = {"
ab
aj
aj
aj
aj
au
aH
aX
bd
aj
Jr
Vf
Vf
ab
"}
(17,1,1) = {"
ab
aj
aj
aj
aj
au
aI
aY
bd
aj
Jr
Vf
Vf
ab
"}
(18,1,1) = {"
ab
aj
aj
aj
aj
au
aJ
aZ
bd
aj
Jr
Ui
Vf
ab
"}
(19,1,1) = {"
ab
aj
aj
aj
aj
au
aK
ba
bd
aj
Jr
Vf
Vf
ab
"}
(20,1,1) = {"
ae
aj
aj
bk
aj
au
aL
bb
bd
aj
Vm
Vq
vB
ab
"}
(21,1,1) = {"
ab
ab
ab
ab
aj
at
at
at
at
aj
aj
aj
aj
ab
"}
(22,1,1) = {"
ab
ak
ap
ab
aj
aj
aj
aj
aj
aj
aj
aj
aj
ab
"}
(23,1,1) = {"
ab
aj
bi
ab
aj
av
av
av
av
aj
aj
aj
aj
ab
"}
(24,1,1) = {"
ab
al
aj
aq
bk
aw
aM
bc
be
bk
aj
aj
ak
ab
"}
(25,1,1) = {"
ab
ab
ab
ab
ab
ab
ab
ab
ab
ab
ab
ab
ab
ab
"}
