//MAP CONVERTED BY dmm2tgm.py THIS HEADER COMMENT PREVENTS RECONVERSION, DO NOT REMOVE
"aa" = (
/turf/template_noop,
/area/template_noop)
"ab" = (
/obj/structure/shuttle/engine/propulsion{
	dir = 1
	},
/obj/effect/turf_decal/stripes/line{
	dir = 1
	},
/turf/open/floor/plating/airless,
/area/shuttle/escape)
"ac" = (
/turf/closed/wall/mineral/plastitanium,
/area/shuttle/escape)
"ad" = (
/obj/structure/window/reinforced,
/obj/structure/shuttle/engine/heater{
	dir = 1
	},
/obj/effect/turf_decal/stripes/line{
	dir = 1
	},
/turf/open/floor/plating/airless,
/area/shuttle/escape)
"ae" = (
/turf/closed/wall/mineral/titanium/nodiagonal,
/area/shuttle/escape)
"af" = (
/turf/closed/wall/mineral/titanium,
/area/shuttle/escape)
"ag" = (
/obj/structure/window/shuttle,
/obj/structure/grille,
/turf/open/floor/plating,
/area/shuttle/escape)
"ah" = (
/obj/item/clothing/suit/hazardvest{
	desc = "A high-visibility lifejacket complete with whistle and slot for oxygen tanks.";
	name = "emergency lifejacket"
	},
/obj/item/clothing/suit/hazardvest{
	desc = "A high-visibility lifejacket complete with whistle and slot for oxygen tanks.";
	name = "emergency lifejacket"
	},
/obj/item/clothing/suit/hazardvest{
	desc = "A high-visibility lifejacket complete with whistle and slot for oxygen tanks.";
	name = "emergency lifejacket"
	},
/obj/item/clothing/suit/hazardvest{
	desc = "A high-visibility lifejacket complete with whistle and slot for oxygen tanks.";
	name = "emergency lifejacket"
	},
/obj/item/clothing/suit/hazardvest{
	desc = "A high-visibility lifejacket complete with whistle and slot for oxygen tanks.";
	name = "emergency lifejacket"
	},
/obj/item/tank/internals/emergency_oxygen{
	pixel_x = 3
	},
/obj/item/tank/internals/emergency_oxygen{
	pixel_x = 3
	},
/obj/item/tank/internals/emergency_oxygen{
	pixel_x = 3
	},
/obj/item/tank/internals/emergency_oxygen{
	pixel_x = 3
	},
/obj/item/tank/internals/emergency_oxygen{
	pixel_x = 3
	},
/obj/item/clothing/mask/breath{
	pixel_x = -3;
	pixel_y = -3
	},
/obj/item/clothing/mask/breath{
	pixel_x = -3;
	pixel_y = -3
	},
/obj/item/clothing/mask/breath{
	pixel_x = -3;
	pixel_y = -3
	},
/obj/item/clothing/mask/breath{
	pixel_x = -3;
	pixel_y = -3
	},
/obj/item/clothing/mask/breath{
	pixel_x = -3;
	pixel_y = -3
	},
/obj/item/clothing/head/hardhat/orange{
	name = "protective hat";
	pixel_y = 9
	},
/obj/item/clothing/head/hardhat/orange{
	name = "protective hat";
	pixel_y = 9
	},
/obj/item/clothing/head/hardhat/orange{
	name = "protective hat";
	pixel_y = 9
	},
/obj/item/clothing/head/hardhat/orange{
	name = "protective hat";
	pixel_y = 9
	},
/obj/item/clothing/head/hardhat/orange{
	name = "protective hat";
	pixel_y = 9
	},
/obj/structure/closet/crate/internals,
/obj/effect/turf_decal/bot,
/turf/open/floor/plasteel,
/area/shuttle/escape)
"aq" = (
/obj/machinery/status_display/evac,
/turf/closed/wall/mineral/titanium,
/area/shuttle/escape)
"av" = (
/obj/structure/chair/fancy/shuttle{
	dir = 4
	},
/obj/effect/turf_decal/bot,
/turf/open/floor/plasteel,
/area/shuttle/escape)
"aw" = (
/obj/structure/chair/fancy/shuttle{
	dir = 8
	},
/obj/effect/turf_decal/bot,
/turf/open/floor/plasteel,
/area/shuttle/escape)
"ax" = (
/obj/structure/flora/ausbushes/grassybush,
/obj/structure/flora/ausbushes/lavendergrass,
/obj/structure/flora/ausbushes/brflowers,
/obj/structure/flora/ausbushes/leafybush,
/obj/structure/window/shuttle,
/turf/open/floor/grass,
/area/shuttle/escape)
"aC" = (
/obj/machinery/status_display/ai,
/turf/closed/wall/mineral/titanium/nodiagonal,
/area/shuttle/escape)
"aD" = (
/obj/machinery/status_display/evac,
/turf/closed/wall/mineral/titanium/nodiagonal,
/area/shuttle/escape)
"aE" = (
/obj/effect/turf_decal/delivery,
/turf/open/floor/plasteel,
/area/shuttle/escape)
"aH" = (
/obj/structure/chair/fancy/shuttle{
	dir = 4
	},
/obj/item/radio_abstract/intercom{
	name = "Station Intercom";
	pixel_x = -26
	},
/obj/effect/turf_decal/bot,
/turf/open/floor/plasteel,
/area/shuttle/escape)
"aI" = (
/obj/structure/flora/ausbushes/grassybush,
/obj/structure/flora/ausbushes/lavendergrass,
/obj/structure/flora/ausbushes/ywflowers,
/obj/structure/flora/ausbushes/genericbush,
/obj/structure/window/shuttle,
/turf/open/floor/grass,
/area/shuttle/escape)
"aK" = (
/obj/structure/extinguisher_cabinet,
/turf/closed/wall/mineral/titanium/nodiagonal,
/area/shuttle/escape)
"aP" = (
/obj/structure/sign/departments/medbay/alt,
/turf/closed/wall/mineral/titanium,
/area/shuttle/escape)
"aT" = (
/obj/structure/sign/nanotrasen,
/turf/closed/wall/mineral/titanium,
/area/shuttle/escape)
"aU" = (
/obj/effect/turf_decal/bot,
/obj/machinery/light{
	dir = 8
	},
/turf/open/floor/plasteel,
/area/shuttle/escape)
"aX" = (
/obj/structure/flora/ausbushes/grassybush,
/obj/structure/flora/ausbushes/lavendergrass,
/obj/structure/flora/ausbushes/ppflowers,
/obj/structure/flora/ausbushes/sunnybush,
/obj/structure/window/shuttle,
/turf/open/floor/grass,
/area/shuttle/escape)
"aY" = (
/obj/structure/extinguisher_cabinet{
	pixel_x = -26
	},
/obj/machinery/shieldgen,
/obj/effect/turf_decal/bot,
/turf/open/floor/plasteel,
/area/shuttle/escape)
"aZ" = (
/obj/structure/rack,
/obj/item/storage/toolbox/electrical{
	pixel_x = -3;
	pixel_y = 1
	},
/obj/item/storage/toolbox/mechanical{
	pixel_y = -1
	},
/obj/item/storage/toolbox/emergency{
	pixel_x = 3;
	pixel_y = -5
	},
/obj/effect/turf_decal/bot,
/obj/machinery/light/small{
	dir = 1
	},
/turf/open/floor/plasteel,
/area/shuttle/escape)
"ba" = (
/obj/structure/reagent_dispensers/fueltank,
/obj/item/radio_abstract/intercom{
	name = "Station Intercom";
	pixel_x = -26
	},
/obj/effect/turf_decal/bot,
/turf/open/floor/plasteel,
/area/shuttle/escape)
"bb" = (
/obj/effect/turf_decal/stripes/line{
	dir = 9
	},
/turf/open/floor/plasteel,
/area/shuttle/escape)
"bc" = (
/obj/effect/turf_decal/stripes/line{
	dir = 5
	},
/turf/open/floor/plasteel,
/area/shuttle/escape)
"bd" = (
/obj/structure/closet/crate/medical,
/obj/item/storage/firstaid/regular,
/obj/item/storage/firstaid/o2{
	pixel_x = 3;
	pixel_y = 3
	},
/obj/item/storage/firstaid/toxin{
	pixel_x = -4;
	pixel_y = 3
	},
/obj/item/healthanalyzer{
	pixel_x = 3;
	pixel_y = 3
	},
/obj/item/lazarus_injector,
/obj/effect/turf_decal/bot,
/mob/living/simple_animal/bot/medbot{
	name = "\improper emergency medibot";
	pixel_x = -3;
	pixel_y = 2
	},
/turf/open/floor/plasteel,
/area/shuttle/escape)
"be" = (
/obj/structure/flora/ausbushes/grassybush,
/obj/structure/flora/ausbushes/lavendergrass,
/obj/structure/flora/ausbushes/ywflowers,
/obj/structure/flora/ausbushes/fernybush,
/obj/structure/window/shuttle,
/turf/open/floor/grass,
/area/shuttle/escape)
"bf" = (
/obj/structure/reagent_dispensers/watertank,
/obj/effect/turf_decal/bot,
/turf/open/floor/plasteel,
/area/shuttle/escape)
"bg" = (
/obj/effect/turf_decal/stripes/line{
	dir = 8
	},
/turf/open/floor/plasteel,
/area/shuttle/escape)
"bh" = (
/obj/effect/turf_decal/stripes/line{
	dir = 4
	},
/turf/open/floor/plasteel,
/area/shuttle/escape)
"bi" = (
/obj/structure/closet/crate{
	name = "emergency supplies crate"
	},
/obj/item/storage/toolbox/emergency,
/obj/item/storage/toolbox/emergency,
/obj/item/flashlight/flare{
	pixel_x = 3;
	pixel_y = 3
	},
/obj/item/flashlight/flare{
	pixel_x = -6;
	pixel_y = -2
	},
/obj/item/crowbar,
/obj/item/wrench,
/obj/item/radio_abstract/walkie_talkie,
/obj/effect/turf_decal/bot,
/turf/open/floor/plasteel,
/area/shuttle/escape)
"bj" = (
/obj/machinery/vending/wallmed{
	name = "Emergency NanoMed";
	use_power = 0
	},
/turf/closed/wall/mineral/titanium/nodiagonal,
/area/shuttle/escape)
"bl" = (
/obj/structure/rack,
/obj/item/clothing/suit/fire/firefighter,
/obj/item/tank/internals/oxygen/red,
/obj/item/clothing/mask/gas,
/obj/item/clothing/head/hardhat/red,
/obj/effect/turf_decal/bot,
/obj/machinery/light{
	dir = 8
	},
/turf/open/floor/plasteel,
/area/shuttle/escape)
"bm" = (
/obj/effect/turf_decal/stripes/line{
	dir = 10
	},
/turf/open/floor/plasteel,
/area/shuttle/escape)
"bn" = (
/obj/effect/turf_decal/stripes/line{
	dir = 6
	},
/turf/open/floor/plasteel,
/area/shuttle/escape)
"bq" = (
/obj/structure/table,
/obj/item/clipboard,
/obj/item/folder/yellow,
/obj/item/pen,
/obj/item/hand_labeler_refill,
/obj/effect/turf_decal/bot,
/turf/open/floor/plasteel,
/area/shuttle/escape)
"br" = (
/obj/machinery/recharge_station,
/obj/effect/turf_decal/delivery,
/turf/open/floor/plasteel,
/area/shuttle/escape)
"bs" = (
/obj/structure/table,
/obj/machinery/cell_charger,
/obj/item/stock_parts/cell/high,
/obj/effect/turf_decal/bot,
/turf/open/floor/plasteel,
/area/shuttle/escape)
"bw" = (
/turf/open/floor/mineral/plastitanium/red/brig,
/area/shuttle/escape)
"bx" = (
/obj/structure/chair/fancy/shuttle,
/turf/open/floor/mineral/plastitanium/red/brig,
/area/shuttle/escape)
"by" = (
/obj/structure/table/reinforced,
/obj/machinery/recharger,
/turf/open/floor/mineral/plastitanium/red/brig,
/area/shuttle/escape)
"bz" = (
/obj/item/kirbyplants{
	icon_state = "plant-21"
	},
/obj/machinery/button/flasher{
	id = "shuttleflash";
	pixel_x = -26;
	pixel_y = 24
	},
/obj/effect/turf_decal/tile/red{
	dir = 1
	},
/turf/open/floor/plasteel,
/area/shuttle/escape)
"bA" = (
/obj/item/kirbyplants{
	icon_state = "plant-21"
	},
/obj/effect/turf_decal/tile/neutral{
	dir = 4
	},
/turf/open/floor/plasteel,
/area/shuttle/escape)
"bB" = (
/obj/structure/table,
/obj/item/clipboard,
/obj/item/toy/figure/ninja,
/obj/effect/turf_decal/bot,
/turf/open/floor/plasteel,
/area/shuttle/escape)
"bC" = (
/obj/structure/chair/fancy/shuttle,
/obj/effect/turf_decal/bot,
/turf/open/floor/plasteel,
/area/shuttle/escape)
"bD" = (
/obj/structure/chair/fancy/shuttle,
/obj/machinery/status_display/evac{
	pixel_y = 32
	},
/obj/effect/turf_decal/bot,
/turf/open/floor/plasteel,
/area/shuttle/escape)
"bE" = (
/obj/structure/chair/fancy/shuttle{
	dir = 4
	},
/turf/open/floor/mineral/plastitanium/red/brig,
/area/shuttle/escape)
"bF" = (
/obj/effect/turf_decal/tile/red{
	dir = 1
	},
/turf/open/floor/plasteel,
/area/shuttle/escape)
"bG" = (
/obj/structure/extinguisher_cabinet{
	pixel_x = 26
	},
/obj/machinery/light{
	dir = 4
	},
/obj/effect/turf_decal/tile/neutral{
	dir = 4
	},
/turf/open/floor/plasteel,
/area/shuttle/escape)
"bH" = (
/turf/open/floor/plasteel,
/area/shuttle/escape)
"bI" = (
/obj/effect/turf_decal/tile/neutral,
/turf/open/floor/plasteel,
/area/shuttle/escape)
"bK" = (
/obj/effect/turf_decal/tile/neutral{
	dir = 8
	},
/turf/open/floor/plasteel,
/area/shuttle/escape)
"bL" = (
/obj/machinery/door/airlock/external{
	name = "Emergency Recovery Airlock"
	},
/obj/effect/turf_decal/stripes/line{
	dir = 8
	},
/turf/open/floor/plasteel,
/area/shuttle/escape)
"bM" = (
/obj/structure/chair/fancy/shuttle{
	dir = 4
	},
/obj/machinery/status_display/evac{
	pixel_x = -32
	},
/turf/open/floor/mineral/plastitanium/red/brig,
/area/shuttle/escape)
"bN" = (
/obj/structure/chair/fancy/shuttle{
	dir = 8
	},
/turf/open/floor/mineral/plastitanium/red/brig,
/area/shuttle/escape)
"bO" = (
/obj/structure/table/reinforced,
/obj/item/storage/lockbox/loyalty,
/turf/open/floor/mineral/plastitanium/red/brig,
/area/shuttle/escape)
"bP" = (
/obj/structure/table/reinforced,
/obj/machinery/recharger,
/obj/effect/turf_decal/tile/red{
	dir = 8
	},
/turf/open/floor/plasteel,
/area/shuttle/escape)
"bQ" = (
/obj/structure/fireaxecabinet{
	pixel_x = 32
	},
/obj/effect/turf_decal/tile/neutral,
/turf/open/floor/plasteel,
/area/shuttle/escape)
"bR" = (
/obj/machinery/door/airlock/external{
	name = "Emergency Recovery Airlock"
	},
/obj/effect/turf_decal/stripes/line,
/turf/open/floor/plasteel,
/area/shuttle/escape)
"bS" = (
/obj/effect/turf_decal/tile/neutral{
	dir = 4
	},
/turf/open/floor/plasteel,
/area/shuttle/escape)
"bT" = (
/obj/effect/turf_decal/tile/neutral{
	dir = 1
	},
/turf/open/floor/plasteel,
/area/shuttle/escape)
"bU" = (
/obj/structure/chair/fancy/shuttle{
	dir = 1
	},
/turf/open/floor/mineral/plastitanium/red/brig,
/area/shuttle/escape)
"bV" = (
/obj/structure/table/reinforced,
/obj/item/storage/box/zipties,
/obj/item/radio_abstract/intercom{
	name = "Station Intercom";
	pixel_y = -26
	},
/turf/open/floor/mineral/plastitanium/red/brig,
/area/shuttle/escape)
"bW" = (
/obj/structure/table/reinforced,
/obj/item/paper_bin,
/obj/item/pen,
/obj/effect/turf_decal/tile/red{
	dir = 8
	},
/turf/open/floor/plasteel,
/area/shuttle/escape)
"bZ" = (
/obj/machinery/suit_storage_unit/standard_unit,
/obj/effect/turf_decal/delivery,
/turf/open/floor/plasteel,
/area/shuttle/escape)
"co" = (
/obj/effect/turf_decal/tile/blue/half/contrasted{
	dir = 8
	},
/turf/open/floor/plasteel,
/area/shuttle/escape)
"cB" = (
/obj/structure/chair/fancy/shuttle{
	dir = 8
	},
/obj/effect/turf_decal/bot,
/obj/machinery/light{
	dir = 4
	},
/turf/open/floor/plasteel,
/area/shuttle/escape)
"cC" = (
/obj/effect/turf_decal/bot,
/turf/open/floor/plasteel,
/area/shuttle/escape)
"cF" = (
/obj/machinery/light,
/turf/open/floor/plasteel,
/area/shuttle/escape)
"cG" = (
/obj/structure/chair/fancy/shuttle{
	dir = 1
	},
/obj/machinery/light,
/turf/open/floor/mineral/plastitanium/red/brig,
/area/shuttle/escape)
"cH" = (
/obj/effect/turf_decal/bot,
/obj/machinery/light/small,
/turf/open/floor/plasteel,
/area/shuttle/escape)
"dr" = (
/obj/machinery/computer/communications{
	dir = 1
	},
/obj/effect/turf_decal/tile/blue/half/contrasted{
	dir = 8
	},
/turf/open/floor/plasteel/dark,
/area/shuttle/escape)
"dX" = (
/obj/machinery/computer/operating,
/obj/effect/turf_decal/tile/blue/opposingcorners{
	dir = 1
	},
/turf/open/floor/plasteel/white,
/area/shuttle/escape)
"eY" = (
/obj/machinery/door/airlock/medical/glass{
	name = "Escape Shuttle Infirmary"
	},
/obj/effect/turf_decal/stripes/line{
	dir = 8
	},
/obj/machinery/door/firedoor,
/turf/open/floor/plasteel,
/area/shuttle/escape)
"hB" = (
/obj/effect/spawner/structure/window/shuttle,
/turf/open/floor/plating,
/area/shuttle/escape)
"jP" = (
/obj/structure/table/reinforced,
/obj/machinery/cell_charger,
/obj/item/stock_parts/cell/high,
/obj/effect/turf_decal/tile/neutral/fourcorners/contrasted,
/turf/open/floor/plasteel/dark,
/area/shuttle/escape)
"kc" = (
/obj/effect/turf_decal/tile/blue/half/contrasted{
	dir = 8
	},
/turf/open/floor/plasteel/white,
/area/shuttle/escape)
"nv" = (
/obj/machinery/computer/crew{
	dir = 1
	},
/obj/effect/turf_decal/tile/blue/half/contrasted{
	dir = 8
	},
/turf/open/floor/plasteel/dark,
/area/shuttle/escape)
"oq" = (
/obj/structure/bed/roller,
/obj/machinery/iv_drip,
/obj/effect/turf_decal/tile/blue/half/contrasted{
	dir = 8
	},
/turf/open/floor/plasteel/white,
/area/shuttle/escape)
"pa" = (
/obj/item/radio_abstract/intercom{
	name = "Station Intercom";
	pixel_y = 58
	},
/obj/effect/turf_decal/tile/neutral/half/contrasted{
	dir = 8
	},
/turf/open/floor/plasteel,
/area/shuttle/escape)
"qL" = (
/obj/item/radio_abstract/intercom{
	name = "Station Intercom";
	pixel_x = 26;
	pixel_y = 58
	},
/obj/effect/turf_decal/tile/blue/opposingcorners{
	dir = 1
	},
/turf/open/floor/plasteel/white,
/area/shuttle/escape)
"rY" = (
/obj/effect/turf_decal/tile/neutral/half/contrasted{
	dir = 4
	},
/turf/open/floor/plasteel,
/area/shuttle/escape)
"sc" = (
/obj/structure/chair/office,
/obj/effect/turf_decal/tile/neutral/fourcorners/contrasted,
/turf/open/floor/plasteel/dark,
/area/shuttle/escape)
"sN" = (
/obj/machinery/computer/security{
	dir = 4
	},
/obj/effect/turf_decal/tile/red/anticorner/contrasted{
	dir = 1
	},
/turf/open/floor/plasteel/dark,
/area/shuttle/escape)
"sU" = (
/obj/item/kirbyplants{
	icon_state = "plant-21";
	pixel_x = -3;
	pixel_y = 3
	},
/obj/machinery/light{
	dir = 1
	},
/obj/effect/turf_decal/tile/neutral/fourcorners/contrasted,
/turf/open/floor/plasteel/dark,
/area/shuttle/escape)
"tw" = (
/obj/machinery/computer/secure_data{
	dir = 4
	},
/obj/effect/turf_decal/tile/red/anticorner/contrasted{
	dir = 8
	},
/turf/open/floor/plasteel/dark,
/area/shuttle/escape)
"uc" = (
/obj/structure/chair/office/light{
	dir = 1
	},
/obj/effect/turf_decal/tile/blue/opposingcorners{
	dir = 1
	},
/turf/open/floor/plasteel/white,
/area/shuttle/escape)
"vm" = (
/obj/machinery/stasis,
/obj/effect/turf_decal/tile/blue/opposingcorners{
	dir = 1
	},
/turf/open/floor/plasteel/white,
/area/shuttle/escape)
"vA" = (
/obj/machinery/shower{
	dir = 8;
	name = "emergency shower"
	},
/obj/effect/turf_decal/tile/blue/half/contrasted,
/turf/open/floor/plasteel/white,
/area/shuttle/escape)
"wW" = (
/obj/structure/table/reinforced,
/obj/machinery/recharger,
/obj/effect/turf_decal/tile/neutral/fourcorners/contrasted,
/turf/open/floor/plasteel/dark,
/area/shuttle/escape)
"zd" = (
/obj/machinery/door/airlock/command{
	name = "Emergency Recovery Airlock";
	req_access_txt = "19"
	},
/obj/effect/turf_decal/stripes/line{
	dir = 8
	},
/obj/machinery/door/firedoor,
/turf/open/floor/plasteel,
/area/shuttle/escape)
"zl" = (
/obj/item/kirbyplants{
	icon_state = "plant-21";
	pixel_x = -3;
	pixel_y = 3
	},
/obj/machinery/light{
	dir = 4
	},
/obj/effect/turf_decal/tile/neutral/half/contrasted,
/turf/open/floor/plasteel,
/area/shuttle/escape)
"zr" = (
/obj/structure/table/reinforced,
/obj/item/folder/red,
/obj/item/restraints/handcuffs,
/obj/item/assembly/flash/handheld,
/obj/effect/turf_decal/tile/neutral/fourcorners/contrasted,
/turf/open/floor/plasteel/dark,
/area/shuttle/escape)
"zW" = (
/obj/effect/turf_decal/tile/neutral/fourcorners/contrasted,
/turf/open/floor/plasteel,
/area/shuttle/escape)
"Af" = (
/obj/structure/table/optable,
/obj/item/surgical_drapes,
/obj/effect/turf_decal/tile/blue/opposingcorners{
	dir = 1
	},
/turf/open/floor/plasteel/white,
/area/shuttle/escape)
"Ay" = (
/obj/machinery/door/airlock/shuttle{
	name = "Emergency Shuttle Airlock"
	},
/obj/effect/turf_decal/stripes/line{
	dir = 8
	},
/obj/structure/fans/tiny,
/turf/open/floor/plasteel/white,
/area/shuttle/escape)
"AG" = (
/obj/machinery/computer/med_data{
	dir = 4
	},
/obj/effect/turf_decal/tile/blue/half/contrasted{
	dir = 4
	},
/turf/open/floor/plasteel/white,
/area/shuttle/escape)
"Cl" = (
/obj/effect/turf_decal/tile/blue/half/contrasted{
	dir = 4
	},
/turf/open/floor/plasteel/white,
/area/shuttle/escape)
"Dx" = (
/obj/machinery/computer/station_alert{
	dir = 8
	},
/obj/effect/turf_decal/tile/yellow/anticorner/contrasted{
	dir = 4
	},
/turf/open/floor/plasteel/dark,
/area/shuttle/escape)
"Ec" = (
/obj/item/scalpel{
	pixel_y = 12
	},
/obj/item/circular_saw,
/obj/item/retractor{
	pixel_x = 4
	},
/obj/item/hemostat{
	pixel_x = -4
	},
/obj/item/clothing/gloves/color/latex,
/obj/item/clothing/mask/surgical,
/obj/structure/table/reinforced,
/obj/item/surgicaldrill,
/obj/item/cautery,
/obj/effect/turf_decal/tile/blue/opposingcorners{
	dir = 1
	},
/turf/open/floor/plasteel/white,
/area/shuttle/escape)
"Ej" = (
/obj/machinery/door/airlock/security/glass{
	name = "Holding Area";
	req_access_txt = "2"
	},
/obj/machinery/door/firedoor,
/turf/open/floor/mineral/plastitanium/red/brig,
/area/shuttle/escape)
"Eu" = (
/obj/structure/table/reinforced,
/obj/item/storage/firstaid/regular,
/obj/effect/turf_decal/tile/neutral/fourcorners/contrasted,
/turf/open/floor/plasteel/dark,
/area/shuttle/escape)
"Ey" = (
/obj/machinery/door/airlock/shuttle{
	name = "Emergency Shuttle Cargo"
	},
/obj/effect/turf_decal/stripes/line{
	dir = 8
	},
/obj/machinery/door/firedoor,
/turf/open/floor/plasteel,
/area/shuttle/escape)
"Gd" = (
/obj/item/reagent_containers/glass/bottle/epinephrine{
	pixel_x = 6
	},
/obj/item/reagent_containers/glass/bottle/charcoal{
	pixel_x = -3
	},
/obj/item/reagent_containers/glass/bottle/epinephrine{
	pixel_x = -3;
	pixel_y = 8
	},
/obj/item/reagent_containers/glass/bottle/charcoal{
	pixel_x = 6;
	pixel_y = 8
	},
/obj/item/reagent_containers/syringe/epinephrine{
	pixel_x = 3;
	pixel_y = -2
	},
/obj/item/reagent_containers/syringe/epinephrine{
	pixel_x = 4;
	pixel_y = 1
	},
/obj/item/reagent_containers/syringe/epinephrine{
	pixel_x = -2;
	pixel_y = 5
	},
/obj/item/reagent_containers/syringe/epinephrine{
	pixel_x = 2;
	pixel_y = 8
	},
/obj/structure/table/reinforced,
/obj/machinery/light{
	dir = 8
	},
/obj/effect/turf_decal/tile/blue/opposingcorners{
	dir = 1
	},
/turf/open/floor/plasteel/white,
/area/shuttle/escape)
"Gg" = (
/obj/structure/chair/office{
	dir = 8
	},
/obj/effect/turf_decal/tile/neutral/fourcorners/contrasted,
/turf/open/floor/plasteel/dark,
/area/shuttle/escape)
"Hh" = (
/obj/machinery/door/airlock/command/glass{
	name = "Cockpit";
	req_access_txt = "19"
	},
/obj/effect/turf_decal/stripes/line,
/obj/machinery/door/firedoor,
/turf/open/floor/plasteel,
/area/shuttle/escape)
"IG" = (
/obj/item/kirbyplants{
	icon_state = "plant-21";
	pixel_x = -3;
	pixel_y = 3
	},
/obj/effect/turf_decal/tile/neutral/half/contrasted{
	dir = 1
	},
/turf/open/floor/plasteel{
	heat_capacity = 1e+006
	},
/area/shuttle/escape)
"Kr" = (
/obj/structure/table/reinforced,
/obj/item/paper_bin,
/obj/item/pen,
/obj/effect/turf_decal/tile/neutral/fourcorners/contrasted,
/turf/open/floor/plasteel/dark,
/area/shuttle/escape)
"Ky" = (
/obj/effect/spawner/structure/window/shuttle,
/obj/machinery/door/firedoor/window,
/turf/open/floor/plating,
/area/shuttle/escape)
"KD" = (
/obj/machinery/door/airlock/shuttle{
	name = "Emergency Shuttle Airlock";
	req_access_txt = "2"
	},
/obj/effect/turf_decal/stripes/line{
	dir = 8
	},
/obj/structure/fans/tiny,
/turf/open/floor/plasteel/white,
/area/shuttle/escape)
"LM" = (
/obj/machinery/light{
	dir = 1
	},
/obj/effect/turf_decal/tile/neutral/half/contrasted{
	dir = 4
	},
/turf/open/floor/plasteel,
/area/shuttle/escape)
"Ml" = (
/obj/effect/turf_decal/tile/neutral/fourcorners/contrasted,
/turf/open/floor/plasteel/dark,
/area/shuttle/escape)
"Mo" = (
/obj/item/kirbyplants{
	icon_state = "plant-21";
	pixel_x = -3;
	pixel_y = 3
	},
/obj/machinery/light{
	dir = 8
	},
/obj/effect/turf_decal/tile/neutral/half/contrasted{
	dir = 1
	},
/turf/open/floor/plasteel{
	heat_capacity = 1e+006
	},
/area/shuttle/escape)
"MY" = (
/obj/structure/sink{
	dir = 4;
	pixel_x = 11
	},
/obj/effect/turf_decal/tile/blue/opposingcorners{
	dir = 1
	},
/turf/open/floor/plasteel/white,
/area/shuttle/escape)
"Np" = (
/obj/item/storage/firstaid/toxin,
/obj/item/storage/firstaid/o2{
	pixel_x = 3;
	pixel_y = 3
	},
/obj/structure/table/reinforced,
/obj/effect/turf_decal/tile/blue/anticorner/contrasted{
	dir = 4
	},
/turf/open/floor/plasteel/white,
/area/shuttle/escape)
"Pe" = (
/obj/structure/chair/office{
	dir = 4
	},
/obj/effect/turf_decal/tile/neutral/fourcorners/contrasted,
/turf/open/floor/plasteel/dark,
/area/shuttle/escape)
"Pm" = (
/obj/item/storage/firstaid/fire,
/obj/item/storage/firstaid/regular{
	pixel_x = 2;
	pixel_y = 3
	},
/obj/structure/table/reinforced,
/obj/effect/turf_decal/tile/blue/half/contrasted,
/turf/open/floor/plasteel/white,
/area/shuttle/escape)
"Qa" = (
/obj/machinery/flasher{
	id = "shuttleflash";
	pixel_y = -26
	},
/obj/machinery/light,
/obj/effect/turf_decal/tile/neutral/half/contrasted{
	dir = 8
	},
/turf/open/floor/plasteel,
/area/shuttle/escape)
"Qc" = (
/obj/structure/table/reinforced,
/obj/item/storage/toolbox/mechanical,
/obj/effect/turf_decal/tile/neutral/fourcorners/contrasted,
/turf/open/floor/plasteel/dark,
/area/shuttle/escape)
"Qw" = (
/obj/structure/chair/office/light{
	dir = 8
	},
/obj/effect/turf_decal/tile/blue/half/contrasted{
	dir = 4
	},
/turf/open/floor/plasteel/white,
/area/shuttle/escape)
"QW" = (
/obj/structure/table/reinforced,
/obj/item/storage/fancy/donut_box,
/obj/effect/turf_decal/tile/neutral/fourcorners/contrasted,
/turf/open/floor/plasteel/dark,
/area/shuttle/escape)
"Rn" = (
/obj/machinery/computer/atmos_alert{
	dir = 8
	},
/obj/effect/turf_decal/tile/yellow/anticorner/contrasted,
/turf/open/floor/plasteel/dark,
/area/shuttle/escape)
"Ss" = (
/obj/effect/turf_decal/tile/blue/opposingcorners{
	dir = 1
	},
/turf/open/floor/plasteel/white,
/area/shuttle/escape)
"TQ" = (
/obj/machinery/door/airlock/shuttle{
	name = "Emergency Shuttle Airlock"
	},
/obj/docking_port/mobile/emergency{
	dwidth = 11;
	height = 18;
	name = "Delta emergency shuttle";
	port_direction = 4;
	preferred_direction = 2;
	width = 29
	},
/obj/structure/fans/tiny,
/turf/open/floor/plating,
/area/shuttle/escape)
"Vu" = (
/obj/effect/turf_decal/tile/neutral/half/contrasted{
	dir = 8
	},
/turf/open/floor/plasteel,
/area/shuttle/escape)
"VI" = (
/obj/structure/bed/roller,
/obj/machinery/iv_drip,
/obj/structure/extinguisher_cabinet{
	pixel_x = 26
	},
/obj/machinery/light/small{
	dir = 4
	},
/obj/effect/turf_decal/tile/blue/anticorner/contrasted,
/turf/open/floor/plasteel/white,
/area/shuttle/escape)
"Wk" = (
/obj/machinery/computer/emergency_shuttle{
	dir = 1
	},
/obj/effect/turf_decal/tile/blue/anticorner/contrasted{
	dir = 8
	},
/turf/open/floor/plasteel/dark,
/area/shuttle/escape)
"WL" = (
/obj/structure/table/reinforced,
/obj/item/folder/blue,
/obj/item/pen,
/obj/effect/turf_decal/tile/neutral/fourcorners/contrasted,
/turf/open/floor/plasteel/dark,
/area/shuttle/escape)
"Xq" = (
/obj/machinery/computer/med_data{
	dir = 1
	},
/obj/effect/turf_decal/tile/blue/anticorner/contrasted,
/turf/open/floor/plasteel/dark,
/area/shuttle/escape)
"Yt" = (
/obj/machinery/door/airlock/medical/glass{
	name = "Escape Shuttle Infirmary"
	},
/obj/effect/turf_decal/stripes/line,
/obj/machinery/door/firedoor,
/turf/open/floor/plasteel,
/area/shuttle/escape)
"Zl" = (
/obj/item/defibrillator/loaded,
/obj/structure/table/reinforced,
/obj/effect/turf_decal/tile/blue/opposingcorners{
	dir = 1
	},
/turf/open/floor/plasteel/white,
/area/shuttle/escape)
"ZB" = (
/obj/item/radio_abstract/intercom{
	name = "Station Intercom";
	pixel_x = 26;
	pixel_y = 58
	},
/obj/effect/turf_decal/tile/neutral/fourcorners/contrasted,
/turf/open/floor/plasteel/dark,
/area/shuttle/escape)

(1,1,1) = {"
aa
ac
ae
af
af
Ky
Ky
af
af
Ay
aT
TQ
af
Ky
Ky
Ky
af
Ay
af
KD
af
af
af
af
aa
aa
aa
aa
aa
"}
(2,1,1) = {"
ab
ad
af
ah
Mo
av
av
aH
IG
aE
aU
aE
IG
av
av
av
Mo
aE
af
bw
bE
bM
bU
af
aa
aa
aa
aa
aa
"}
(3,1,1) = {"
ab
ad
Ky
rY
zW
zW
zW
zW
zW
zW
zW
zW
zW
zW
zW
zW
zW
Vu
Ej
bw
bw
bw
bU
Ky
aa
aa
aa
aa
aa
"}
(4,1,1) = {"
ab
ad
Ky
rY
zW
aw
aw
aw
aw
aw
zW
aw
aw
aw
aw
aw
zW
Vu
af
bx
bw
bw
cG
af
aa
aa
aa
aa
aa
"}
(5,1,1) = {"
ac
ac
af
rY
zW
ax
aC
aI
aK
ax
zW
aX
aK
be
aD
aX
zW
Vu
hB
bx
bw
bN
bU
af
af
aT
Ky
af
af
"}
(6,1,1) = {"
ab
ad
af
LM
zW
av
av
av
av
av
zW
av
av
av
av
av
zW
Vu
af
by
bw
bO
bV
af
wW
sN
tw
Kr
af
"}
(7,1,1) = {"
ab
ad
Ky
rY
zW
zW
zW
zW
zW
zW
zW
zW
zW
zW
zW
zW
zW
Qa
af
af
Ej
hB
aT
af
sU
Gg
Gg
zr
Ky
"}
(8,1,1) = {"
ac
ac
af
LM
zW
aw
aw
aw
aw
aw
zW
aw
aw
aw
aw
aw
zW
Vu
hB
bz
bF
bP
bW
aq
Ml
Ml
sc
nv
Ky
"}
(9,1,1) = {"
ab
ad
Ky
rY
zW
ax
aD
aI
aK
ax
zW
aX
aC
be
bj
aX
zW
Vu
Hh
rY
zW
zW
co
Hh
Ml
Ml
Eu
Xq
Ky
"}
(10,1,1) = {"
ab
ad
Ky
rY
zW
av
av
av
av
av
zW
av
av
av
av
av
zW
Vu
Hh
rY
zW
zW
co
Hh
Ml
Ml
WL
Wk
Ky
"}
(11,1,1) = {"
ac
ac
af
rY
zW
zW
zW
zW
zW
zW
zW
zW
zW
zW
zW
zW
zW
Vu
hB
bA
bG
bQ
bI
aq
Ml
ZB
sc
dr
Ky
"}
(12,1,1) = {"
ab
ad
Ky
ah
zl
aw
aE
aE
aw
aw
cB
aw
aw
aw
aE
aE
zl
ah
af
aT
af
af
zd
af
sU
Pe
Pe
Qc
Ky
"}
(13,1,1) = {"
ab
ad
af
af
aq
ag
eY
eY
ag
aP
af
af
af
af
Ey
Ey
af
af
af
bB
bH
bR
cH
af
QW
Dx
Rn
jP
af
"}
(14,1,1) = {"
ac
ac
af
Zl
Gd
AG
aE
aE
oq
vm
af
aY
ba
bf
aE
aE
bl
bq
af
bC
cF
ae
af
af
af
aT
Ky
af
af
"}
(15,1,1) = {"
ab
ad
Ky
dX
uc
Qw
zW
zW
kc
Ss
Yt
aE
bb
bg
bg
bg
bm
br
af
bD
bI
bS
bZ
af
aa
aa
aa
aa
aa
"}
(16,1,1) = {"
ab
ad
Ky
Af
qL
Cl
zW
zW
kc
Ss
Yt
aE
bc
bh
bh
bh
bn
br
af
bC
pa
rY
bZ
Ky
aa
aa
aa
aa
aa
"}
(17,1,1) = {"
ab
ad
af
Ec
MY
Np
Pm
vA
VI
vm
aP
aZ
bd
bi
cC
cC
ah
bs
af
ah
bK
bT
bZ
af
aa
aa
aa
aa
aa
"}
(18,1,1) = {"
aa
ac
ae
af
Ky
Ky
Ky
Ky
af
af
aT
af
Ky
Ky
Ky
Ky
Ky
af
af
Ky
bL
bL
Ky
af
aa
aa
aa
aa
aa
"}
