//MAP CONVERTED BY dmm2tgm.py THIS HEADER COMMENT PREVENTS RECONVERSION, DO NOT REMOVE
"ae" = (
/obj/effect/turf_decal/tile/dark_blue/half/contrasted{
	alpha = 180;
	dir = 8
	},
/turf/open/floor/iron/dark,
/area/shuttle/escape)
"av" = (
/obj/structure/table/optable,
/obj/item/storage/backpack/duffelbag/med/surgery,
/obj/effect/turf_decal/tile/blue/opposingcorners,
/turf/open/floor/iron/white,
/area/shuttle/escape)
"aw" = (
/obj/structure/chair/fancy/comfy{
	buildstackamount = 0;
	color = "#c45c57";
	dir = 1
	},
/turf/open/floor/carpet/black,
/area/shuttle/escape)
"bs" = (
/obj/structure/table/reinforced,
/obj/item/storage/firstaid,
/obj/effect/turf_decal/tile/dark_blue/half/contrasted{
	alpha = 180;
	dir = 1
	},
/turf/open/floor/iron/dark,
/area/shuttle/escape)
"bw" = (
/obj/structure/window/reinforced/tinted,
/obj/structure/window/reinforced/tinted{
	dir = 1
	},
/obj/structure/chair/fancy/comfy{
	buildstackamount = 0;
	color = "#c45c57";
	dir = 8
	},
/turf/open/floor/carpet/black,
/area/shuttle/escape)
"cJ" = (
/obj/effect/turf_decal/tile/dark_blue/half/contrasted{
	alpha = 180;
	dir = 1
	},
/turf/open/floor/iron/dark,
/area/shuttle/escape)
"cP" = (
/obj/machinery/computer/slot_machine,
/obj/structure/window/reinforced/tinted{
	dir = 4
	},
/turf/open/floor/carpet/black,
/area/shuttle/escape)
"dC" = (
/obj/structure/window/reinforced/tinted,
/obj/structure/chair/fancy/comfy{
	buildstackamount = 0;
	color = "#c45c57";
	dir = 8
	},
/turf/open/floor/carpet/black,
/area/shuttle/escape)
"em" = (
/obj/structure/table/reinforced,
/obj/machinery/recharger,
/turf/open/floor/mineral/plastitanium/red/brig,
/area/shuttle/escape)
"fE" = (
/obj/effect/turf_decal/tile/dark_blue/anticorner/contrasted{
	dir = 4
	},
/turf/open/floor/iron/dark,
/area/shuttle/escape)
"fK" = (
/obj/machinery/computer/apc_control{
	dir = 8
	},
/obj/effect/turf_decal/tile/dark_blue/half/contrasted,
/turf/open/floor/iron/dark,
/area/shuttle/escape)
"gt" = (
/obj/effect/spawner/structure/window/shuttle,
/turf/open/floor/plating,
/area/shuttle/escape)
"gO" = (
/obj/machinery/computer/slot_machine,
/obj/effect/turf_decal/tile/blue/opposingcorners,
/turf/open/floor/iron/white,
/area/shuttle/escape)
"hi" = (
/obj/machinery/door/airlock/gold,
/turf/open/floor/carpet/green,
/area/shuttle/escape)
"hJ" = (
/obj/structure/chair/fancy/comfy{
	buildstackamount = 0;
	color = "#c45c57"
	},
/turf/open/floor/carpet/black,
/area/shuttle/escape)
"ii" = (
/obj/docking_port/mobile/emergency,
/obj/machinery/door/airlock/gold,
/turf/open/floor/carpet/green,
/area/shuttle/escape)
"le" = (
/obj/machinery/door/airlock/security/glass{
	name = "Brig";
	req_access_txt = "2"
	},
/turf/open/floor/mineral/plastitanium/red/brig,
/area/shuttle/escape)
"lx" = (
/obj/structure/chair/fancy/comfy{
	buildstackamount = 0;
	color = "#c45c57"
	},
/obj/structure/window/reinforced/tinted{
	dir = 4
	},
/obj/structure/window/reinforced/tinted{
	dir = 8
	},
/turf/open/floor/carpet/black,
/area/shuttle/escape)
"lE" = (
/obj/structure/chair/fancy/comfy{
	buildstackamount = 0;
	color = "#c45c57"
	},
/obj/structure/window/reinforced/tinted{
	dir = 4
	},
/turf/open/floor/carpet/black,
/area/shuttle/escape)
"lH" = (
/obj/structure/table/reinforced,
/obj/item/defibrillator/compact/loaded,
/obj/item/defibrillator/compact/loaded,
/obj/effect/turf_decal/tile/blue/opposingcorners,
/turf/open/floor/iron/white,
/area/shuttle/escape)
"mY" = (
/turf/closed/wall/mineral/titanium,
/area/shuttle/escape)
"nj" = (
/obj/structure/chair/fancy/comfy{
	buildstackamount = 0;
	color = "#c45c57";
	dir = 8
	},
/obj/effect/turf_decal/tile/blue/opposingcorners,
/turf/open/floor/iron/white,
/area/shuttle/escape)
"nN" = (
/obj/machinery/computer/slot_machine,
/obj/structure/window/reinforced/tinted{
	dir = 8
	},
/obj/structure/window/reinforced/tinted{
	dir = 4
	},
/turf/open/floor/carpet/black,
/area/shuttle/escape)
"os" = (
/obj/machinery/computer/slot_machine,
/obj/effect/turf_decal/tile/dark_blue/half/contrasted{
	alpha = 180;
	dir = 1
	},
/turf/open/floor/iron/dark,
/area/shuttle/escape)
"pg" = (
/obj/effect/turf_decal/tile/dark_blue/half/contrasted,
/turf/open/floor/iron/dark,
/area/shuttle/escape)
"qd" = (
/obj/machinery/vending/medical,
/obj/effect/turf_decal/tile/blue/opposingcorners,
/turf/open/floor/iron/white,
/area/shuttle/escape)
"rC" = (
/turf/open/floor/carpet/black,
/area/shuttle/escape)
"sb" = (
/obj/machinery/computer/security{
	dir = 8
	},
/obj/effect/turf_decal/tile/dark_blue/anticorner/contrasted,
/turf/open/floor/iron/dark,
/area/shuttle/escape)
"so" = (
/obj/machinery/computer/slot_machine,
/obj/structure/window/reinforced/tinted,
/obj/structure/window/reinforced/tinted{
	dir = 1
	},
/obj/structure/window/reinforced/tinted{
	dir = 4
	},
/turf/open/floor/carpet/black,
/area/shuttle/escape)
"tN" = (
/obj/structure/window/reinforced/tinted,
/obj/structure/window/reinforced/tinted{
	dir = 1
	},
/obj/machinery/computer/slot_machine,
/obj/structure/window/reinforced/tinted{
	dir = 8
	},
/turf/open/floor/carpet/black,
/area/shuttle/escape)
"un" = (
/obj/structure/chair/fancy/comfy{
	buildstackamount = 0;
	color = "#c45c57";
	dir = 4
	},
/turf/open/floor/carpet/green,
/area/shuttle/escape)
"up" = (
/obj/machinery/computer/slot_machine,
/obj/structure/window/reinforced/tinted,
/obj/structure/window/reinforced/tinted{
	dir = 4
	},
/turf/open/floor/carpet/black,
/area/shuttle/escape)
"uM" = (
/obj/machinery/door/airlock/command{
	name = "Cockpit";
	req_access_txt = "19"
	},
/turf/open/floor/mineral/plastitanium,
/area/shuttle/escape)
"vS" = (
/obj/structure/chair/fancy/shuttle{
	dir = 1
	},
/obj/effect/turf_decal/tile/dark_blue/opposingcorners,
/turf/open/floor/iron/dark,
/area/shuttle/escape)
"wj" = (
/obj/structure/shuttle/engine/propulsion,
/turf/open/floor/plating,
/area/shuttle/escape)
"wJ" = (
/obj/machinery/computer/operating,
/obj/effect/turf_decal/tile/blue/opposingcorners,
/turf/open/floor/iron/white,
/area/shuttle/escape)
"xd" = (
/obj/structure/chair/fancy/comfy{
	buildstackamount = 0;
	color = "#c45c57";
	dir = 4
	},
/obj/structure/window/reinforced/tinted,
/turf/open/floor/carpet/black,
/area/shuttle/escape)
"xm" = (
/obj/machinery/light/small{
	dir = 8
	},
/obj/structure/table/reinforced,
/obj/item/storage/firstaid{
	pixel_x = 3;
	pixel_y = 3
	},
/obj/item/storage/firstaid/fire,
/obj/effect/turf_decal/tile/blue/opposingcorners,
/turf/open/floor/iron/white,
/area/shuttle/escape)
"xr" = (
/turf/template_noop,
/area/template_noop)
"xD" = (
/obj/structure/window/reinforced/tinted,
/obj/machinery/computer/slot_machine,
/obj/structure/window/reinforced/tinted{
	dir = 8
	},
/turf/open/floor/carpet/black,
/area/shuttle/escape)
"yB" = (
/obj/structure/table/glass,
/obj/item/book/manual/wiki/medicine,
/obj/item/stack/medical/gauze,
/turf/open/floor/iron/white,
/area/shuttle/escape)
"Am" = (
/obj/effect/turf_decal/tile/dark_blue/fourcorners/contrasted,
/turf/open/floor/iron/dark,
/area/shuttle/escape)
"Bv" = (
/obj/structure/table/wood/poker,
/turf/open/floor/carpet/black,
/area/shuttle/escape)
"Cf" = (
/obj/structure/chair/fancy/shuttle{
	dir = 8
	},
/turf/open/floor/mineral/plastitanium/red/brig,
/area/shuttle/escape)
"Ci" = (
/obj/machinery/computer/atmos_alert{
	dir = 8
	},
/obj/effect/turf_decal/tile/dark_blue/half/contrasted,
/turf/open/floor/iron/dark,
/area/shuttle/escape)
"CQ" = (
/obj/machinery/computer/crew{
	dir = 8
	},
/obj/effect/turf_decal/tile/dark_blue/half/contrasted,
/turf/open/floor/iron/dark,
/area/shuttle/escape)
"Dh" = (
/obj/machinery/computer/slot_machine,
/obj/effect/turf_decal/tile/dark_blue/half/contrasted{
	alpha = 180;
	dir = 4
	},
/turf/open/floor/iron/dark,
/area/shuttle/escape)
"Dq" = (
/obj/structure/shuttle/engine/heater,
/obj/structure/window/reinforced{
	dir = 1
	},
/turf/open/floor/plating,
/area/shuttle/escape)
"Dy" = (
/obj/structure/table/reinforced,
/obj/machinery/recharger,
/obj/effect/turf_decal/tile/dark_blue/half/contrasted,
/turf/open/floor/iron/dark,
/area/shuttle/escape)
"FM" = (
/obj/structure/chair/fancy/comfy{
	buildstackamount = 0;
	color = "#c45c57";
	dir = 4
	},
/obj/structure/window/reinforced/tinted,
/obj/structure/window/reinforced/tinted{
	dir = 1
	},
/turf/open/floor/carpet/black,
/area/shuttle/escape)
"FP" = (
/obj/effect/turf_decal/tile/dark_blue/opposingcorners{
	dir = 1
	},
/turf/open/floor/iron/dark,
/area/shuttle/escape)
"HW" = (
/obj/machinery/door/airlock/gold,
/turf/open/floor/mineral/titanium/blue,
/area/shuttle/escape)
"Ir" = (
/obj/machinery/shower{
	dir = 1;
	name = "emergency shower"
	},
/obj/effect/turf_decal/tile/blue/opposingcorners,
/turf/open/floor/noslip/white,
/area/shuttle/escape)
"IG" = (
/obj/structure/table/reinforced,
/obj/item/storage/firstaid{
	pixel_x = 3;
	pixel_y = 2
	},
/obj/item/storage/firstaid/brute,
/obj/machinery/light{
	dir = 8
	},
/obj/effect/turf_decal/tile/blue/opposingcorners,
/turf/open/floor/iron/white,
/area/shuttle/escape)
"Jx" = (
/obj/structure/chair/fancy/shuttle{
	dir = 1
	},
/obj/effect/turf_decal/tile/dark_blue/fourcorners/contrasted,
/turf/open/floor/iron/dark,
/area/shuttle/escape)
"JA" = (
/obj/structure/chair/fancy/comfy{
	buildstackamount = 0;
	color = "#c45c57";
	dir = 1
	},
/turf/open/floor/carpet/green,
/area/shuttle/escape)
"JS" = (
/obj/machinery/door/airlock/command{
	name = "Cockpit";
	req_access_txt = "19"
	},
/turf/open/floor/mineral/plastitanium/red/brig,
/area/shuttle/escape)
"KA" = (
/obj/structure/window/reinforced/tinted{
	dir = 4
	},
/obj/structure/chair/fancy/comfy{
	buildstackamount = 0;
	color = "#c45c57";
	dir = 1
	},
/turf/open/floor/carpet/black,
/area/shuttle/escape)
"Li" = (
/obj/structure/table/glass,
/obj/item/storage/belt/medical,
/obj/item/storage/belt/medical,
/obj/item/reagent_containers/spray/cleaner{
	pixel_x = -3;
	pixel_y = 2
	},
/obj/item/clothing/neck/stethoscope,
/obj/item/clothing/neck/stethoscope,
/obj/item/clothing/glasses/hud/health,
/obj/item/clothing/glasses/hud/health,
/obj/effect/turf_decal/tile/blue/opposingcorners,
/turf/open/floor/iron/white,
/area/shuttle/escape)
"LF" = (
/obj/machinery/computer/communications,
/obj/effect/turf_decal/tile/dark_blue/half/contrasted{
	alpha = 180;
	dir = 4
	},
/turf/open/floor/iron/dark,
/area/shuttle/escape)
"Nk" = (
/obj/machinery/computer/slot_machine,
/obj/structure/window/reinforced/tinted,
/obj/structure/window/reinforced/tinted{
	dir = 4
	},
/obj/structure/window/reinforced/tinted{
	dir = 8
	},
/turf/open/floor/carpet/black,
/area/shuttle/escape)
"Nl" = (
/obj/effect/turf_decal/tile/blue/opposingcorners,
/turf/open/floor/iron/white,
/area/shuttle/escape)
"NG" = (
/obj/item/assembly/flash,
/obj/structure/table/reinforced,
/turf/open/floor/mineral/plastitanium/red/brig,
/area/shuttle/escape)
"NY" = (
/obj/structure/table/wood/poker,
/turf/open/floor/carpet/green,
/area/shuttle/escape)
"OY" = (
/turf/open/floor/carpet/green,
/area/shuttle/escape)
"Pn" = (
/obj/structure/table/glass,
/obj/item/reagent_containers/glass/bottle/epinephrine,
/obj/item/reagent_containers/syringe/epinephrine,
/obj/effect/turf_decal/tile/blue/opposingcorners,
/turf/open/floor/iron/white,
/area/shuttle/escape)
"PL" = (
/obj/structure/window/reinforced/tinted{
	dir = 8
	},
/obj/structure/window/reinforced/tinted{
	dir = 4
	},
/obj/structure/chair/fancy/comfy{
	buildstackamount = 0;
	color = "#c45c57";
	dir = 1
	},
/turf/open/floor/carpet/black,
/area/shuttle/escape)
"RZ" = (
/obj/structure/table/reinforced,
/obj/item/storage/box/handcuffs,
/turf/open/floor/mineral/plastitanium/red/brig,
/area/shuttle/escape)
"SQ" = (
/turf/open/floor/mineral/plastitanium/red/brig,
/area/shuttle/escape)
"Tc" = (
/obj/machinery/computer/emergency_shuttle,
/obj/effect/turf_decal/tile/dark_blue/half/contrasted{
	alpha = 180;
	dir = 4
	},
/turf/open/floor/iron/dark,
/area/shuttle/escape)
"Ur" = (
/obj/structure/chair/fancy/shuttle{
	dir = 1
	},
/obj/effect/turf_decal/tile/dark_blue/opposingcorners{
	dir = 1
	},
/turf/open/floor/iron/dark,
/area/shuttle/escape)
"UD" = (
/obj/machinery/computer/slot_machine,
/turf/open/floor/mineral/plastitanium/red/brig,
/area/shuttle/escape)
"WJ" = (
/obj/structure/table/wood/poker,
/obj/item/toy/cards/deck,
/turf/open/floor/carpet/black,
/area/shuttle/escape)
"WN" = (
/obj/machinery/stasis,
/obj/effect/turf_decal/tile/blue/opposingcorners,
/turf/open/floor/iron/white,
/area/shuttle/escape)
"WQ" = (
/obj/structure/chair/fancy/shuttle{
	dir = 4
	},
/turf/open/floor/mineral/plastitanium/red/brig,
/area/shuttle/escape)
"Yr" = (
/obj/machinery/computer/slot_machine,
/obj/effect/turf_decal/tile/dark_blue/anticorner/contrasted{
	dir = 8
	},
/turf/open/floor/iron/dark,
/area/shuttle/escape)
"YN" = (
/obj/effect/turf_decal/tile/dark_blue/anticorner/contrasted{
	dir = 1
	},
/turf/open/floor/iron/dark,
/area/shuttle/escape)
"YW" = (
/obj/effect/turf_decal/tile/dark_blue/opposingcorners,
/turf/open/floor/iron/dark,
/area/shuttle/escape)
"ZK" = (
/obj/structure/chair/fancy/comfy{
	buildstackamount = 0;
	color = "#c45c57";
	dir = 8
	},
/turf/open/floor/carpet/green,
/area/shuttle/escape)

(1,1,1) = {"
mY
mY
mY
mY
mY
hi
mY
ii
mY
gt
mY
gt
mY
hi
mY
hi
mY
xr
"}
(2,1,1) = {"
mY
lH
xm
IG
mY
rC
rC
rC
tN
xD
xD
xD
xD
rC
rC
rC
Dq
wj
"}
(3,1,1) = {"
gt
Nl
Nl
Nl
gt
hJ
OY
OY
bw
dC
dC
dC
dC
OY
OY
aw
Dq
wj
"}
(4,1,1) = {"
gt
av
Nl
Nl
HW
rC
OY
OY
rC
rC
rC
rC
rC
OY
OY
aw
Dq
wj
"}
(5,1,1) = {"
gt
wJ
Nl
Nl
gt
hJ
OY
rC
rC
un
un
un
rC
rC
OY
aw
Dq
wj
"}
(6,1,1) = {"
mY
WN
Nl
Nl
gt
nN
PL
rC
OY
NY
Bv
NY
JA
rC
lx
Nk
Dq
wj
"}
(7,1,1) = {"
mY
Pn
Nl
Ir
gt
cP
KA
rC
OY
rC
rC
WJ
JA
rC
lE
up
Dq
wj
"}
(8,1,1) = {"
mY
WN
Nl
Nl
gt
cP
KA
rC
OY
NY
Bv
NY
JA
rC
lE
up
Dq
wj
"}
(9,1,1) = {"
gt
gO
Nl
Nl
gt
hJ
OY
rC
rC
ZK
ZK
ZK
rC
rC
OY
aw
Dq
wj
"}
(10,1,1) = {"
gt
nj
Nl
Nl
HW
rC
OY
OY
rC
rC
rC
rC
rC
OY
OY
aw
Dq
wj
"}
(11,1,1) = {"
gt
Li
Nl
Nl
gt
hJ
OY
OY
FM
xd
xd
xd
xd
OY
OY
aw
Dq
wj
"}
(12,1,1) = {"
mY
qd
Nl
yB
mY
rC
rC
rC
so
up
up
up
up
rC
rC
rC
Dq
wj
"}
(13,1,1) = {"
mY
mY
uM
mY
mY
mY
uM
mY
mY
mY
mY
mY
mY
mY
le
mY
Dq
wj
"}
(14,1,1) = {"
gt
YN
cJ
cJ
bs
os
cJ
os
Yr
mY
RZ
WQ
WQ
WQ
SQ
WQ
Dq
wj
"}
(15,1,1) = {"
gt
Tc
Ur
FP
FP
FP
FP
FP
ae
mY
em
SQ
SQ
SQ
SQ
SQ
Dq
wj
"}
(16,1,1) = {"
gt
Dh
Jx
Am
Am
Am
Am
Am
ae
JS
SQ
SQ
UD
SQ
UD
SQ
Dq
wj
"}
(17,1,1) = {"
gt
LF
vS
YW
YW
YW
YW
YW
ae
mY
em
SQ
SQ
SQ
SQ
SQ
Dq
wj
"}
(18,1,1) = {"
gt
fE
pg
pg
Dy
fK
Ci
CQ
sb
mY
NG
Cf
Cf
Cf
Cf
Cf
Dq
wj
"}
(19,1,1) = {"
mY
gt
gt
gt
mY
gt
gt
gt
gt
mY
gt
gt
mY
mY
gt
gt
mY
xr
"}
