//MAP CONVERTED BY dmm2tgm.py THIS HEADER COMMENT PREVENTS RECONVERSION, DO NOT REMOVE
"aa" = (
/turf/template_noop,
/area/template_noop)
"ab" = (
/turf/closed/wall/mineral/plastitanium,
/area/shuttle/hunter)
"ad" = (
/obj/effect/turf_decal/stripes/line{
	dir = 1
	},
/turf/open/floor/plating,
/area/shuttle/hunter)
"ai" = (
/obj/structure/grille,
/obj/structure/window/plastitanium,
/turf/open/floor/plating,
/area/shuttle/hunter)
"aj" = (
/obj/effect/turf_decal/stripes/line,
/turf/open/floor/plating,
/area/shuttle/hunter)
"ak" = (
/obj/structure/sign/poster/contraband/bountyhunters,
/turf/closed/wall/mineral/plastitanium,
/area/shuttle/hunter)
"an" = (
/obj/structure/table,
/turf/open/floor/pod/light,
/area/shuttle/hunter)
"ao" = (
/obj/structure/chair/office{
	dir = 8
	},
/turf/open/floor/pod/light,
/area/shuttle/hunter)
"ap" = (
/obj/effect/mob_spawn/human/fugitive/bounty/hook,
/turf/open/floor/pod/light,
/area/shuttle/hunter)
"as" = (
/turf/open/floor/pod/dark,
/area/shuttle/hunter)
"au" = (
/obj/structure/curtain/bounty,
/turf/open/floor/pod/dark,
/area/shuttle/hunter)
"aw" = (
/obj/structure/table,
/obj/item/phone,
/turf/open/floor/pod/dark,
/area/shuttle/hunter)
"ax" = (
/obj/structure/table,
/turf/open/floor/pod/dark,
/area/shuttle/hunter)
"ay" = (
/obj/structure/chair/office{
	dir = 8
	},
/turf/open/floor/pod/dark,
/area/shuttle/hunter)
"az" = (
/obj/structure/chair/fancy/shuttle{
	dir = 4
	},
/turf/open/floor/pod/dark,
/area/shuttle/hunter)
"aA" = (
/obj/machinery/computer/shuttle_flight/hunter{
	dir = 8
	},
/turf/open/floor/pod/dark,
/area/shuttle/hunter)
"aB" = (
/obj/machinery/launchpad,
/turf/open/floor/pod/dark,
/area/shuttle/hunter)
"aC" = (
/obj/item/multitool,
/turf/open/floor/pod/dark,
/area/shuttle/hunter)
"aD" = (
/obj/structure/curtain/bounty,
/obj/machinery/atmospherics/pipe/simple/purple/hidden{
	dir = 4
	},
/turf/open/floor/pod/dark,
/area/shuttle/hunter)
"aE" = (
/obj/structure/table,
/obj/item/binoculars,
/turf/open/floor/pod/dark,
/area/shuttle/hunter)
"aJ" = (
/obj/machinery/suit_storage_unit/standard_unit,
/turf/open/floor/pod/light,
/area/shuttle/hunter)
"aK" = (
/obj/machinery/suit_storage_unit/open,
/turf/open/floor/pod/light,
/area/shuttle/hunter)
"aM" = (
/obj/effect/mob_spawn/human/fugitive/bounty/armor{
	dir = 1
	},
/turf/open/floor/pod/light,
/area/shuttle/hunter)
"aO" = (
/obj/effect/mapping_helpers/airlock/cyclelink_helper{
	dir = 1
	},
/obj/machinery/door/airlock/external{
	req_access_txt = "181"
	},
/obj/docking_port/stationary{
	dwidth = 11;
	height = 16;
	id = "pirateship_home";
	name = "Deep Space";
	width = 17
	},
/obj/docking_port/mobile{
	dheight = 3;
	dwidth = 3;
	height = 13;
	id = "huntership";
	movement_force = list("KNOCKDOWN" = 0, "THROW" = 0);
	name = "hunter shuttle";
	rechargeTime = 1800;
	width = 15
	},
/turf/open/floor/plating,
/area/shuttle/hunter)
"aP" = (
/obj/structure/fluff/empty_sleeper{
	dir = 1
	},
/turf/open/floor/pod/light,
/area/shuttle/hunter)
"aV" = (
/obj/effect/mapping_helpers/airlock/cyclelink_helper,
/obj/machinery/door/airlock/external{
	req_access_txt = "181"
	},
/turf/open/floor/plating,
/area/shuttle/hunter)
"aZ" = (
/obj/effect/mob_spawn/human/fugitive/bounty/synth,
/turf/open/floor/pod/light,
/area/shuttle/hunter)
"cp" = (
/obj/machinery/shuttle/engine{
	dir = 4
	},
/turf/open/floor/plating/airless,
/area/shuttle/hunter)
"ee" = (
/obj/machinery/computer/weapons{
	dir = 8
	},
/turf/open/floor/pod/dark,
/area/shuttle/hunter)
"gr" = (
/obj/machinery/computer/launchpad{
	dir = 4
	},
/obj/machinery/atmospherics/pipe/simple/purple/hidden{
	dir = 4
	},
/turf/open/floor/pod/dark,
/area/shuttle/hunter)
"hX" = (
/obj/structure/table,
/obj/item/wrench,
/turf/open/floor/pod/light,
/area/shuttle/hunter)
"iP" = (
/obj/machinery/computer/locator{
	dir = 8
	},
/turf/open/floor/pod/light,
/area/shuttle/hunter)
"jV" = (
/obj/effect/turf_decal/stripes/line{
	dir = 10
	},
/obj/machinery/atmospherics/pipe/manifold4w/purple/hidden,
/turf/open/floor/pod/dark,
/area/shuttle/hunter)
"lH" = (
/obj/structure/chair/office{
	dir = 4
	},
/obj/machinery/atmospherics/pipe/simple/purple/hidden,
/turf/open/floor/pod/light,
/area/shuttle/hunter)
"mA" = (
/obj/machinery/atmospherics/pipe/simple/purple/hidden{
	dir = 10
	},
/turf/open/floor/plating,
/area/shuttle/hunter)
"nN" = (
/obj/machinery/power/smes,
/obj/machinery/atmospherics/pipe/simple/purple/hidden{
	dir = 4
	},
/turf/open/floor/pod/dark,
/area/shuttle/hunter)
"qZ" = (
/obj/machinery/atmospherics/pipe/simple/purple/hidden{
	dir = 10
	},
/turf/open/floor/pod/dark,
/area/shuttle/hunter)
"rg" = (
/obj/effect/mapping_helpers/airlock/cyclelink_helper,
/obj/machinery/door/airlock/external{
	req_access_txt = "181"
	},
/obj/machinery/atmospherics/pipe/simple/purple/hidden,
/turf/open/floor/plating,
/area/shuttle/hunter)
"sy" = (
/obj/effect/turf_decal/stripes/line{
	dir = 1
	},
/obj/machinery/atmospherics/pipe/simple/purple/hidden,
/turf/open/floor/plating,
/area/shuttle/hunter)
"sA" = (
/obj/effect/turf_decal/stripes/line{
	dir = 9
	},
/obj/machinery/atmospherics/pipe/manifold4w/purple/hidden,
/turf/open/floor/pod/dark,
/area/shuttle/hunter)
"uF" = (
/obj/machinery/shuttle_weapon/laser/triple{
	dir = 4
	},
/turf/closed/wall/mineral/plastitanium,
/area/shuttle/hunter)
"wa" = (
/obj/effect/mapping_helpers/airlock/cyclelink_helper{
	dir = 1
	},
/obj/machinery/door/airlock/external{
	req_access_txt = "181"
	},
/obj/machinery/atmospherics/pipe/simple/purple/hidden,
/turf/open/floor/plating,
/area/shuttle/hunter)
"Fu" = (
/obj/structure/window/reinforced{
	dir = 4
	},
/obj/machinery/atmospherics/components/unary/shuttle/engine_heater{
	dir = 4
	},
/turf/open/floor/plating/airless,
/area/shuttle/hunter)
"Gc" = (
/obj/machinery/atmospherics/components/unary/portables_connector,
/obj/machinery/portable_atmospherics/canister/toxins,
/turf/open/floor/pod/dark,
/area/shuttle/hunter)
"GY" = (
/obj/machinery/atmospherics/components/unary/shuttle/engine_heater{
	dir = 4
	},
/turf/open/floor/plating/airless,
/area/shuttle/hunter)
"IV" = (
/obj/machinery/atmospherics/pipe/simple/purple/hidden{
	dir = 4
	},
/turf/open/floor/pod/dark,
/area/shuttle/hunter)
"JO" = (
/obj/effect/turf_decal/stripes/line,
/obj/machinery/atmospherics/pipe/simple/purple/hidden,
/turf/open/floor/plating,
/area/shuttle/hunter)
"JP" = (
/obj/machinery/atmospherics/components/unary/portables_connector{
	dir = 1
	},
/obj/machinery/portable_atmospherics/canister/toxins,
/turf/open/floor/pod/dark,
/area/shuttle/hunter)
"Os" = (
/obj/machinery/fugitive_capture,
/obj/machinery/atmospherics/pipe/simple/purple/hidden{
	dir = 4
	},
/turf/open/floor/pod/dark,
/area/shuttle/hunter)
"Rp" = (
/obj/structure/sign/warning/vacuum/external,
/obj/machinery/atmospherics/pipe/simple/purple/hidden{
	dir = 4
	},
/turf/closed/wall/mineral/plastitanium,
/area/shuttle/hunter)
"RV" = (
/obj/effect/turf_decal/stripes/line{
	dir = 8
	},
/obj/machinery/atmospherics/pipe/simple/purple/hidden,
/turf/open/floor/pod/dark,
/area/shuttle/hunter)
"VY" = (
/obj/machinery/suit_storage_unit/standard_unit,
/obj/machinery/atmospherics/pipe/simple/purple/hidden,
/turf/open/floor/pod/light,
/area/shuttle/hunter)
"Ww" = (
/obj/structure/chair/office{
	dir = 4
	},
/obj/machinery/atmospherics/pipe/simple/purple/hidden{
	dir = 9
	},
/turf/open/floor/pod/dark,
/area/shuttle/hunter)
"Xu" = (
/obj/machinery/atmospherics/pipe/simple/purple/hidden{
	dir = 9
	},
/turf/open/floor/plating,
/area/shuttle/hunter)

(1,1,1) = {"
aa
aa
aa
ab
aa
aa
aa
aa
aa
ab
aa
aa
aa
"}
(2,1,1) = {"
aa
aa
aa
ab
aa
aa
aa
aa
aa
ab
aa
aa
aa
"}
(3,1,1) = {"
ab
aa
aa
ab
aa
cp
aa
cp
aa
ab
aa
aa
ab
"}
(4,1,1) = {"
ab
aa
cp
ab
ab
Fu
ai
Fu
ab
ab
cp
aa
ab
"}
(5,1,1) = {"
ab
ab
GY
ab
ab
gr
aB
nN
ab
ab
GY
ab
ab
"}
(6,1,1) = {"
ab
ab
Rp
ab
ab
IV
aC
Os
ab
ab
Rp
ab
ab
"}
(7,1,1) = {"
aV
ad
mA
JO
wa
sA
RV
jV
rg
sy
Xu
aj
aO
"}
(8,1,1) = {"
ab
ab
ai
ab
ab
aD
au
aD
ab
ab
ai
ab
ab
"}
(9,1,1) = {"
aa
ab
ai
Gc
lH
Ww
as
qZ
VY
JP
ai
ab
aa
"}
(10,1,1) = {"
aa
aa
ai
ak
hX
aw
ax
as
aJ
ab
ai
aa
aa
"}
(11,1,1) = {"
aa
aa
aa
ab
an
ax
aE
as
aK
ab
aa
aa
aa
"}
(12,1,1) = {"
aa
aa
aa
ab
ao
ay
as
as
aJ
ab
aa
aa
aa
"}
(13,1,1) = {"
aa
aa
aa
ai
ab
au
au
au
ab
ai
aa
aa
aa
"}
(14,1,1) = {"
aa
aa
aa
ai
ap
as
as
as
aP
ai
aa
aa
aa
"}
(15,1,1) = {"
aa
aa
aa
ai
aZ
az
as
az
aM
ai
aa
aa
aa
"}
(16,1,1) = {"
aa
aa
aa
uF
ai
aA
iP
ee
ai
uF
aa
aa
aa
"}
(17,1,1) = {"
aa
aa
aa
aa
ai
ai
ai
ai
ai
aa
aa
aa
aa
"}
