//MAP CONVERTED BY dmm2tgm.py THIS HEADER COMMENT PREVENTS RECONVERSION, DO NOT REMOVE
"aa" = (
/turf/open/floor/mineral/titanium/blue,
/area/shuttle/hunter)
"ab" = (
/obj/machinery/computer/shuttle_flight/hunter{
	dir = 8
	},
/obj/machinery/atmospherics/pipe/manifold/purple/hidden{
	dir = 4
	},
/turf/open/floor/mineral/titanium/blue,
/area/shuttle/hunter)
"ac" = (
/obj/structure/fans/tiny,
/obj/docking_port/stationary{
	dir = 4;
	dwidth = 3;
	height = 12;
	id = "huntership_home";
	name = "Deep Space";
	width = 7
	},
/obj/docking_port/mobile{
	dir = 4;
	dwidth = 3;
	height = 12;
	id = "huntership";
	name = "hunter shuttle";
	rechargeTime = 1800;
	width = 7
	},
/obj/machinery/door/poddoor/shutters{
	id = "Interpolship"
	},
/turf/open/floor/mineral/titanium/blue,
/area/shuttle/hunter)
"af" = (
/obj/effect/turf_decal/stripes{
	dir = 8
	},
/turf/open/floor/mineral/titanium/blue,
/area/shuttle/hunter)
"ag" = (
/obj/effect/turf_decal/delivery,
/obj/machinery/atmospherics/pipe/simple/purple/hidden,
/turf/open/floor/mineral/titanium/blue,
/area/shuttle/hunter)
"ah" = (
/obj/effect/turf_decal/loading_area{
	dir = 4
	},
/turf/open/floor/mineral/titanium/blue,
/area/shuttle/hunter)
"aj" = (
/obj/structure/closet/crate/eva,
/obj/effect/turf_decal/box,
/turf/open/floor/mineral/titanium/blue,
/area/shuttle/hunter)
"ak" = (
/obj/structure/chair/fancy/shuttle{
	dir = 1
	},
/obj/effect/mob_spawn/human/fugitive/spacepol{
	dir = 1
	},
/turf/open/floor/mineral/titanium/blue,
/area/shuttle/hunter)
"al" = (
/obj/effect/turf_decal/stripes{
	dir = 8
	},
/obj/effect/turf_decal/caution{
	dir = 4
	},
/turf/open/floor/mineral/titanium/blue,
/area/shuttle/hunter)
"bY" = (
/obj/structure/chair/fancy/shuttle,
/turf/open/floor/mineral/titanium/blue,
/area/shuttle/hunter)
"cJ" = (
/obj/machinery/atmospherics/components/unary/shuttle/engine_heater{
	dir = 4
	},
/turf/closed/wall/mineral/titanium,
/area/shuttle/hunter)
"fj" = (
/obj/machinery/computer/locator{
	dir = 8
	},
/obj/machinery/atmospherics/pipe/simple/purple/hidden,
/turf/open/floor/mineral/titanium/blue,
/area/shuttle/hunter)
"hB" = (
/obj/machinery/shuttle/engine{
	dir = 4
	},
/turf/closed/wall/mineral/titanium,
/area/shuttle/hunter)
"hJ" = (
/obj/structure/window/shuttle,
/obj/structure/grille,
/turf/open/floor/plating,
/area/shuttle/hunter)
"hR" = (
/obj/effect/spawner/structure/window/shuttle,
/obj/machinery/atmospherics/pipe/simple/purple/hidden,
/turf/open/floor/plating,
/area/shuttle/hunter)
"jf" = (
/obj/machinery/atmospherics/pipe/simple/purple/hidden{
	dir = 9
	},
/turf/open/floor/plating,
/area/shuttle/hunter)
"jC" = (
/obj/machinery/computer/weapons{
	dir = 8
	},
/obj/machinery/atmospherics/pipe/simple/purple/hidden,
/turf/open/floor/mineral/titanium/blue,
/area/shuttle/hunter)
"ku" = (
/turf/closed/wall/mineral/titanium,
/area/shuttle/hunter)
"lp" = (
/obj/machinery/fugitive_capture,
/turf/open/floor/mineral/titanium/blue,
/area/shuttle/hunter)
"oD" = (
/obj/machinery/shuttle_weapon/laser/triple{
	dir = 4
	},
/turf/closed/wall/mineral/titanium,
/area/shuttle/hunter)
"qx" = (
/obj/machinery/button/door{
	id = "Interpolship";
	pixel_y = 26;
	req_access_txt = "181"
	},
/obj/effect/turf_decal/stripes{
	dir = 8
	},
/turf/open/floor/mineral/titanium/blue,
/area/shuttle/hunter)
"te" = (
/obj/structure/fans/tiny,
/obj/machinery/door/poddoor/shutters{
	id = "Interpolship"
	},
/turf/open/floor/mineral/titanium/blue,
/area/shuttle/hunter)
"ug" = (
/obj/machinery/atmospherics/pipe/simple/purple/hidden,
/turf/open/floor/mineral/titanium/blue,
/area/shuttle/hunter)
"yh" = (
/obj/machinery/atmospherics/pipe/simple/purple/hidden{
	dir = 4
	},
/turf/open/floor/mineral/titanium/blue,
/area/shuttle/hunter)
"An" = (
/obj/effect/spawner/structure/window/shuttle,
/turf/open/floor/plating,
/area/shuttle/hunter)
"Fl" = (
/obj/machinery/door/airlock/titanium{
	req_access_txt = "181"
	},
/obj/machinery/atmospherics/pipe/simple/purple/hidden{
	dir = 4
	},
/turf/open/floor/mineral/titanium/blue,
/area/shuttle/hunter)
"FF" = (
/obj/machinery/atmospherics/pipe/manifold/purple/hidden{
	dir = 8
	},
/turf/open/floor/mineral/titanium/blue,
/area/shuttle/hunter)
"MP" = (
/obj/machinery/atmospherics/pipe/simple/purple/hidden{
	dir = 10
	},
/turf/open/floor/plating,
/area/shuttle/hunter)
"Pq" = (
/turf/template_noop,
/area/template_noop)
"Qm" = (
/obj/machinery/atmospherics/components/unary/portables_connector{
	dir = 1
	},
/obj/machinery/portable_atmospherics/canister/toxins,
/obj/item/wrench,
/turf/open/floor/mineral/titanium/blue,
/area/shuttle/hunter)
"Rz" = (
/obj/structure/chair/fancy/shuttle{
	dir = 4
	},
/obj/machinery/atmospherics/pipe/simple/purple/hidden{
	dir = 4
	},
/turf/open/floor/mineral/titanium/blue,
/area/shuttle/hunter)
"SZ" = (
/obj/structure/window/shuttle,
/obj/structure/grille,
/obj/machinery/atmospherics/pipe/simple/purple/hidden,
/turf/open/floor/plating,
/area/shuttle/hunter)
"YM" = (
/obj/machinery/atmospherics/pipe/manifold/purple/hidden{
	dir = 1
	},
/turf/open/floor/mineral/titanium/blue,
/area/shuttle/hunter)

(1,1,1) = {"
Pq
ku
te
ac
te
ku
Pq
"}
(2,1,1) = {"
Pq
ku
qx
al
af
ku
Pq
"}
(3,1,1) = {"
Pq
ku
bY
aa
ak
ku
Pq
"}
(4,1,1) = {"
hB
ku
bY
aa
ak
ku
hB
"}
(5,1,1) = {"
cJ
ku
bY
aa
ak
ku
cJ
"}
(6,1,1) = {"
MP
SZ
ag
FF
ug
SZ
jf
"}
(7,1,1) = {"
Pq
hJ
ah
YM
Qm
hJ
Pq
"}
(8,1,1) = {"
Pq
ku
lp
yh
aj
ku
Pq
"}
(9,1,1) = {"
hB
ku
ku
Fl
ku
ku
hB
"}
(10,1,1) = {"
cJ
ku
aa
Rz
aa
ku
cJ
"}
(11,1,1) = {"
MP
hR
fj
ab
jC
hR
jf
"}
(12,1,1) = {"
Pq
oD
An
An
An
oD
Pq
"}
