//MAP CONVERTED BY dmm2tgm.py THIS HEADER COMMENT PREVENTS RECONVERSION, DO NOT REMOVE
"a" = (
/obj/effect/decal/cleanable/dirt,
/turf/open/floor/plating,
/area/template_noop)
"b" = (
/obj/machinery/button/door/directional/north{
	name = "Shutter Control";
	id = "explo_depart"
	},
/obj/effect/turf_decal/stripes/corner{
	dir = 4
	},
/obj/effect/decal/cleanable/dirt,
/turf/open/floor/mineral/titanium,
/area/template_noop)
"e" = (
/turf/closed/wall/mineral/titanium/nodiagonal,
/area/template_noop)
"f" = (
/obj/item/radio/intercom{
	frequency = 1361;
	freqlock = 1;
	pixel_y = -28
	},
/obj/effect/decal/cleanable/dirt,
/turf/open/floor/plating,
/area/template_noop)
"g" = (
/obj/effect/turf_decal/stripes/line{
	dir = 1
	},
/obj/item/caution,
/turf/open/floor/mineral/titanium,
/area/template_noop)
"n" = (
/obj/structure/bed/maint,
/obj/effect/decal/cleanable/cobweb,
/obj/effect/spawner/lootdrop/maintenance,
/turf/open/floor/mineral/titanium,
/area/template_noop)
"u" = (
/obj/effect/decal/cleanable/dirt,
/mob/living/basic/cockroach,
/turf/open/floor/plating,
/area/template_noop)
"z" = (
/obj/structure/table/reinforced,
/obj/machinery/door/poddoor/shutters{
	id = "explo_depart"
	},
/turf/open/floor/plating,
/area/template_noop)
"E" = (
/obj/machinery/door/airlock/shuttle,
/obj/effect/turf_decal/stripes/closeup,
/obj/effect/mapping_helpers/airlock/locked,
/obj/structure/barricade/wooden/crude,
/turf/open/floor/mineral/plastitanium,
/area/template_noop)
"J" = (
/obj/effect/decal/cleanable/dirt,
/turf/open/floor/mineral/titanium,
/area/template_noop)
"L" = (
/obj/machinery/newscaster/directional/south,
/obj/item/newspaper{
	pixel_x = 2;
	pixel_y = 3
	},
/obj/item/chair{
	pixel_y = 2;
	pixel_x = -2
	},
/turf/open/floor/mineral/titanium,
/area/template_noop)
"M" = (
/obj/effect/decal/cleanable/vomit/old,
/turf/open/floor/mineral/titanium,
/area/template_noop)
"P" = (
/obj/machinery/holopad,
/obj/effect/decal/cleanable/dirt,
/obj/effect/turf_decal/box/corners,
/obj/effect/turf_decal/box/corners{
	dir = 8
	},
/obj/effect/turf_decal/box/corners{
	dir = 1
	},
/turf/open/floor/mineral/titanium,
/area/template_noop)
"S" = (
/obj/effect/decal/cleanable/dirt,
/obj/effect/decal/cleanable/blood,
/turf/open/floor/mineral/titanium,
/area/template_noop)
"V" = (
/obj/effect/decal/cleanable/dirt,
/obj/effect/spawner/lootdrop/glowstick/lit,
/turf/open/floor/mineral/titanium,
/area/template_noop)

(1,1,1) = {"
e
n
a
L
"}
(2,1,1) = {"
E
S
u
f
"}
(3,1,1) = {"
e
b
P
a
"}
(4,1,1) = {"
z
a
M
J
"}
(5,1,1) = {"
z
g
J
V
"}
