//MAP CONVERTED BY dmm2tgm.py THIS HEADER COMMENT PREVENTS RECONVERSION, DO NOT REMOVE
"a" = (
/obj/effect/turf_decal/stripes/line{
	dir = 1
	},
/turf/open/floor/mineral/titanium,
/area/template_noop)
"f" = (
/obj/item/radio/intercom{
	frequency = 1361;
	freqlock = 1;
	pixel_y = -28
	},
/turf/open/floor/mineral/titanium,
/area/template_noop)
"h" = (
/turf/open/floor/mineral/titanium,
/area/template_noop)
"r" = (
/obj/machinery/door/airlock/shuttle,
/obj/effect/turf_decal/stripes/closeup,
/turf/open/floor/mineral/plastitanium,
/area/template_noop)
"C" = (
/turf/closed/wall/mineral/titanium/nodiagonal,
/area/template_noop)
"P" = (
/obj/structure/table/reinforced,
/obj/machinery/door/poddoor/shutters{
	id = "explo_depart"
	},
/turf/open/floor/plating,
/area/template_noop)
"U" = (
/obj/machinery/holopad,
/obj/effect/turf_decal/box,
/turf/open/floor/mineral/titanium,
/area/template_noop)
"W" = (
/obj/machinery/button/door/directional/north{
	name = "Shutter Control";
	id = "explo_depart"
	},
/obj/effect/turf_decal/stripes/corner{
	dir = 4
	},
/turf/open/floor/mineral/titanium,
/area/template_noop)

(1,1,1) = {"
C
h
h
h
"}
(2,1,1) = {"
r
h
h
f
"}
(3,1,1) = {"
C
W
U
h
"}
(4,1,1) = {"
P
a
h
h
"}
(5,1,1) = {"
P
a
h
h
"}
