//MAP CONVERTED BY dmm2tgm.py THIS HEADER COMMENT PREVENTS RECONVERSION, DO NOT REMOVE
"a" = (
/turf/open/floor/mineral/titanium,
/area/template_noop)
"g" = (
/obj/machinery/button/door/directional/north{
	name = "Shutter Control";
	id = "explo_depart"
	},
/obj/effect/turf_decal/stripes/corner{
	dir = 4
	},
/turf/open/floor/mineral/titanium,
/area/template_noop)
"o" = (
/obj/machinery/holopad,
/obj/effect/turf_decal/box,
/turf/open/floor/mineral/titanium,
/area/template_noop)
"y" = (
/obj/structure/table/reinforced,
/obj/machinery/door/poddoor/shutters{
	id = "explo_depart"
	},
/turf/open/floor/plating,
/area/template_noop)
"D" = (
/turf/closed/wall/mineral/titanium/nodiagonal,
/area/template_noop)
"E" = (
/obj/structure/sign/departments/minsky/research/dorms,
/turf/closed/wall/mineral/titanium/nodiagonal,
/area/template_noop)
"H" = (
/obj/effect/turf_decal/stripes/line{
	dir = 1
	},
/turf/open/floor/mineral/titanium,
/area/template_noop)
"K" = (
/obj/item/radio/intercom{
	frequency = 1361;
	freqlock = 1;
	pixel_y = -28
	},
/turf/open/floor/mineral/titanium,
/area/template_noop)
"Q" = (
/obj/machinery/door/airlock/shuttle,
/obj/effect/turf_decal/stripes/closeup,
/turf/open/floor/mineral/plastitanium,
/area/template_noop)

(1,1,1) = {"
E
a
a
a
"}
(2,1,1) = {"
Q
a
a
K
"}
(3,1,1) = {"
D
g
o
a
"}
(4,1,1) = {"
y
H
a
a
"}
(5,1,1) = {"
y
H
a
a
"}
