//MAP CONVERTED BY dmm2tgm.py THIS HEADER COMMENT PREVENTS RECONVERSION, DO NOT REMOVE
"a" = (
/obj/effect/turf_decal/bot,
/obj/effect/decal/cleanable/dirt,
/obj/machinery/light{
	dir = 8
	},
/obj/machinery/conveyor_switch/oneway{
	dir = 1;
	id = "MailConv"
	},
/turf/open/floor/plasteel,
/area/shuttle/supply)
"b" = (
/obj/structure/fans/tiny,
/obj/machinery/door/poddoor{
	id = "QMLoaddoor";
	name = "Supply Dock Loading Door"
	},
/obj/machinery/conveyor{
	dir = 4;
	id = "QMLoad2"
	},
/obj/structure/plasticflaps,
/turf/open/floor/plasteel/sepia,
/area/shuttle/supply)
"c" = (
/obj/effect/turf_decal/bot,
/obj/effect/decal/cleanable/dirt,
/obj/machinery/conveyor_switch/oneway{
	dir = 8;
	id = "QMLoad2";
	name = "Unloading ramp Switch"
	},
/turf/open/floor/plasteel,
/area/shuttle/supply)
"d" = (
/turf/closed/wall/mineral/titanium,
/area/shuttle/supply)
"g" = (
/obj/machinery/conveyor{
	dir = 4;
	id = "QMLoad2"
	},
/obj/machinery/status_display/supply{
	pixel_x = 1;
	pixel_y = 32
	},
/obj/effect/turf_decal/stripes/line,
/obj/effect/decal/cleanable/dirt,
/obj/effect/decal/cleanable/dirt,
/turf/open/floor/plasteel/dark,
/area/shuttle/supply)
"h" = (
/obj/effect/decal/cleanable/dirt/dust,
/turf/closed/wall/mineral/titanium,
/area/shuttle/supply)
"o" = (
/obj/effect/decal/cleanable/dirt/dust,
/turf/closed/wall/mineral/titanium/nodiagonal,
/area/shuttle/supply)
"r" = (
/obj/docking_port/mobile/supply,
/obj/structure/fans/tiny,
/obj/machinery/door/airlock/shuttle/glass{
	autoclose = 0.1;
	id_tag = "CargoAirlocks"
	},
/turf/open/floor/plating,
/area/shuttle/supply)
"s" = (
/turf/closed/wall/mineral/titanium/nodiagonal,
/area/shuttle/supply)
"v" = (
/obj/effect/decal/cleanable/dirt/dust,
/turf/closed/wall/mineral/plastitanium,
/area/shuttle/supply)
"w" = (
/obj/effect/turf_decal/bot,
/turf/open/floor/plasteel,
/area/shuttle/supply)
"B" = (
/obj/effect/decal/cleanable/dirt/dust,
/obj/effect/decal/cleanable/dirt/dust,
/obj/structure/shuttle/engine/propulsion{
	dir = 8
	},
/turf/open/floor/plating/airless,
/area/shuttle/supply)
"C" = (
/obj/effect/decal/cleanable/dirt/dust,
/obj/machinery/conveyor{
	dir = 4;
	id = "QMLoad2"
	},
/obj/effect/turf_decal/stripes/line,
/turf/open/floor/plasteel/dark,
/area/shuttle/supply)
"F" = (
/obj/machinery/conveyor{
	dir = 8;
	id = "MailConv"
	},
/obj/effect/turf_decal/stripes/line{
	dir = 1
	},
/obj/effect/decal/cleanable/dirt,
/turf/open/floor/plasteel/dark,
/area/shuttle/supply)
"G" = (
/obj/effect/turf_decal/bot,
/obj/effect/decal/cleanable/oil/streak,
/turf/open/floor/plasteel,
/area/shuttle/supply)
"J" = (
/obj/effect/spawner/structure/window/shuttle,
/turf/open/floor/plating,
/area/shuttle/supply)
"L" = (
/obj/effect/decal/cleanable/dirt/dust,
/obj/machinery/conveyor{
	dir = 8;
	id = "MailConv"
	},
/obj/effect/turf_decal/stripes/line{
	dir = 1
	},
/obj/effect/decal/cleanable/dirt,
/turf/open/floor/plasteel/dark,
/area/shuttle/supply)
"P" = (
/obj/effect/decal/cleanable/dirt/dust,
/obj/structure/shuttle/engine/propulsion{
	dir = 8
	},
/turf/open/floor/plating/airless,
/area/shuttle/supply)
"Q" = (
/obj/machinery/conveyor{
	dir = 8;
	id = "MailConv"
	},
/obj/effect/turf_decal/stripes/line{
	dir = 1
	},
/turf/open/floor/plasteel/dark,
/area/shuttle/supply)
"R" = (
/obj/effect/decal/cleanable/dirt/dust,
/obj/machinery/conveyor{
	dir = 8;
	id = "MailConv"
	},
/obj/effect/turf_decal/stripes/line{
	dir = 1
	},
/obj/structure/sign/warning/fire{
	pixel_x = 1;
	pixel_y = -33
	},
/turf/open/floor/plasteel/dark,
/area/shuttle/supply)
"S" = (
/obj/effect/decal/cleanable/dirt/dust,
/obj/effect/spawner/structure/window/shuttle,
/turf/open/floor/plating,
/area/shuttle/supply)
"T" = (
/obj/effect/decal/cleanable/dirt/dust,
/obj/structure/shuttle/engine/heater{
	dir = 8
	},
/obj/effect/spawner/structure/window/shuttle,
/turf/open/floor/plating,
/area/shuttle/supply)
"X" = (
/obj/machinery/conveyor{
	dir = 4;
	id = "QMLoad2"
	},
/obj/effect/turf_decal/stripes/line,
/obj/effect/decal/cleanable/dirt,
/turf/open/floor/plasteel/dark,
/area/shuttle/supply)
"Y" = (
/obj/structure/fans/tiny,
/obj/machinery/door/poddoor{
	id = "QMLoaddoor2";
	name = "Supply Dock Loading Door"
	},
/obj/machinery/conveyor{
	dir = 8;
	id = "MailConv"
	},
/obj/structure/plasticflaps,
/turf/open/floor/plasteel/sepia,
/area/shuttle/supply)
"Z" = (
/obj/effect/turf_decal/bot,
/obj/effect/decal/cleanable/dirt,
/turf/open/floor/plasteel,
/area/shuttle/supply)

(1,1,1) = {"
v
B
o
P
v
"}
(2,1,1) = {"
s
T
a
T
o
"}
(3,1,1) = {"
J
X
Z
F
S
"}
(4,1,1) = {"
J
C
w
L
S
"}
(5,1,1) = {"
J
X
G
Q
J
"}
(6,1,1) = {"
o
g
c
R
s
"}
(7,1,1) = {"
d
b
r
Y
h
"}
