//MAP CONVERTED BY dmm2tgm.py THIS HEADER COMMENT PREVENTS RECONVERSION, DO NOT REMOVE
"a" = (
/obj/machinery/conveyor{
	dir = 8;
	id = "MailConv"
	},
/turf/open/floor/plasteel/dark,
/area/shuttle/supply)
"c" = (
/obj/structure/table/reinforced,
/obj/effect/turf_decal/stripes/closeup,
/turf/open/floor/plasteel/sepia,
/area/shuttle/supply)
"d" = (
/turf/closed/wall/mineral/titanium,
/area/shuttle/supply)
"e" = (
/obj/effect/turf_decal/bot,
/obj/effect/decal/cleanable/dirt,
/obj/effect/turf_decal/stripes/corner,
/obj/structure/railing/corner,
/turf/open/floor/plasteel,
/area/shuttle/supply)
"f" = (
/obj/structure/shuttle/engine/propulsion/burst/right,
/turf/open/floor/plating/airless,
/area/shuttle/supply)
"g" = (
/turf/closed/wall/mineral/titanium/nodiagonal,
/area/shuttle/supply)
"h" = (
/turf/template_noop,
/area/template_noop)
"i" = (
/obj/machinery/conveyor{
	dir = 8;
	id = "MailConv"
	},
/obj/effect/decal/cleanable/dirt,
/obj/structure/railing/corner,
/turf/open/floor/plasteel/dark,
/area/shuttle/supply)
"j" = (
/obj/machinery/conveyor_switch/oneway{
	dir = 8;
	id = "QMLoad2";
	name = "Unloading ramp Switch"
	},
/obj/effect/decal/cleanable/dirt,
/obj/effect/decal/cleanable/dirt,
/obj/effect/turf_decal/stripes/line{
	dir = 6
	},
/obj/structure/railing,
/turf/open/floor/plasteel,
/area/shuttle/supply)
"k" = (
/obj/effect/turf_decal/stripes/line{
	dir = 4
	},
/obj/effect/turf_decal/bot,
/obj/structure/railing/corner{
	dir = 4
	},
/turf/open/floor/plasteel,
/area/shuttle/supply)
"l" = (
/obj/structure/fans/tiny,
/obj/machinery/door/poddoor{
	id = "QMLoaddoor";
	name = "Supply Dock Loading Door"
	},
/obj/machinery/conveyor{
	dir = 4;
	id = "QMLoad2"
	},
/obj/structure/plasticflaps,
/turf/open/floor/plasteel/sepia,
/area/shuttle/supply)
"m" = (
/obj/effect/turf_decal/bot,
/obj/effect/decal/cleanable/dirt,
/obj/effect/turf_decal/stripes/line{
	dir = 4
	},
/obj/structure/railing{
	dir = 4
	},
/turf/open/floor/plasteel,
/area/shuttle/supply)
"n" = (
/obj/effect/turf_decal/bot,
/obj/effect/decal/cleanable/dirt,
/obj/effect/turf_decal/stripes/line,
/turf/open/floor/plasteel,
/area/shuttle/supply)
"o" = (
/obj/effect/turf_decal/bot,
/obj/effect/decal/cleanable/dirt,
/obj/effect/turf_decal/stripes/line{
	dir = 1
	},
/turf/open/floor/plasteel,
/area/shuttle/supply)
"p" = (
/obj/effect/decal/cleanable/dirt,
/obj/effect/turf_decal/stripes/line{
	dir = 6
	},
/obj/effect/turf_decal/bot,
/turf/open/floor/plasteel,
/area/shuttle/supply)
"q" = (
/obj/machinery/door/airlock/titanium{
	name = "Supply Shuttle Airlock";
	req_access_txt = "31"
	},
/obj/docking_port/mobile/supply,
/obj/structure/fans/tiny,
/turf/open/floor/plating,
/area/shuttle/supply)
"r" = (
/obj/structure/table/reinforced,
/obj/effect/turf_decal/stripes/end{
	dir = 8
	},
/turf/open/floor/plasteel/sepia,
/area/shuttle/supply)
"s" = (
/obj/machinery/conveyor{
	dir = 5;
	id = "QMLoad2"
	},
/turf/open/floor/plasteel/dark,
/area/shuttle/supply)
"t" = (
/obj/effect/turf_decal/loading_area{
	dir = 4;
	pixel_x = 4
	},
/obj/effect/decal/cleanable/glass,
/obj/effect/turf_decal/stripes/line{
	dir = 9
	},
/turf/open/floor/plasteel,
/area/shuttle/supply)
"u" = (
/obj/effect/turf_decal/bot,
/obj/effect/decal/cleanable/oil/streak,
/obj/effect/turf_decal/stripes/corner{
	dir = 4
	},
/obj/structure/railing/corner{
	dir = 4
	},
/turf/open/floor/plasteel,
/area/shuttle/supply)
"w" = (
/turf/closed/wall/mineral/plastitanium,
/area/shuttle/supply)
"x" = (
/obj/structure/shuttle/engine/heater,
/obj/effect/spawner/structure/window/shuttle,
/turf/open/floor/plating,
/area/shuttle/supply)
"y" = (
/obj/machinery/conveyor{
	dir = 1;
	id = "QMLoad2"
	},
/turf/open/floor/plasteel/dark,
/area/shuttle/supply)
"z" = (
/obj/structure/shuttle/engine/propulsion/burst/left,
/turf/open/floor/plating/airless,
/area/shuttle/supply)
"A" = (
/obj/effect/turf_decal/bot,
/obj/effect/decal/cleanable/dirt,
/obj/effect/decal/cleanable/dirt,
/obj/effect/turf_decal/stripes/line{
	dir = 5
	},
/obj/structure/railing{
	dir = 4
	},
/turf/open/floor/plasteel,
/area/shuttle/supply)
"B" = (
/obj/machinery/light{
	dir = 1
	},
/obj/machinery/conveyor/inverted{
	dir = 5;
	id = "MailConv"
	},
/obj/effect/decal/cleanable/dirt,
/obj/effect/decal/cleanable/dirt,
/turf/open/floor/plasteel/dark,
/area/shuttle/supply)
"C" = (
/obj/effect/turf_decal/stripes/line{
	dir = 8
	},
/obj/effect/turf_decal/loading_area{
	dir = 4;
	pixel_x = 4
	},
/turf/open/floor/plasteel,
/area/shuttle/supply)
"D" = (
/obj/machinery/light,
/obj/machinery/conveyor{
	dir = 1;
	id = "QMLoad2"
	},
/turf/open/floor/plasteel/dark,
/area/shuttle/supply)
"E" = (
/obj/effect/spawner/structure/window/shuttle,
/turf/open/floor/plating,
/area/shuttle/supply)
"F" = (
/obj/effect/decal/cleanable/dirt,
/obj/effect/decal/cleanable/dirt,
/obj/effect/turf_decal/stripes/line{
	dir = 10
	},
/obj/effect/turf_decal/loading_area{
	dir = 4;
	pixel_x = 4
	},
/turf/open/floor/plasteel,
/area/shuttle/supply)
"G" = (
/obj/machinery/light{
	dir = 8
	},
/obj/machinery/conveyor{
	id = "MailConv"
	},
/turf/open/floor/plasteel/dark,
/area/shuttle/supply)
"H" = (
/obj/structure/fans/tiny,
/obj/machinery/door/poddoor{
	id = "QMLoaddoor2";
	name = "Supply Dock Loading Door"
	},
/obj/machinery/conveyor{
	dir = 8;
	id = "MailConv"
	},
/obj/structure/plasticflaps,
/turf/open/floor/plasteel/sepia,
/area/shuttle/supply)
"I" = (
/obj/machinery/light{
	dir = 1
	},
/obj/machinery/conveyor/inverted{
	dir = 6;
	id = "MailConv"
	},
/obj/effect/decal/cleanable/dirt,
/turf/open/floor/plasteel/dark,
/area/shuttle/supply)
"J" = (
/obj/effect/decal/cleanable/dirt,
/obj/effect/turf_decal/stripes/line{
	dir = 8
	},
/obj/effect/turf_decal/loading_area{
	dir = 4;
	pixel_x = 4
	},
/turf/open/floor/plasteel,
/area/shuttle/supply)
"K" = (
/obj/machinery/conveyor{
	id = "MailConv"
	},
/obj/effect/decal/cleanable/dirt,
/turf/open/floor/plasteel/dark,
/area/shuttle/supply)
"L" = (
/obj/effect/decal/cleanable/dirt,
/turf/closed/wall/mineral/titanium,
/area/shuttle/supply)
"M" = (
/obj/machinery/conveyor{
	dir = 1;
	id = "MailConv"
	},
/obj/effect/decal/cleanable/dirt,
/turf/open/floor/plasteel/dark,
/area/shuttle/supply)
"N" = (
/obj/machinery/door/airlock/titanium{
	name = "Supply Shuttle Airlock";
	req_access_txt = "31"
	},
/obj/structure/fans/tiny,
/turf/open/floor/plating,
/area/shuttle/supply)
"O" = (
/obj/machinery/light{
	dir = 4
	},
/obj/machinery/button/door{
	id = "QMLoaddoor2";
	layer = 4;
	name = "Loading Doors";
	pixel_x = 32;
	pixel_y = 5;
	req_access_txt = "31"
	},
/obj/machinery/button/door{
	id = "QMLoaddoor";
	layer = 4;
	name = "Loading Doors";
	pixel_x = 32;
	pixel_y = -5;
	req_access_txt = "31"
	},
/obj/effect/decal/cleanable/dirt,
/obj/effect/decal/cleanable/dirt,
/obj/effect/turf_decal/stripes/line{
	dir = 4
	},
/obj/effect/turf_decal/caution/stand_clear{
	dir = 8
	},
/turf/open/floor/plasteel,
/area/shuttle/supply)
"P" = (
/obj/machinery/conveyor{
	id = "MailConv"
	},
/obj/effect/decal/cleanable/dirt,
/obj/effect/decal/cleanable/dirt,
/turf/open/floor/plasteel/dark,
/area/shuttle/supply)
"Q" = (
/obj/effect/turf_decal/bot,
/turf/open/floor/plasteel,
/area/shuttle/supply)
"R" = (
/obj/structure/sign/warning/fire,
/turf/closed/wall/mineral/titanium,
/area/shuttle/supply)
"S" = (
/obj/machinery/conveyor_switch/oneway{
	dir = 1;
	id = "MailConv"
	},
/obj/effect/decal/cleanable/dirt,
/obj/effect/decal/cleanable/dirt,
/obj/effect/turf_decal/stripes/line{
	dir = 5
	},
/obj/structure/railing{
	dir = 1
	},
/turf/open/floor/plasteel,
/area/shuttle/supply)
"T" = (
/obj/effect/turf_decal/bot,
/obj/effect/decal/cleanable/dirt,
/turf/open/floor/plasteel,
/area/shuttle/supply)
"U" = (
/obj/machinery/conveyor{
	id = "MailConv"
	},
/turf/open/floor/plasteel/dark,
/area/shuttle/supply)
"V" = (
/obj/machinery/light,
/obj/machinery/conveyor{
	id = "MailConv"
	},
/obj/effect/decal/cleanable/dirt,
/turf/open/floor/plasteel/dark,
/area/shuttle/supply)
"W" = (
/obj/structure/table/reinforced,
/obj/effect/turf_decal/stripes/end{
	dir = 4
	},
/turf/open/floor/plasteel/sepia,
/area/shuttle/supply)
"X" = (
/obj/structure/shuttle/engine/propulsion,
/turf/open/floor/plating/airless,
/area/shuttle/supply)
"Y" = (
/obj/effect/decal/cleanable/dirt,
/obj/effect/turf_decal/stripes/line{
	dir = 4
	},
/obj/effect/turf_decal/bot,
/turf/open/floor/plasteel,
/area/shuttle/supply)
"Z" = (
/obj/machinery/conveyor{
	dir = 9;
	id = "MailConv"
	},
/turf/open/floor/plasteel/dark,
/area/shuttle/supply)

(1,1,1) = {"
h
d
E
E
E
E
E
E
E
E
E
g
w
"}
(2,1,1) = {"
d
g
B
K
K
U
G
U
K
P
V
R
z
"}
(3,1,1) = {"
E
r
a
t
C
C
J
C
C
J
F
x
X
"}
(4,1,1) = {"
E
c
a
o
T
Q
Q
Q
Q
T
n
x
X
"}
(5,1,1) = {"
E
W
i
A
m
u
Q
e
k
Y
p
x
X
"}
(6,1,1) = {"
d
g
I
M
Z
S
O
j
s
y
D
R
f
"}
(7,1,1) = {"
h
d
d
d
H
N
d
q
l
L
d
g
w
"}
