//MAP CONVERTED BY dmm2tgm.py THIS HEADER COMMENT PREVENTS RECONVERSION, DO NOT REMOVE
"a" = (
/obj/machinery/deepfryer{
	dir = 1
	},
/turf/open/floor/plating/beach/sand,
/area/tdome/arena)
"b" = (
/mob/living/simple_animal/crab{
	desc = "FUCK YEAH AMERICA";
	name = "american crab"
	},
/turf/open/floor/plating/beach/sand,
/area/tdome/arena)
"c" = (
/obj/item/reagent_containers/glass/beaker{
	list_reagents = list(/datum/reagent/consumable/cooking_oil = 50);
	dir = 1
	},
/turf/open/floor/plating/beach/sand,
/area/tdome/arena)
"d" = (
/turf/open/floor/plating/beach/sand,
/area/tdome/arena)
"e" = (
/obj/structure/mineral_door/wood{
	name = "bar";
	opacity = 0;
	dir = 1
	},
/turf/open/floor/plating/beach/sand,
/area/tdome/arena)
"f" = (
/turf/open/floor/wood,
/area/tdome/arena)
"g" = (
/obj/structure/chair/wood{
	dir = 1
	},
/mob/living/simple_animal/parrot,
/turf/open/floor/wood,
/area/tdome/arena)
"h" = (
/obj/item/reagent_containers/food/drinks/soda_cans/monkey_energy{
	dir = 1
	},
/turf/open/floor/plating/beach/sand,
/area/tdome/arena)
"i" = (
/obj/structure/chair/stool{
	dir = 1
	},
/mob/living/simple_animal/crab{
	desc = "He just wants to grill for God's sake!";
	name = "boomer crab"
	},
/turf/open/floor/plating/beach/sand,
/area/tdome/arena)
"j" = (
/obj/machinery/grill{
	dir = 1
	},
/turf/open/floor/plating/beach/sand,
/area/tdome/arena)
"k" = (
/obj/item/reagent_containers/food/snacks/meat/crab{
	dir = 1
	},
/turf/open/floor/plating/beach/sand,
/area/tdome/arena)
"l" = (
/obj/item/reagent_containers/food/snacks/burger/crab{
	dir = 1
	},
/turf/open/floor/plating/beach/sand,
/area/tdome/arena)
"m" = (
/turf/closed/wall/mineral/sandstone{
	opacity = 0
	},
/area/tdome/arena)
"n" = (
/obj/structure/table/wood{
	dir = 1
	},
/obj/item/reagent_containers/food/drinks/bottle/rum{
	dir = 1
	},
/turf/open/floor/wood,
/area/tdome/arena)
"o" = (
/obj/structure/table/wood{
	dir = 1
	},
/obj/item/reagent_containers/food/drinks/bottle/absinthe/premium{
	dir = 1
	},
/turf/open/floor/wood,
/area/tdome/arena)
"p" = (
/obj/structure/table/wood{
	dir = 1
	},
/obj/item/reagent_containers/food/drinks/bottle/tequila{
	dir = 1
	},
/turf/open/floor/wood,
/area/tdome/arena)
"q" = (
/obj/item/reagent_containers/food/snacks/crab_rangoon{
	dir = 1
	},
/turf/open/floor/plating/beach/sand,
/area/tdome/arena)
"r" = (
/obj/effect/overlay/coconut{
	dir = 1
	},
/turf/open/floor/plating/beach/sand,
/area/tdome/arena)
"s" = (
/obj/structure/flora/tree/palm{
	dir = 1
	},
/turf/open/floor/plating/beach/sand,
/area/tdome/arena)
"t" = (
/obj/structure/chair/stool{
	dir = 1
	},
/turf/open/floor/plating/beach/sand,
/area/tdome/arena)
"u" = (
/obj/structure/flora/tree/palm{
	dir = 1
	},
/obj/effect/overlay/coconut{
	dir = 1
	},
/turf/open/floor/plating/beach/sand,
/area/tdome/arena)
"v" = (
/obj/item/clothing/mask/gas/tiki_mask{
	dir = 1
	},
/turf/open/floor/plating/beach/sand,
/area/tdome/arena)
"w" = (
/obj/structure/bonfire{
	dir = 1
	},
/turf/open/floor/plating/beach/sand,
/area/tdome/arena)
"x" = (
/obj/item/flashlight/flare/torch{
	dir = 1
	},
/turf/open/floor/plating/beach/sand,
/area/tdome/arena)
"y" = (
/obj/item/clothing/head/collectable/paper{
	dir = 1
	},
/turf/open/floor/plating/beach/sand,
/area/tdome/arena)
"A" = (
/turf/open/floor/plating/beach/coastline_t,
/area/tdome/arena)
"B" = (
/turf/open/floor/plating/beach/coastline_t/sandwater_inner{
	dir = 8
	},
/area/tdome/arena)
"D" = (
/obj/structure/chair/comfy/shuttle{
	dir = 1
	},
/mob/living/simple_animal/crab,
/turf/open/floor/plating/beach/sand,
/area/tdome/arena)
"E" = (
/obj/item/toy/beach_ball{
	dir = 1
	},
/turf/open/floor/plating/beach/sand,
/area/tdome/arena)
"F" = (
/turf/open/floor/plating/beach/coastline_t/sandwater_inner,
/area/tdome/arena)
"G" = (
/turf/open/floor/plating/beach/coastline_b{
	dir = 5
	},
/area/tdome/arena)
"H" = (
/turf/open/floor/plating/beach/coastline_t{
	dir = 10
	},
/area/tdome/arena)
"I" = (
/turf/open/floor/plating/beach/coastline_t{
	dir = 6
	},
/area/tdome/arena)
"J" = (
/turf/open/floor/plating/beach/coastline_b{
	dir = 9
	},
/area/tdome/arena)
"K" = (
/turf/open/floor/plating/beach/water{
	desc = "What's the difference?";
	name = "coastline water"
	},
/area/tdome/arena)
"L" = (
/turf/open/floor/holofloor/beach/coast_b,
/area/tdome/arena)
"M" = (
/obj/structure/flora/rock{
	desc = "A volcanic rock.";
	name = "coastal rock";
	dir = 1
	},
/obj/structure/flora/ausbushes/stalkybush{
	desc = "It can't be smoked.";
	name = "sea weed";
	dir = 1
	},
/turf/open/floor/plating/beach/water,
/area/tdome/arena)
"N" = (
/turf/open/floor/plating/beach/water,
/area/tdome/arena)

(1,1,1) = {"
M
K
G
A
d
d
k
a"}(2,1,1) = {"
N
L
H
B
d
d
l
b"}(3,1,1) = {"
N
L
A
d
d
r
d
c"}(4,1,1) = {"
N
L
A
d
d
s
d
d"}(5,1,1) = {"
N
L
A
D
d
d
d
d"}(6,1,1) = {"
N
L
A
E
d
d
m
e"}(7,1,1) = {"
N
L
A
d
v
t
n
f"}(8,1,1) = {"
N
L
A
d
w
t
o
g"}(9,1,1) = {"
N
L
A
d
x
t
p
f"}(10,1,1) = {"
N
L
A
d
d
d
m
e"}(11,1,1) = {"
N
L
A
d
d
d
d
d"}(12,1,1) = {"
N
L
A
d
y
d
d
d"}(13,1,1) = {"
N
L
A
d
d
u
d
h"}(14,1,1) = {"
N
L
I
F
d
d
q
i"}(15,1,1) = {"
M
K
J
A
d
d
k
j"}