//MAP CONVERTED BY dmm2tgm.py THIS HEADER COMMENT PREVENTS RECONVERSION, DO NOT REMOVE
"aa" = (
/obj/effect/turf_decal/stripes/corner{
	dir = 4
	},
/obj/structure/cable{
	icon_state = "0-2"
	},
/obj/effect/decal/cleanable/dirt{
	dir = 4
	},
/turf/open/floor/plating,
/area/tdome/arena)
"ab" = (
/obj/machinery/power/emitter/energycannon{
	dir = 1
	},
/obj/effect/turf_decal/box{
	dir = 4
	},
/obj/effect/turf_decal/stripes/line{
	dir = 1
	},
/obj/structure/cable{
	icon_state = "0-2"
	},
/obj/effect/decal/cleanable/dirt{
	dir = 4
	},
/turf/open/floor/plating,
/area/tdome/arena)
"ac" = (
/obj/effect/turf_decal/stripes/line{
	dir = 1
	},
/obj/structure/cable{
	icon_state = "0-2"
	},
/obj/effect/decal/cleanable/dirt{
	dir = 4
	},
/turf/open/floor/plating,
/area/tdome/arena)
"ad" = (
/obj/effect/turf_decal/stripes/line{
	dir = 5
	},
/obj/structure/cable{
	icon_state = "0-2"
	},
/turf/open/floor/plating,
/area/tdome/arena)
"ae" = (
/obj/structure/reflector/box/anchored{
	icon_state = "reflector_map";
	dir = 5
	},
/obj/effect/turf_decal/box{
	dir = 4
	},
/obj/structure/cable{
	icon_state = "0-2"
	},
/obj/effect/decal/cleanable/dirt{
	dir = 4
	},
/turf/open/floor/engine,
/area/tdome/arena)
"af" = (
/obj/effect/turf_decal/stripes/line{
	dir = 9
	},
/obj/structure/cable{
	icon_state = "0-2"
	},
/obj/effect/decal/cleanable/dirt{
	dir = 4
	},
/turf/open/floor/plating,
/area/tdome/arena)
"ag" = (
/obj/effect/turf_decal/stripes/line{
	dir = 1
	},
/obj/structure/cable{
	icon_state = "0-2"
	},
/turf/open/floor/plating,
/area/tdome/arena)
"ah" = (
/obj/effect/turf_decal/stripes/line{
	dir = 5
	},
/obj/structure/cable{
	icon_state = "0-2"
	},
/obj/effect/decal/cleanable/dirt{
	dir = 4
	},
/turf/open/floor/plating,
/area/tdome/arena)
"ai" = (
/obj/structure/reflector/box/anchored{
	icon_state = "reflector_map";
	dir = 9
	},
/obj/effect/turf_decal/box{
	dir = 4
	},
/obj/structure/cable{
	icon_state = "0-2"
	},
/obj/effect/decal/cleanable/dirt{
	dir = 4
	},
/turf/open/floor/engine,
/area/tdome/arena)
"aj" = (
/obj/machinery/power/emitter/energycannon{
	dir = 1
	},
/obj/effect/turf_decal/box{
	dir = 4
	},
/obj/effect/turf_decal/stripes/line{
	dir = 1
	},
/obj/structure/cable{
	icon_state = "0-2"
	},
/turf/open/floor/plating,
/area/tdome/arena)
"ak" = (
/obj/structure/cable{
	icon_state = "0-2"
	},
/obj/effect/decal/cleanable/dirt{
	dir = 4
	},
/turf/open/floor/plating,
/area/tdome/arena)
"al" = (
/obj/effect/turf_decal/stripes/line{
	dir = 4
	},
/obj/structure/cable{
	icon_state = "0-2"
	},
/obj/effect/decal/cleanable/dirt{
	dir = 4
	},
/turf/open/floor/plating,
/area/tdome/arena)
"am" = (
/turf/open/floor/circuit/green/anim,
/area/tdome/arena)
"an" = (
/obj/effect/turf_decal/trimline/red/filled/line{
	icon_state = "trimline_fill";
	dir = 10
	},
/obj/effect/turf_decal/tile/neutral{
	dir = 4
	},
/turf/open/floor/plasteel/dark,
/area/tdome/arena)
"ao" = (
/obj/effect/turf_decal/trimline/red/filled/line{
	icon_state = "trimline_fill";
	dir = 2
	},
/obj/effect/turf_decal/stripes/corner{
	dir = 2
	},
/obj/effect/turf_decal/tile/neutral{
	dir = 4
	},
/obj/effect/turf_decal/tile/neutral{
	dir = 1
	},
/turf/open/floor/plasteel/dark,
/area/tdome/arena)
"ap" = (
/obj/effect/turf_decal/trimline/red/filled/line{
	icon_state = "trimline_fill";
	dir = 6
	},
/obj/effect/turf_decal/stripes/line{
	dir = 2
	},
/obj/effect/turf_decal/tile/neutral{
	dir = 1
	},
/turf/open/floor/plasteel/dark,
/area/tdome/arena)
"aq" = (
/obj/effect/turf_decal/stripes/corner{
	dir = 8
	},
/obj/effect/turf_decal/stripes/corner{
	dir = 4
	},
/turf/open/floor/circuit/green/anim,
/area/tdome/arena)
"ar" = (
/obj/effect/turf_decal/trimline/red/filled/end{
	icon_state = "trimline_end_fill";
	dir = 8
	},
/obj/effect/turf_decal/stripes/line{
	dir = 1
	},
/turf/open/floor/plasteel/dark,
/area/tdome/arena)
"as" = (
/obj/effect/turf_decal/trimline/red/filled/line{
	icon_state = "trimline_fill";
	dir = 2
	},
/obj/effect/turf_decal/trimline/red/filled/line{
	dir = 1
	},
/obj/effect/turf_decal/stripes/line{
	dir = 1
	},
/turf/open/floor/plasteel/dark,
/area/tdome/arena)
"at" = (
/obj/effect/turf_decal/trimline/red/filled/end{
	icon_state = "trimline_end_fill";
	dir = 4
	},
/obj/effect/turf_decal/stripes/line{
	dir = 1
	},
/turf/open/floor/plasteel/dark,
/area/tdome/arena)
"au" = (
/obj/effect/turf_decal/stripes/corner{
	dir = 2
	},
/obj/effect/turf_decal/stripes/corner{
	dir = 1
	},
/turf/open/floor/circuit/green/anim,
/area/tdome/arena)
"av" = (
/obj/effect/turf_decal/trimline/red/filled/line{
	icon_state = "trimline_fill";
	dir = 10
	},
/obj/effect/turf_decal/stripes/line{
	dir = 2
	},
/obj/effect/turf_decal/tile/neutral{
	dir = 4
	},
/turf/open/floor/plasteel/dark,
/area/tdome/arena)
"aw" = (
/obj/effect/turf_decal/trimline/red/filled/line{
	icon_state = "trimline_fill";
	dir = 2
	},
/obj/effect/turf_decal/stripes/corner{
	dir = 8
	},
/obj/effect/turf_decal/tile/neutral{
	dir = 1
	},
/obj/effect/turf_decal/tile/neutral{
	dir = 4
	},
/turf/open/floor/plasteel/dark,
/area/tdome/arena)
"ax" = (
/obj/effect/turf_decal/trimline/red/filled/line{
	icon_state = "trimline_fill";
	dir = 6
	},
/obj/effect/turf_decal/tile/neutral{
	dir = 1
	},
/turf/open/floor/plasteel/dark,
/area/tdome/arena)
"ay" = (
/obj/effect/turf_decal/stripes/line{
	dir = 8
	},
/obj/structure/cable{
	icon_state = "0-2"
	},
/obj/effect/decal/cleanable/dirt{
	dir = 4
	},
/turf/open/floor/plating,
/area/tdome/arena)
"az" = (
/obj/effect/turf_decal/stripes/line{
	dir = 4
	},
/obj/structure/cable{
	icon_state = "0-2"
	},
/turf/open/floor/plating,
/area/tdome/arena)
"aA" = (
/obj/effect/turf_decal/trimline/red/filled/line{
	icon_state = "trimline_fill";
	dir = 8
	},
/obj/effect/turf_decal/tile/neutral{
	dir = 4
	},
/obj/effect/turf_decal/tile/neutral{
	dir = 2
	},
/turf/open/floor/plasteel/dark,
/area/tdome/arena)
"aB" = (
/obj/effect/turf_decal/tile/neutral{
	dir = 8
	},
/obj/effect/turf_decal/tile/neutral{
	dir = 4
	},
/obj/effect/turf_decal/tile/neutral{
	dir = 2
	},
/obj/effect/turf_decal/tile/neutral{
	dir = 1
	},
/turf/open/floor/plasteel/dark,
/area/tdome/arena)
"aC" = (
/obj/effect/turf_decal/trimline/red/filled/corner{
	icon_state = "trimline_corner_fill";
	dir = 2
	},
/obj/effect/turf_decal/tile/neutral{
	dir = 8
	},
/obj/effect/turf_decal/tile/neutral{
	dir = 4
	},
/obj/effect/turf_decal/tile/neutral{
	dir = 1
	},
/turf/open/floor/plasteel/dark,
/area/tdome/arena)
"aD" = (
/obj/effect/turf_decal/trimline/red/filled/line{
	icon_state = "trimline_fill";
	dir = 6
	},
/obj/effect/turf_decal/stripes/line{
	dir = 4
	},
/obj/effect/turf_decal/tile/neutral{
	dir = 1
	},
/turf/open/floor/plasteel/dark,
/area/tdome/arena)
"aE" = (
/obj/effect/turf_decal/delivery{
	dir = 4
	},
/turf/open/floor/plasteel/dark,
/area/tdome/arena)
"aF" = (
/obj/effect/turf_decal/trimline/red/filled/line{
	icon_state = "trimline_fill";
	dir = 10
	},
/obj/effect/turf_decal/stripes/line{
	dir = 8
	},
/obj/effect/turf_decal/tile/neutral{
	dir = 4
	},
/turf/open/floor/plasteel/dark,
/area/tdome/arena)
"aG" = (
/obj/effect/turf_decal/trimline/red/filled/corner{
	icon_state = "trimline_corner_fill";
	dir = 8
	},
/obj/effect/turf_decal/tile/neutral{
	dir = 1
	},
/obj/effect/turf_decal/tile/neutral{
	dir = 4
	},
/obj/effect/turf_decal/tile/neutral{
	dir = 2
	},
/turf/open/floor/plasteel/dark,
/area/tdome/arena)
"aH" = (
/obj/effect/turf_decal/tile/neutral{
	dir = 1
	},
/obj/effect/turf_decal/tile/neutral{
	dir = 4
	},
/obj/effect/turf_decal/tile/neutral{
	dir = 2
	},
/obj/effect/turf_decal/tile/neutral{
	dir = 8
	},
/turf/open/floor/plasteel/dark,
/area/tdome/arena)
"aI" = (
/obj/effect/turf_decal/trimline/red/filled/line{
	icon_state = "trimline_fill";
	dir = 4
	},
/obj/effect/turf_decal/tile/neutral{
	dir = 1
	},
/obj/effect/turf_decal/tile/neutral{
	dir = 8
	},
/turf/open/floor/plasteel/dark,
/area/tdome/arena)
"aJ" = (
/obj/effect/turf_decal/trimline/red/filled/line{
	icon_state = "trimline_fill";
	dir = 4
	},
/obj/effect/turf_decal/stripes/line{
	dir = 4
	},
/obj/effect/turf_decal/tile/neutral{
	dir = 8
	},
/obj/effect/turf_decal/tile/neutral{
	dir = 1
	},
/turf/open/floor/plasteel/dark,
/area/tdome/arena)
"aK" = (
/obj/effect/turf_decal/caution/stand_clear{
	dir = 4
	},
/turf/open/floor/plasteel/dark,
/area/tdome/arena)
"aL" = (
/obj/effect/turf_decal/trimline/red/filled/line{
	icon_state = "trimline_fill";
	dir = 8
	},
/obj/effect/turf_decal/stripes/line{
	dir = 8
	},
/obj/effect/turf_decal/tile/neutral{
	dir = 4
	},
/obj/effect/turf_decal/tile/neutral{
	dir = 2
	},
/turf/open/floor/plasteel/dark,
/area/tdome/arena)
"aM" = (
/obj/effect/turf_decal/stripes/line{
	dir = 8
	},
/obj/structure/cable{
	icon_state = "0-2"
	},
/turf/open/floor/plating,
/area/tdome/arena)
"aN" = (
/obj/effect/turf_decal/trimline/red/filled/corner{
	dir = 4
	},
/obj/effect/turf_decal/tile/neutral{
	dir = 8
	},
/obj/effect/turf_decal/tile/neutral{
	dir = 2
	},
/obj/effect/turf_decal/tile/neutral{
	dir = 1
	},
/turf/open/floor/plasteel/dark,
/area/tdome/arena)
"aO" = (
/obj/effect/turf_decal/trimline/red/filled/line{
	icon_state = "trimline_fill";
	dir = 5
	},
/obj/effect/turf_decal/stripes/line{
	dir = 4
	},
/obj/effect/turf_decal/tile/neutral{
	dir = 8
	},
/turf/open/floor/plasteel/dark,
/area/tdome/arena)
"aP" = (
/obj/effect/turf_decal/trimline/red/filled/line{
	icon_state = "trimline_fill";
	dir = 9
	},
/obj/effect/turf_decal/stripes/line{
	dir = 8
	},
/obj/effect/turf_decal/tile/neutral{
	dir = 2
	},
/turf/open/floor/plasteel/dark,
/area/tdome/arena)
"aQ" = (
/obj/effect/turf_decal/trimline/red/filled/corner{
	icon_state = "trimline_corner_fill";
	dir = 1
	},
/obj/effect/turf_decal/tile/neutral{
	dir = 4
	},
/obj/effect/turf_decal/tile/neutral{
	dir = 2
	},
/obj/effect/turf_decal/tile/neutral{
	dir = 8
	},
/turf/open/floor/plasteel/dark,
/area/tdome/arena)
"aR" = (
/obj/effect/turf_decal/trimline/red/filled/line{
	icon_state = "trimline_fill";
	dir = 5
	},
/obj/effect/turf_decal/tile/neutral{
	dir = 8
	},
/turf/open/floor/plasteel/dark,
/area/tdome/arena)
"aS" = (
/obj/effect/turf_decal/stripes/corner{
	dir = 2
	},
/turf/open/floor/circuit/green/anim,
/area/tdome/arena)
"aT" = (
/obj/effect/turf_decal/trimline/red/filled/line{
	icon_state = "trimline_fill";
	dir = 2
	},
/obj/effect/turf_decal/stripes/line{
	dir = 2
	},
/obj/effect/turf_decal/tile/neutral{
	dir = 4
	},
/obj/effect/turf_decal/tile/neutral{
	dir = 1
	},
/turf/open/floor/plasteel/dark,
/area/tdome/arena)
"aU" = (
/obj/effect/turf_decal/stripes/corner{
	dir = 8
	},
/turf/open/floor/circuit/green/anim,
/area/tdome/arena)
"aV" = (
/obj/effect/turf_decal/trimline/red/filled/line{
	icon_state = "trimline_fill";
	dir = 9
	},
/obj/effect/turf_decal/tile/neutral{
	dir = 2
	},
/turf/open/floor/plasteel/dark,
/area/tdome/arena)
"aW" = (
/obj/effect/turf_decal/stripes/line{
	dir = 1
	},
/turf/open/floor/circuit/green/anim,
/area/tdome/arena)
"aX" = (
/obj/effect/turf_decal/trimline/red/filled/line{
	icon_state = "trimline_fill";
	dir = 9
	},
/obj/effect/turf_decal/stripes/line{
	dir = 1
	},
/obj/effect/turf_decal/tile/neutral{
	dir = 2
	},
/turf/open/floor/plasteel/dark,
/area/tdome/arena)
"aY" = (
/obj/effect/turf_decal/trimline/red/filled/line{
	icon_state = "trimline_fill";
	dir = 5
	},
/obj/effect/turf_decal/stripes/line{
	dir = 1
	},
/obj/effect/turf_decal/tile/neutral{
	dir = 8
	},
/turf/open/floor/plasteel/dark,
/area/tdome/arena)
"aZ" = (
/obj/effect/turf_decal/trimline/red/filled/line{
	dir = 1
	},
/obj/effect/turf_decal/trimline/red/filled/corner{
	icon_state = "trimline_corner_fill";
	dir = 8
	},
/obj/effect/turf_decal/stripes/line{
	dir = 1
	},
/obj/effect/turf_decal/tile/neutral{
	dir = 2
	},
/turf/open/floor/plasteel/dark,
/area/tdome/arena)
"ba" = (
/obj/effect/turf_decal/trimline/red/filled/line{
	dir = 1
	},
/obj/effect/turf_decal/stripes/line{
	dir = 1
	},
/obj/effect/turf_decal/tile/neutral{
	dir = 2
	},
/obj/effect/turf_decal/tile/neutral{
	dir = 8
	},
/turf/open/floor/plasteel/dark,
/area/tdome/arena)
"bb" = (
/obj/effect/turf_decal/trimline/red/filled/line{
	dir = 1
	},
/obj/effect/turf_decal/stripes/line{
	dir = 1
	},
/obj/effect/turf_decal/trimline/red/filled/corner{
	icon_state = "trimline_corner_fill";
	dir = 2
	},
/obj/effect/turf_decal/tile/neutral{
	dir = 8
	},
/turf/open/floor/plasteel/dark,
/area/tdome/arena)
"bc" = (
/obj/structure/reflector/box/anchored{
	icon_state = "reflector_map";
	dir = 4
	},
/obj/effect/turf_decal/box{
	dir = 4
	},
/obj/structure/cable{
	icon_state = "0-2"
	},
/turf/open/floor/engine,
/area/tdome/arena)
"bd" = (
/obj/effect/turf_decal/stripes/line{
	dir = 8
	},
/obj/effect/turf_decal/stripes/line{
	dir = 4
	},
/obj/structure/cable{
	icon_state = "0-2"
	},
/turf/open/floor/circuit/green/anim,
/area/tdome/arena)
"be" = (
/obj/structure/reflector/box/anchored{
	icon_state = "reflector_map";
	dir = 6
	},
/obj/effect/turf_decal/box{
	dir = 4
	},
/obj/structure/cable{
	icon_state = "0-2"
	},
/turf/open/floor/engine,
/area/tdome/arena)
"bf" = (
/obj/machinery/power/emitter/energycannon{
	icon_state = "emitter_+a";
	dir = 2
	},
/obj/effect/turf_decal/box{
	dir = 4
	},
/obj/effect/turf_decal/stripes/line{
	dir = 8
	},
/obj/structure/cable{
	icon_state = "0-2"
	},
/turf/open/floor/plating,
/area/tdome/arena)
"bg" = (
/obj/structure/cable{
	icon_state = "0-2"
	},
/turf/open/floor/plating,
/area/tdome/arena)
"bh" = (
/obj/machinery/power/emitter/energycannon{
	icon_state = "emitter_+a";
	dir = 2
	},
/obj/effect/turf_decal/box{
	dir = 4
	},
/obj/effect/turf_decal/stripes/line{
	dir = 4
	},
/obj/structure/cable{
	icon_state = "0-2"
	},
/turf/open/floor/plating,
/area/tdome/arena)
"bi" = (
/obj/structure/reflector/box/anchored{
	icon_state = "reflector_map";
	dir = 10
	},
/obj/effect/turf_decal/box{
	dir = 4
	},
/obj/structure/cable{
	icon_state = "0-2"
	},
/turf/open/floor/engine,
/area/tdome/arena)
"bj" = (
/obj/structure/reflector/box/anchored{
	icon_state = "reflector_map";
	dir = 8
	},
/obj/effect/turf_decal/box{
	dir = 4
	},
/obj/structure/cable{
	icon_state = "0-2"
	},
/obj/effect/decal/cleanable/dirt{
	dir = 4
	},
/turf/open/floor/engine,
/area/tdome/arena)

(1,1,1) = {"
al
al
az
al
al
az
al
aa"}(2,1,1) = {"
bc
aW
am
am
am
am
am
ab"}(3,1,1) = {"
bd
aX
aA
aA
aA
aA
an
ac"}(4,1,1) = {"
be
aY
aN
aB
aB
aB
ao
ad"}(5,1,1) = {"
bf
aW
aR
aN
aB
aC
ap
ae"}(6,1,1) = {"
ak
ar
aS
aO
aJ
aD
aq
af"}(7,1,1) = {"
bg
aZ
av
am
aK
am
ar
ac"}(8,1,1) = {"
ak
ba
aT
aE
am
aE
as
ag"}(9,1,1) = {"
ak
bb
ap
am
aK
am
at
ag"}(10,1,1) = {"
ak
at
aU
aP
aL
aF
au
ah"}(11,1,1) = {"
bh
aW
aV
aQ
aH
aG
av
ai"}(12,1,1) = {"
bi
aX
aQ
aH
aH
aH
aw
af"}(13,1,1) = {"
bd
aY
aI
aI
aI
aI
ax
ac"}(14,1,1) = {"
bj
aW
am
am
am
am
am
aj"}(15,1,1) = {"
ay
aM
ay
ay
aM
ay
ay
ak"}