//MAP CONVERTED BY dmm2tgm.py THIS HEADER COMMENT PREVENTS RECONVERSION, DO NOT REMOVE
"aa" = (
/obj/structure/stone_tile/surrounding_tile/cracked{
	dir = 1
	},
/obj/structure/stone_tile/cracked{
	dir = 2
	},
/obj/structure/stone_tile/center/cracked{
	pixel_x = 8;
	pixel_y = 8;
	dir = 1
	},
/obj/structure/stone_tile/cracked{
	dir = 8
	},
/turf/open/indestructible/necropolis/air,
/area/tdome/arena)
"ab" = (
/obj/structure/stone_tile/block/cracked{
	dir = 2
	},
/turf/open/indestructible/necropolis/air,
/area/tdome/arena)
"ac" = (
/turf/open/indestructible/necropolis/air,
/area/tdome/arena)
"ad" = (
/obj/structure/stone_tile/surrounding_tile/cracked{
	dir = 8;
	pixel_y = -16
	},
/obj/structure/stone_tile/block/cracked{
	dir = 8
	},
/obj/structure/stone_tile/block/cracked{
	dir = 4
	},
/obj/structure/stone_tile/surrounding_tile/cracked{
	dir = 4;
	pixel_y = 16
	},
/obj/structure/stone_tile/surrounding_tile/cracked{
	pixel_y = -16;
	dir = 1
	},
/turf/open/indestructible/necropolis/air,
/area/tdome/arena)
"ae" = (
/obj/structure/stone_tile/block{
	dir = 2
	},
/turf/open/indestructible/necropolis/air,
/area/tdome/arena)
"af" = (
/obj/structure/stone_tile/surrounding_tile{
	dir = 8
	},
/obj/structure/stone_tile{
	dir = 1
	},
/obj/structure/stone_tile{
	dir = 4
	},
/obj/structure/stone_tile/center{
	pixel_x = -8;
	pixel_y = 8;
	dir = 1
	},
/turf/open/indestructible/necropolis/air,
/area/tdome/arena)
"ag" = (
/obj/structure/stone_tile/block/cracked{
	dir = 8
	},
/turf/open/indestructible/necropolis/air,
/area/tdome/arena)
"ah" = (
/obj/structure/stone_tile/cracked{
	dir = 4
	},
/turf/open/indestructible/necropolis/air,
/area/tdome/arena)
"ai" = (
/obj/structure/stone_tile/cracked{
	dir = 2
	},
/obj/structure/stone_tile/cracked{
	dir = 4
	},
/turf/open/indestructible/necropolis/air,
/area/tdome/arena)
"aj" = (
/obj/structure/stone_tile/slab/cracked{
	dir = 2
	},
/obj/structure/stone_tile/slab/cracked{
	dir = 4
	},
/turf/open/indestructible/necropolis/air,
/area/tdome/arena)
"ak" = (
/obj/structure/stone_tile/cracked{
	dir = 1
	},
/obj/structure/stone_tile/cracked{
	dir = 2
	},
/obj/structure/stone_tile/cracked{
	dir = 4
	},
/obj/structure/stone_tile/cracked{
	dir = 8
	},
/turf/open/indestructible/necropolis/air,
/area/tdome/arena)
"al" = (
/obj/structure/stone_tile/surrounding_tile{
	dir = 8;
	pixel_y = -16
	},
/obj/structure/stone_tile/block{
	dir = 8
	},
/obj/structure/stone_tile/surrounding_tile{
	dir = 4;
	pixel_y = 16
	},
/obj/structure/stone_tile/surrounding_tile/cracked{
	dir = 1;
	pixel_y = -16
	},
/obj/structure/stone_tile/block/cracked{
	dir = 4
	},
/obj/structure/stone_tile/surrounding_tile/cracked{
	dir = 2;
	pixel_y = 16
	},
/turf/open/indestructible/necropolis/air,
/area/tdome/arena)
"am" = (
/obj/structure/stone_tile/surrounding_tile{
	dir = 8;
	pixel_y = -16
	},
/obj/structure/stone_tile/surrounding_tile{
	dir = 1;
	pixel_y = -16
	},
/obj/structure/stone_tile/block{
	dir = 8
	},
/obj/structure/stone_tile/block{
	dir = 4
	},
/obj/structure/stone_tile/surrounding_tile{
	dir = 4;
	pixel_y = 16
	},
/obj/structure/stone_tile/surrounding_tile{
	dir = 2;
	pixel_y = 16
	},
/turf/open/indestructible/necropolis/air,
/area/tdome/arena)
"an" = (
/obj/structure/stone_tile/slab{
	dir = 1
	},
/turf/open/indestructible/necropolis/air,
/area/tdome/arena)
"ao" = (
/obj/structure/stone_tile{
	dir = 4
	},
/turf/open/indestructible/necropolis/air,
/area/tdome/arena)
"ap" = (
/obj/structure/stone_tile{
	dir = 2
	},
/obj/structure/stone_tile{
	dir = 4
	},
/turf/open/indestructible/necropolis/air,
/area/tdome/arena)
"aq" = (
/obj/structure/stone_tile{
	dir = 2
	},
/turf/open/indestructible/necropolis/air,
/area/tdome/arena)
"ar" = (
/obj/structure/stone_tile/block{
	dir = 4
	},
/turf/open/indestructible/necropolis/air,
/area/tdome/arena)
"as" = (
/obj/structure/stone_tile/cracked{
	dir = 8
	},
/turf/open/indestructible/necropolis/air,
/area/tdome/arena)
"at" = (
/obj/structure/stone_tile/cracked{
	dir = 1
	},
/turf/open/indestructible/necropolis/air,
/area/tdome/arena)
"au" = (
/obj/structure/stone_tile/surrounding/cracked{
	dir = 2
	},
/obj/structure/stone_tile/surrounding/cracked{
	dir = 1
	},
/turf/open/lava/smooth,
/area/tdome/arena)
"av" = (
/obj/structure/stone_tile/block/cracked{
	dir = 2
	},
/turf/open/lava/smooth,
/area/tdome/arena)
"aw" = (
/obj/structure/stone_tile/slab/cracked{
	dir = 4
	},
/obj/structure/stone_tile/slab/cracked{
	dir = 8;
	name = "cracked stone block"
	},
/obj/structure/stone_tile/slab/cracked{
	dir = 2
	},
/turf/open/lava/smooth,
/area/tdome/arena)
"ax" = (
/obj/structure/stone_tile/block{
	dir = 2
	},
/turf/open/lava/smooth,
/area/tdome/arena)
"ay" = (
/obj/structure/stone_tile/surrounding{
	dir = 1
	},
/turf/open/lava/smooth,
/area/tdome/arena)
"az" = (
/obj/structure/stone_tile{
	dir = 8
	},
/turf/open/indestructible/necropolis/air,
/area/tdome/arena)
"aA" = (
/obj/structure/stone_tile{
	dir = 1
	},
/obj/structure/stone_tile{
	dir = 8
	},
/turf/open/indestructible/necropolis/air,
/area/tdome/arena)
"aB" = (
/obj/structure/stone_tile{
	dir = 1
	},
/turf/open/indestructible/necropolis/air,
/area/tdome/arena)
"aC" = (
/obj/structure/stone_tile{
	dir = 4
	},
/obj/structure/stone_tile{
	dir = 2
	},
/turf/open/indestructible/necropolis/air,
/area/tdome/arena)
"aD" = (
/obj/structure/stone_tile{
	dir = 4
	},
/obj/structure/stone_tile/cracked{
	dir = 2
	},
/turf/open/lava/smooth,
/area/tdome/arena)
"aE" = (
/obj/structure/stone_tile/surrounding_tile/cracked{
	pixel_x = -16;
	dir = 1
	},
/obj/structure/stone_tile/block/cracked{
	dir = 1
	},
/obj/structure/stone_tile/surrounding_tile/cracked{
	dir = 2;
	pixel_x = -16
	},
/obj/structure/stone_tile/block/cracked{
	dir = 2
	},
/turf/open/indestructible/necropolis/air,
/area/tdome/arena)
"aF" = (
/obj/structure/stone_tile/slab/cracked{
	dir = 8;
	name = "cracked stone block";
	pixel_y = -16
	},
/obj/structure/stone_tile/block/cracked{
	dir = 2
	},
/turf/open/indestructible/necropolis/air,
/area/tdome/arena)
"aG" = (
/obj/structure/stone_tile/burnt{
	dir = 1
	},
/obj/structure/stone_tile/burnt{
	dir = 8
	},
/turf/open/lava/smooth,
/area/tdome/arena)
"aH" = (
/obj/structure/stone_tile/block/cracked{
	dir = 1
	},
/obj/structure/stone_tile/surrounding_tile/cracked{
	dir = 8;
	pixel_x = 16
	},
/obj/structure/stone_tile/block/cracked{
	dir = 2
	},
/obj/structure/stone_tile/surrounding_tile/cracked{
	dir = 4;
	pixel_x = 16
	},
/turf/open/indestructible/necropolis/air,
/area/tdome/arena)
"aI" = (
/obj/structure/stone_tile/slab/burnt{
	dir = 1
	},
/turf/open/lava/smooth,
/area/tdome/arena)
"aJ" = (
/obj/structure/stone_tile{
	dir = 1
	},
/obj/structure/stone_tile{
	dir = 2
	},
/turf/open/lava/smooth,
/area/tdome/arena)
"aK" = (
/obj/structure/stone_tile/block{
	dir = 1
	},
/obj/structure/stone_tile/surrounding_tile{
	dir = 1;
	pixel_x = -16
	},
/obj/structure/stone_tile/surrounding_tile{
	dir = 2;
	pixel_x = -16
	},
/obj/structure/stone_tile/block{
	dir = 2
	},
/turf/open/indestructible/necropolis/air,
/area/tdome/arena)
"aL" = (
/obj/structure/stone_tile/block{
	dir = 1
	},
/obj/structure/stone_tile/block{
	dir = 2
	},
/turf/open/indestructible/necropolis/air,
/area/tdome/arena)
"aM" = (
/obj/structure/stone_tile/burnt{
	dir = 2
	},
/obj/structure/stone_tile/burnt{
	dir = 1
	},
/turf/open/lava/smooth,
/area/tdome/arena)
"aN" = (
/obj/structure/stone_tile/block{
	dir = 8
	},
/turf/open/indestructible/necropolis/air,
/area/tdome/arena)
"aO" = (
/obj/structure/stone_tile/cracked{
	dir = 8
	},
/obj/structure/stone_tile/cracked{
	dir = 4
	},
/turf/open/lava/smooth,
/area/tdome/arena)
"aP" = (
/obj/structure/stone_tile/block/burnt{
	dir = 1
	},
/turf/open/lava/smooth,
/area/tdome/arena)
"aQ" = (
/obj/structure/stone_tile/surrounding/burnt{
	dir = 1
	},
/turf/open/lava/smooth,
/area/tdome/arena)
"aR" = (
/obj/structure/stone_tile/burnt{
	dir = 4
	},
/turf/open/indestructible/necropolis/air,
/area/tdome/arena)
"aS" = (
/obj/structure/stone_tile/burnt{
	dir = 4
	},
/obj/structure/stone_tile/burnt{
	dir = 2
	},
/turf/open/indestructible/necropolis/air,
/area/tdome/arena)
"aT" = (
/obj/structure/stone_tile/burnt{
	dir = 2
	},
/turf/open/indestructible/necropolis/air,
/area/tdome/arena)
"aU" = (
/obj/structure/stone_tile/block/burnt{
	dir = 4
	},
/turf/open/indestructible/necropolis/air,
/area/tdome/arena)
"aV" = (
/obj/structure/stone_tile/surrounding_tile{
	dir = 2;
	pixel_y = 16
	},
/obj/structure/stone_tile/surrounding_tile{
	dir = 4;
	pixel_y = 16
	},
/obj/structure/stone_tile/block{
	dir = 8
	},
/obj/structure/stone_tile/block{
	dir = 4
	},
/obj/structure/stone_tile/surrounding_tile{
	dir = 1;
	pixel_y = -16
	},
/obj/structure/stone_tile/surrounding_tile{
	dir = 8;
	pixel_y = -16
	},
/turf/open/indestructible/necropolis/air,
/area/tdome/arena)
"aW" = (
/obj/structure/stone_tile/surrounding_tile{
	dir = 2;
	pixel_x = -16
	},
/obj/structure/stone_tile/block{
	dir = 2
	},
/obj/structure/stone_tile/surrounding_tile{
	pixel_x = -16;
	dir = 1
	},
/obj/structure/stone_tile/block{
	dir = 1
	},
/turf/open/indestructible/necropolis/air,
/area/tdome/arena)
"aX" = (
/obj/structure/stone_tile/block/burnt{
	dir = 4
	},
/obj/structure/stone_tile/block/burnt{
	dir = 8
	},
/obj/structure/stone_tile/surrounding_tile/burnt{
	dir = 4;
	pixel_y = 16
	},
/obj/structure/stone_tile/surrounding_tile/burnt{
	dir = 2;
	pixel_y = 16
	},
/obj/structure/stone_tile/surrounding_tile/burnt{
	pixel_y = -16;
	dir = 1
	},
/obj/structure/stone_tile/surrounding_tile/burnt{
	dir = 8;
	pixel_y = -16
	},
/turf/open/indestructible/necropolis/air,
/area/tdome/arena)
"aY" = (
/obj/structure/stone_tile/slab/burnt{
	dir = 1
	},
/turf/open/indestructible/necropolis/air,
/area/tdome/arena)
"aZ" = (
/obj/structure/stone_tile/burnt{
	dir = 8
	},
/turf/open/indestructible/necropolis/air,
/area/tdome/arena)
"ba" = (
/obj/structure/stone_tile/burnt{
	dir = 8
	},
/obj/structure/stone_tile/burnt{
	dir = 1
	},
/turf/open/indestructible/necropolis/air,
/area/tdome/arena)
"bb" = (
/obj/structure/stone_tile/burnt{
	dir = 1
	},
/turf/open/indestructible/necropolis/air,
/area/tdome/arena)
"bc" = (
/obj/structure/stone_tile/surrounding_tile{
	dir = 2
	},
/obj/structure/stone_tile{
	dir = 4
	},
/obj/structure/stone_tile{
	dir = 1
	},
/obj/structure/stone_tile/center{
	pixel_x = 8;
	pixel_y = -8;
	dir = 1
	},
/turf/open/indestructible/necropolis/air,
/area/tdome/arena)
"bd" = (
/obj/structure/stone_tile/block{
	dir = 1
	},
/turf/open/indestructible/necropolis/air,
/area/tdome/arena)
"be" = (
/obj/structure/stone_tile/block{
	dir = 2
	},
/obj/structure/stone_tile/block{
	dir = 1
	},
/turf/open/indestructible/necropolis/air,
/area/tdome/arena)
"bf" = (
/obj/structure/stone_tile/block/burnt{
	dir = 1
	},
/turf/open/indestructible/necropolis/air,
/area/tdome/arena)
"bg" = (
/obj/structure/stone_tile/surrounding_tile/burnt{
	dir = 4
	},
/obj/structure/stone_tile/center/burnt{
	pixel_x = -8;
	pixel_y = -8;
	dir = 1
	},
/obj/structure/stone_tile/burnt{
	dir = 8
	},
/obj/structure/stone_tile/burnt{
	dir = 2
	},
/turf/open/indestructible/necropolis/air,
/area/tdome/arena)
"bh" = (
/obj/structure/stone_tile/block{
	dir = 2
	},
/obj/structure/stone_tile/surrounding_tile{
	dir = 4;
	pixel_x = 16
	},
/obj/structure/stone_tile/surrounding_tile{
	dir = 8;
	pixel_x = 16
	},
/obj/structure/stone_tile/block{
	dir = 1
	},
/turf/open/indestructible/necropolis/air,
/area/tdome/arena)
"bi" = (
/obj/structure/stone_tile{
	dir = 4
	},
/obj/structure/stone_tile{
	dir = 8
	},
/turf/open/lava/smooth,
/area/tdome/arena)
"bj" = (
/obj/structure/stone_tile/block{
	dir = 1
	},
/turf/open/lava/smooth,
/area/tdome/arena)
"bk" = (
/obj/structure/stone_tile{
	dir = 1
	},
/obj/structure/stone_tile/burnt{
	dir = 8
	},
/turf/open/lava/smooth,
/area/tdome/arena)
"bl" = (
/obj/structure/stone_tile/block/burnt{
	dir = 8
	},
/obj/structure/stone_tile/surrounding_tile/burnt{
	dir = 4;
	pixel_y = 16
	},
/obj/structure/stone_tile/surrounding_tile/burnt{
	dir = 8;
	pixel_y = -16
	},
/obj/structure/stone_tile/surrounding_tile{
	dir = 2;
	pixel_y = 16
	},
/obj/structure/stone_tile/block{
	dir = 4
	},
/obj/structure/stone_tile/surrounding_tile{
	dir = 1;
	pixel_y = -16
	},
/turf/open/indestructible/necropolis/air,
/area/tdome/arena)
"bm" = (
/obj/structure/stone_tile{
	dir = 1
	},
/obj/structure/stone_tile{
	dir = 2
	},
/obj/structure/stone_tile{
	dir = 4
	},
/obj/structure/stone_tile{
	dir = 8
	},
/turf/open/indestructible/necropolis/air,
/area/tdome/arena)
"bn" = (
/obj/structure/stone_tile/burnt{
	dir = 8
	},
/obj/structure/stone_tile/burnt{
	dir = 4
	},
/obj/structure/stone_tile/burnt{
	dir = 1
	},
/obj/structure/stone_tile/burnt{
	dir = 2
	},
/turf/open/indestructible/necropolis/air,
/area/tdome/arena)
"bo" = (
/obj/structure/stone_tile{
	dir = 8
	},
/obj/structure/stone_tile{
	dir = 4
	},
/obj/structure/stone_tile{
	dir = 2
	},
/obj/structure/stone_tile{
	dir = 1
	},
/turf/open/indestructible/necropolis/air,
/area/tdome/arena)
"bp" = (
/obj/structure/stone_tile/slab{
	dir = 1
	},
/turf/open/lava/smooth,
/area/tdome/arena)
"bq" = (
/obj/structure/stone_tile/cracked{
	dir = 4
	},
/obj/structure/stone_tile/surrounding_tile/cracked{
	dir = 1
	},
/turf/open/lava/smooth,
/area/tdome/arena)
"br" = (
/obj/structure/stone_tile/cracked{
	dir = 2
	},
/obj/structure/stone_tile/cracked{
	dir = 4
	},
/turf/open/lava/smooth,
/area/tdome/arena)
"bs" = (
/obj/structure/stone_tile{
	dir = 4
	},
/obj/structure/stone_tile{
	dir = 2
	},
/turf/open/lava/smooth,
/area/tdome/arena)
"bt" = (
/obj/structure/stone_tile{
	dir = 2
	},
/obj/structure/stone_tile/surrounding_tile{
	dir = 8
	},
/turf/open/lava/smooth,
/area/tdome/arena)
"bu" = (
/obj/structure/stone_tile/surrounding_tile{
	dir = 8;
	pixel_x = 16
	},
/obj/structure/stone_tile/block{
	dir = 1
	},
/obj/structure/stone_tile/block{
	dir = 2
	},
/obj/structure/stone_tile/surrounding_tile{
	dir = 4;
	pixel_x = 16
	},
/turf/open/indestructible/necropolis/air,
/area/tdome/arena)
"bv" = (
/obj/structure/stone_tile{
	dir = 8
	},
/obj/structure/stone_tile{
	dir = 1
	},
/turf/open/lava/smooth,
/area/tdome/arena)
"bw" = (
/obj/structure/stone_tile/burnt{
	dir = 1
	},
/obj/structure/stone_tile/surrounding_tile/burnt{
	dir = 4
	},
/turf/open/lava/smooth,
/area/tdome/arena)
"bx" = (
/obj/structure/stone_tile/block/burnt{
	dir = 2
	},
/obj/structure/stone_tile/surrounding_tile/burnt{
	dir = 2;
	pixel_x = -16
	},
/obj/structure/stone_tile/block/burnt{
	dir = 1
	},
/obj/structure/stone_tile/surrounding_tile/burnt{
	dir = 1;
	pixel_x = -16
	},
/turf/open/indestructible/necropolis/air,
/area/tdome/arena)
"by" = (
/obj/structure/stone_tile/block/burnt{
	dir = 2
	},
/obj/structure/stone_tile/block/burnt{
	dir = 1
	},
/turf/open/indestructible/necropolis/air,
/area/tdome/arena)
"bz" = (
/obj/structure/stone_tile/surrounding_tile/burnt{
	dir = 4;
	pixel_x = 16
	},
/obj/structure/stone_tile/block/burnt{
	dir = 2
	},
/obj/structure/stone_tile/surrounding_tile/burnt{
	dir = 8;
	pixel_x = 16
	},
/obj/structure/stone_tile/block/burnt{
	dir = 1
	},
/turf/open/indestructible/necropolis/air,
/area/tdome/arena)
"bA" = (
/obj/structure/stone_tile{
	dir = 8
	},
/obj/structure/stone_tile/surrounding_tile{
	dir = 2
	},
/turf/open/lava/smooth,
/area/tdome/arena)

(1,1,1) = {"
bc
aN
aN
ac
ac
ag
ag
aa"}(2,1,1) = {"
bd
az
ao
aW
aE
as
ah
ab"}(3,1,1) = {"
bd
aA
ap
be
aF
as
ai
ab"}(4,1,1) = {"
bd
aB
aq
bh
aH
at
ac
ab"}(5,1,1) = {"
bd
an
ay
bi
aO
au
aj
ab"}(6,1,1) = {"
ac
aV
bj
bA
bq
av
ad
ac"}(7,1,1) = {"
aA
bm
bp
bv
br
aw
ak
ai"}(8,1,1) = {"
ac
bl
bk
bk
aD
aD
al
ac"}(9,1,1) = {"
ba
bn
aI
aG
bs
bp
bo
aC"}(10,1,1) = {"
ac
aX
aP
bw
bt
ax
am
ac"}(11,1,1) = {"
bf
aY
aQ
aM
aJ
ay
an
ae"}(12,1,1) = {"
bf
aZ
aR
bx
aK
az
ao
ae"}(13,1,1) = {"
bf
ba
aS
by
aL
aA
ap
ae"}(14,1,1) = {"
bf
bb
aT
bz
bu
aB
aq
ae"}(15,1,1) = {"
bg
aU
aU
ac
ac
ar
ar
af"}