//MAP CONVERTED BY dmm2tgm.py THIS HEADER COMMENT PREVENTS RECONVERSION, DO NOT REMOVE
"ac" = (
/obj/anomaly/singularity/stationary,
/turf/open/space,
/area/centcom/tdome/arena)
"ad" = (
/obj/effect/turf_decal/loading_area{
	dir = 8
	},
/obj/structure/fans/tiny/invisible,
/turf/open/floor/circuit/red/off,
/area/centcom/tdome/arena)
"ae" = (
/obj/effect/turf_decal/stripes/line{
	dir = 8
	},
/obj/effect/turf_decal/tile/neutral{
	dir = 4
	},
/turf/open/floor/iron/dark,
/area/centcom/tdome/arena)
"ag" = (
/obj/effect/turf_decal/stripes/line,
/obj/structure/fans/tiny/invisible,
/turf/open/floor/circuit/red/off,
/area/centcom/tdome/arena)
"al" = (
/obj/effect/turf_decal/stripes/line{
	dir = 4
	},
/obj/effect/turf_decal/tile/neutral{
	dir = 1
	},
/turf/open/floor/iron/dark,
/area/centcom/tdome/arena)
"am" = (
/obj/effect/turf_decal/loading_area{
	dir = 4
	},
/obj/structure/fans/tiny/invisible,
/turf/open/floor/circuit/red/anim,
/area/centcom/tdome/arena)
"ao" = (
/obj/effect/turf_decal/loading_area{
	dir = 1
	},
/obj/structure/fans/tiny/invisible,
/turf/open/floor/circuit/red/off,
/area/centcom/tdome/arena)
"ap" = (
/obj/effect/turf_decal/box/corners,
/obj/structure/fans/tiny,
/turf/open/floor/circuit/red/off,
/area/centcom/tdome/arena)
"aq" = (
/obj/effect/turf_decal/stripes/line{
	dir = 8
	},
/turf/open/floor/circuit/red/off,
/area/centcom/tdome/arena)
"ar" = (
/obj/effect/turf_decal/stripes/line{
	dir = 4
	},
/obj/structure/fans/tiny/invisible,
/turf/open/floor/circuit/red/off,
/area/centcom/tdome/arena)
"as" = (
/obj/structure/fans/tiny/invisible,
/turf/open/floor/circuit/red/anim,
/area/centcom/tdome/arena)
"at" = (
/turf/open/floor/circuit/red/anim,
/area/centcom/tdome/arena)
"au" = (
/obj/effect/turf_decal/stripes/line{
	dir = 8
	},
/obj/structure/fans/tiny/invisible,
/turf/open/floor/circuit/red/off,
/area/centcom/tdome/arena)
"av" = (
/obj/effect/turf_decal/stripes/line{
	dir = 4
	},
/turf/open/floor/circuit/red/off,
/area/centcom/tdome/arena)
"aw" = (
/obj/effect/turf_decal/box/corners{
	dir = 8
	},
/obj/structure/fans/tiny,
/turf/open/floor/circuit/red/anim,
/area/centcom/tdome/arena)
"ax" = (
/obj/effect/turf_decal/loading_area{
	dir = 1
	},
/obj/structure/fans/tiny/invisible,
/turf/open/floor/circuit/red/anim,
/area/centcom/tdome/arena)
"aM" = (
/obj/effect/turf_decal/box/corners{
	dir = 1
	},
/obj/structure/fans/tiny,
/turf/open/floor/circuit/red/off,
/area/centcom/tdome/arena)
"aN" = (
/obj/effect/turf_decal/box/corners{
	dir = 4
	},
/obj/structure/fans/tiny,
/turf/open/floor/circuit/red/off,
/area/centcom/tdome/arena)
"aR" = (
/obj/effect/turf_decal/box/corners{
	dir = 8
	},
/obj/structure/fans/tiny,
/turf/open/floor/circuit/red/off,
/area/centcom/tdome/arena)
"bc" = (
/obj/effect/turf_decal/loading_area,
/obj/structure/fans/tiny/invisible,
/turf/open/floor/circuit/red/anim,
/area/centcom/tdome/arena)
"bd" = (
/obj/effect/turf_decal/box/corners{
	dir = 4
	},
/obj/structure/fans/tiny,
/turf/open/floor/circuit/red/anim,
/area/centcom/tdome/arena)
"be" = (
/obj/effect/turf_decal/loading_area,
/obj/structure/fans/tiny/invisible,
/turf/open/floor/circuit/red/off,
/area/centcom/tdome/arena)
"bf" = (
/obj/effect/turf_decal/loading_area{
	dir = 8
	},
/obj/structure/fans/tiny/invisible,
/turf/open/floor/circuit/red/anim,
/area/centcom/tdome/arena)
"bg" = (
/obj/effect/turf_decal/stripes/line{
	dir = 8
	},
/obj/effect/turf_decal/tile/neutral,
/turf/open/floor/iron/dark,
/area/centcom/tdome/arena)
"bi" = (
/obj/effect/turf_decal/stripes/line{
	dir = 1
	},
/obj/structure/fans/tiny/invisible,
/turf/open/floor/circuit/red/off,
/area/centcom/tdome/arena)
"bn" = (
/obj/effect/turf_decal/stripes/line{
	dir = 4
	},
/obj/effect/turf_decal/tile/neutral{
	dir = 8
	},
/turf/open/floor/iron/dark,
/area/centcom/tdome/arena)
"bo" = (
/obj/effect/turf_decal/loading_area{
	dir = 4
	},
/obj/structure/fans/tiny/invisible,
/turf/open/floor/circuit/red/off,
/area/centcom/tdome/arena)
"bp" = (
/obj/effect/turf_decal/trimline/red/filled/line{
	dir = 6
	},
/obj/structure/fans/tiny/invisible,
/obj/effect/turf_decal/tile/neutral{
	dir = 1
	},
/turf/open/floor/iron/dark,
/area/centcom/tdome/arena)
"cq" = (
/obj/effect/turf_decal/stripes/line{
	dir = 1
	},
/obj/effect/turf_decal/tile/neutral/half/contrasted{
	dir = 8
	},
/turf/open/floor/iron/dark,
/area/centcom/tdome/arena)
"fZ" = (
/obj/effect/turf_decal/stripes/corner{
	dir = 1
	},
/obj/structure/fans/tiny/invisible,
/obj/effect/turf_decal/tile/neutral,
/turf/open/floor/iron/dark,
/area/centcom/tdome/arena)
"gf" = (
/obj/effect/turf_decal/tile/neutral/fourcorners/contrasted,
/turf/open/floor/iron/dark,
/area/centcom/tdome/arena)
"jM" = (
/obj/effect/turf_decal/stripes/corner{
	dir = 4
	},
/obj/structure/fans/tiny/invisible,
/obj/effect/turf_decal/tile/neutral{
	dir = 8
	},
/turf/open/floor/iron/dark,
/area/centcom/tdome/arena)
"jX" = (
/obj/effect/turf_decal/trimline/red/filled/line{
	dir = 5
	},
/obj/effect/turf_decal/stripes/line{
	dir = 4
	},
/obj/structure/fans/tiny/invisible,
/obj/effect/turf_decal/tile/neutral{
	dir = 8
	},
/turf/open/floor/iron/dark,
/area/centcom/tdome/arena)
"lC" = (
/obj/effect/turf_decal/trimline/red/filled/line{
	dir = 1
	},
/obj/structure/fans/tiny/invisible,
/obj/effect/turf_decal/tile/neutral/half/contrasted{
	dir = 8
	},
/turf/open/floor/iron/dark,
/area/centcom/tdome/arena)
"mh" = (
/obj/effect/turf_decal/trimline/red/filled/line{
	dir = 5
	},
/obj/structure/fans/tiny/invisible,
/obj/effect/turf_decal/tile/neutral{
	dir = 8
	},
/turf/open/floor/iron/dark,
/area/centcom/tdome/arena)
"mw" = (
/obj/effect/turf_decal/trimline/red/filled/line,
/obj/effect/turf_decal/stripes/corner{
	dir = 8
	},
/obj/effect/turf_decal/tile/neutral/half/contrasted{
	dir = 4
	},
/turf/open/floor/iron/dark,
/area/centcom/tdome/arena)
"nk" = (
/obj/effect/turf_decal/trimline/red/filled/line{
	dir = 9
	},
/obj/effect/turf_decal/stripes/line{
	dir = 8
	},
/obj/structure/fans/tiny/invisible,
/obj/effect/turf_decal/tile/neutral,
/turf/open/floor/iron/dark,
/area/centcom/tdome/arena)
"nv" = (
/obj/effect/turf_decal/trimline/red/filled/line{
	dir = 1
	},
/obj/effect/turf_decal/stripes/line{
	dir = 1
	},
/obj/effect/turf_decal/tile/neutral{
	dir = 8
	},
/turf/open/floor/iron/dark,
/area/centcom/tdome/arena)
"rJ" = (
/obj/effect/turf_decal/trimline/red/filled/line,
/obj/effect/turf_decal/stripes/line,
/obj/effect/turf_decal/tile/neutral{
	dir = 4
	},
/turf/open/floor/iron/dark,
/area/centcom/tdome/arena)
"rV" = (
/obj/effect/turf_decal/trimline/red/filled/line,
/obj/effect/turf_decal/stripes/line,
/obj/effect/turf_decal/tile/neutral/half/contrasted{
	dir = 4
	},
/turf/open/floor/iron/dark,
/area/centcom/tdome/arena)
"tP" = (
/obj/effect/turf_decal/tile/neutral/half/contrasted,
/turf/open/floor/iron/dark,
/area/centcom/tdome/arena)
"uR" = (
/obj/effect/turf_decal/trimline/red/filled/line,
/obj/structure/fans/tiny/invisible,
/obj/effect/turf_decal/tile/neutral/half/contrasted{
	dir = 4
	},
/turf/open/floor/iron/dark,
/area/centcom/tdome/arena)
"uX" = (
/obj/effect/turf_decal/trimline/red/filled/line{
	dir = 9
	},
/obj/structure/fans/tiny/invisible,
/obj/effect/turf_decal/tile/neutral,
/turf/open/floor/iron/dark,
/area/centcom/tdome/arena)
"wk" = (
/obj/effect/turf_decal/trimline/red/filled/line{
	dir = 4
	},
/obj/effect/turf_decal/tile/neutral/half/contrasted{
	dir = 1
	},
/turf/open/floor/iron/dark,
/area/centcom/tdome/arena)
"wp" = (
/obj/effect/turf_decal/trimline/red/filled/line{
	dir = 10
	},
/obj/structure/fans/tiny/invisible,
/obj/effect/turf_decal/tile/neutral{
	dir = 4
	},
/turf/open/floor/iron/dark,
/area/centcom/tdome/arena)
"xP" = (
/obj/effect/turf_decal/stripes/line,
/obj/structure/fans/tiny/invisible,
/obj/effect/turf_decal/tile/neutral{
	dir = 1
	},
/turf/open/floor/iron/dark,
/area/centcom/tdome/arena)
"DW" = (
/obj/effect/turf_decal/stripes/line,
/obj/structure/fans/tiny/invisible,
/obj/effect/turf_decal/tile/neutral{
	dir = 4
	},
/turf/open/floor/iron/dark,
/area/centcom/tdome/arena)
"FB" = (
/obj/effect/turf_decal/trimline/red/filled/line{
	dir = 1
	},
/obj/effect/turf_decal/stripes/line{
	dir = 1
	},
/obj/effect/turf_decal/tile/neutral,
/turf/open/floor/iron/dark,
/area/centcom/tdome/arena)
"GA" = (
/obj/effect/turf_decal/stripes/line,
/obj/effect/turf_decal/tile/neutral/half/contrasted{
	dir = 4
	},
/turf/open/floor/iron/dark,
/area/centcom/tdome/arena)
"GQ" = (
/obj/effect/turf_decal/trimline/red/filled/line{
	dir = 1
	},
/obj/effect/turf_decal/stripes/corner{
	dir = 4
	},
/obj/effect/turf_decal/tile/neutral/half/contrasted{
	dir = 8
	},
/turf/open/floor/iron/dark,
/area/centcom/tdome/arena)
"Hg" = (
/obj/effect/turf_decal/trimline/red/filled/line{
	dir = 8
	},
/obj/effect/turf_decal/tile/neutral/half/contrasted,
/turf/open/floor/iron/dark,
/area/centcom/tdome/arena)
"Is" = (
/obj/effect/turf_decal/stripes/line{
	dir = 1
	},
/obj/structure/fans/tiny/invisible,
/obj/effect/turf_decal/tile/neutral,
/turf/open/floor/iron/dark,
/area/centcom/tdome/arena)
"Km" = (
/obj/effect/turf_decal/trimline/red/filled/line{
	dir = 4
	},
/obj/effect/turf_decal/stripes/line{
	dir = 4
	},
/obj/effect/turf_decal/tile/neutral/half/contrasted{
	dir = 1
	},
/turf/open/floor/iron/dark,
/area/centcom/tdome/arena)
"Mx" = (
/obj/effect/turf_decal/trimline/red/filled/line{
	dir = 1
	},
/obj/effect/turf_decal/stripes/line{
	dir = 1
	},
/obj/effect/turf_decal/tile/neutral/half/contrasted{
	dir = 8
	},
/turf/open/floor/iron/dark,
/area/centcom/tdome/arena)
"MP" = (
/obj/effect/turf_decal/stripes/corner{
	dir = 8
	},
/obj/structure/fans/tiny/invisible,
/obj/effect/turf_decal/tile/neutral{
	dir = 4
	},
/turf/open/floor/iron/dark,
/area/centcom/tdome/arena)
"Nu" = (
/obj/effect/turf_decal/trimline/red/filled/line{
	dir = 6
	},
/obj/effect/turf_decal/stripes/line{
	dir = 4
	},
/obj/structure/fans/tiny/invisible,
/obj/effect/turf_decal/tile/neutral{
	dir = 1
	},
/turf/open/floor/iron/dark,
/area/centcom/tdome/arena)
"OH" = (
/obj/effect/turf_decal/trimline/red/filled/line{
	dir = 1
	},
/obj/effect/turf_decal/stripes/corner{
	dir = 1
	},
/obj/effect/turf_decal/tile/neutral/half/contrasted{
	dir = 8
	},
/turf/open/floor/iron/dark,
/area/centcom/tdome/arena)
"PW" = (
/obj/effect/turf_decal/stripes/corner,
/obj/structure/fans/tiny/invisible,
/obj/effect/turf_decal/tile/neutral{
	dir = 1
	},
/turf/open/floor/iron/dark,
/area/centcom/tdome/arena)
"QQ" = (
/obj/effect/turf_decal/trimline/red/filled/line,
/obj/effect/turf_decal/stripes/corner,
/obj/effect/turf_decal/tile/neutral/half/contrasted{
	dir = 4
	},
/turf/open/floor/iron/dark,
/area/centcom/tdome/arena)
"RK" = (
/obj/effect/turf_decal/trimline/red/filled/line,
/obj/effect/turf_decal/stripes/line,
/obj/effect/turf_decal/tile/neutral{
	dir = 1
	},
/turf/open/floor/iron/dark,
/area/centcom/tdome/arena)
"SK" = (
/obj/effect/turf_decal/trimline/red/filled/line{
	dir = 8
	},
/obj/effect/turf_decal/stripes/line{
	dir = 8
	},
/obj/effect/turf_decal/tile/neutral/half/contrasted,
/turf/open/floor/iron/dark,
/area/centcom/tdome/arena)
"Ud" = (
/obj/effect/turf_decal/stripes/line{
	dir = 1
	},
/obj/structure/fans/tiny/invisible,
/obj/effect/turf_decal/tile/neutral{
	dir = 8
	},
/turf/open/floor/iron/dark,
/area/centcom/tdome/arena)
"Ws" = (
/obj/effect/turf_decal/tile/neutral/half/contrasted{
	dir = 1
	},
/turf/open/floor/iron/dark,
/area/centcom/tdome/arena)
"Xi" = (
/obj/effect/turf_decal/trimline/red/filled/line{
	dir = 10
	},
/obj/effect/turf_decal/stripes/line{
	dir = 8
	},
/obj/structure/fans/tiny/invisible,
/obj/effect/turf_decal/tile/neutral{
	dir = 4
	},
/turf/open/floor/iron/dark,
/area/centcom/tdome/arena)

(1,1,1) = {"
ac
ao
FB
tP
tP
rJ
bc
ac
"}
(2,1,1) = {"
ad
ap
Mx
gf
gf
rV
bd
bf
"}
(3,1,1) = {"
ae
aq
OH
gf
gf
mw
aq
bg
"}
(4,1,1) = {"
PW
ar
jX
Km
Km
Nu
ar
jM
"}
(5,1,1) = {"
ag
ac
as
at
at
as
ac
bi
"}
(6,1,1) = {"
DW
as
uX
Hg
Hg
wp
as
Is
"}
(7,1,1) = {"
GA
at
lC
aM
aR
uR
at
cq
"}
(8,1,1) = {"
GA
at
lC
ac
ac
uR
at
cq
"}
(9,1,1) = {"
GA
at
lC
aN
ap
uR
at
cq
"}
(10,1,1) = {"
xP
as
mh
wk
wk
bp
as
Ud
"}
(11,1,1) = {"
ag
ac
as
at
at
as
ac
bi
"}
(12,1,1) = {"
MP
au
nk
SK
SK
Xi
au
fZ
"}
(13,1,1) = {"
al
av
GQ
gf
gf
QQ
av
bn
"}
(14,1,1) = {"
am
aw
Mx
gf
gf
rV
aM
bo
"}
(15,1,1) = {"
ac
ax
nv
Ws
Ws
RK
be
ac
"}
