//MAP CONVERTED BY dmm2tgm.py THIS HEADER COMMENT PREVENTS RECONVERSION, DO NOT REMOVE
"a" = (
/obj/effect/turf_decal/trimline/neutral/filled/corner,
/turf/open/floor/iron/dark,
/area/tdome/arena)
"b" = (
/obj/structure/chair/fancy/sofa/old/corner/concave{
	color = "#c45c57";
	dir = 4
	},
/turf/open/floor/wood,
/area/tdome/arena)
"c" = (
/obj/structure/chair/fancy/sofa/old{
	color = "#c45c57"
	},
/turf/open/floor/wood,
/area/tdome/arena)
"d" = (
/obj/structure/chair/fancy/sofa/old/left{
	color = "#c45c57"
	},
/turf/open/floor/wood,
/area/tdome/arena)
"e" = (
/obj/effect/turf_decal/trimline/neutral/filled/line,
/turf/open/floor/iron/dark,
/area/tdome/arena)
"f" = (
/obj/structure/chair/fancy/sofa/old/right{
	color = "#c45c57"
	},
/turf/open/floor/wood,
/area/tdome/arena)
"g" = (
/obj/structure/chair/fancy/sofa/old/left{
	color = "#c45c57"
	},
/turf/open/floor/wood{
	broken = 1
	},
/area/tdome/arena)
"h" = (
/obj/structure/chair/fancy/sofa/old/corner/concave{
	color = "#c45c57"
	},
/turf/open/floor/wood,
/area/tdome/arena)
"i" = (
/obj/effect/turf_decal/trimline/neutral/filled/corner{
	dir = 8
	},
/turf/open/floor/iron/dark,
/area/tdome/arena)
"j" = (
/obj/effect/turf_decal/trimline/neutral/filled/line{
	dir = 6
	},
/turf/open/floor/iron/dark,
/area/tdome/arena)
"k" = (
/obj/structure/chair/fancy/sofa/old/right{
	color = "#c45c57";
	dir = 4
	},
/turf/open/floor/wood{
	broken = 1
	},
/area/tdome/arena)
"l" = (
/obj/effect/turf_decal/trimline/neutral/filled/corner,
/obj/effect/turf_decal/trimline/neutral/filled/corner{
	dir = 8
	},
/turf/open/floor/iron/dark,
/area/tdome/arena)
"m" = (
/turf/open/floor/iron/stairs,
/area/tdome/arena)
"o" = (
/obj/effect/turf_decal/trimline/neutral/filled/line{
	dir = 10
	},
/turf/open/floor/iron/dark,
/area/tdome/arena)
"p" = (
/obj/structure/railing{
	density = 0;
	dir = 9
	},
/obj/effect/turf_decal/trimline/neutral/filled/line{
	dir = 9
	},
/obj/effect/turf_decal/tile/neutral,
/turf/open/floor/iron/dark,
/area/tdome/arena)
"q" = (
/obj/structure/railing{
	density = 0;
	dir = 1
	},
/obj/effect/turf_decal/trimline/neutral/filled/line{
	dir = 1
	},
/obj/effect/turf_decal/tile/neutral,
/turf/open/floor/iron/dark,
/area/tdome/arena)
"r" = (
/obj/effect/turf_decal/trimline/neutral/filled/line{
	dir = 1
	},
/obj/effect/turf_decal/tile/neutral,
/turf/open/floor/iron/dark,
/area/tdome/arena)
"s" = (
/obj/structure/railing{
	density = 0;
	dir = 5
	},
/obj/effect/turf_decal/trimline/neutral/filled/line{
	dir = 5
	},
/turf/open/floor/iron/dark,
/area/tdome/arena)
"t" = (
/obj/effect/turf_decal/trimline/neutral/filled/line{
	dir = 4
	},
/turf/open/floor/iron/dark,
/area/tdome/arena)
"u" = (
/obj/structure/railing/corner{
	dir = 1
	},
/obj/effect/turf_decal/trimline/neutral/filled/corner{
	dir = 1
	},
/obj/effect/turf_decal/tile/neutral,
/turf/open/floor/iron/dark,
/area/tdome/arena)
"x" = (
/obj/structure/curtain{
	color = "#c45c57"
	},
/turf/open/floor/wood,
/area/tdome/arena)
"y" = (
/turf/open/floor/wood,
/area/tdome/arena)
"A" = (
/turf/open/floor/carpet/red,
/area/tdome/arena)
"D" = (
/turf/open/floor/wood{
	broken = 1
	},
/area/tdome/arena)
"E" = (
/obj/effect/turf_decal/trimline/neutral/filled/line{
	dir = 8
	},
/obj/effect/turf_decal/trimline/neutral/filled/line{
	dir = 4
	},
/turf/open/floor/iron/dark,
/area/tdome/arena)
"F" = (
/obj/effect/turf_decal/trimline/neutral/filled/line{
	dir = 8
	},
/turf/open/floor/iron/dark,
/area/tdome/arena)
"T" = (
/obj/structure/table/wood/fancy/red,
/obj/item/food/popcorn{
	pixel_y = 5
	},
/turf/open/floor/wood,
/area/tdome/arena)
"U" = (
/obj/structure/chair/fancy/sofa/old/left{
	color = "#c45c57";
	dir = 8
	},
/turf/open/floor/wood{
	broken = 1
	},
/area/tdome/arena)
"V" = (
/obj/structure/railing/corner{
	dir = 4
	},
/obj/effect/turf_decal/trimline/neutral/filled/corner{
	dir = 4
	},
/obj/effect/turf_decal/tile/neutral/opposingcorners,
/turf/open/floor/iron/dark,
/area/tdome/arena)
"X" = (
/obj/effect/turf_decal/tile/neutral/opposingcorners,
/turf/open/floor/iron/dark,
/area/tdome/arena)

(1,1,1) = {"
a
t
j
m
r
x
y
y
"}
(2,1,1) = {"
e
b
k
T
q
x
D
y
"}
(3,1,1) = {"
e
c
T
T
q
x
A
A
"}
(4,1,1) = {"
e
c
T
p
u
y
A
A
"}
(5,1,1) = {"
e
d
T
q
X
y
A
A
"}
(6,1,1) = {"
l
E
m
r
X
y
A
A
"}
(7,1,1) = {"
e
f
T
q
X
y
A
A
"}
(8,1,1) = {"
e
c
T
q
X
y
A
A
"}
(9,1,1) = {"
e
g
T
q
X
D
A
A
"}
(10,1,1) = {"
l
E
m
r
X
y
A
A
"}
(11,1,1) = {"
e
f
T
q
X
y
A
A
"}
(12,1,1) = {"
e
c
T
s
V
y
A
A
"}
(13,1,1) = {"
e
c
T
T
q
x
A
A
"}
(14,1,1) = {"
e
h
U
T
q
x
y
D
"}
(15,1,1) = {"
i
F
o
m
r
x
D
y
"}
