//MAP CONVERTED BY dmm2tgm.py THIS HEADER COMMENT PREVENTS RECONVERSION, DO NOT REMOVE
"a" = (
/obj/machinery/atmospherics/pipe/simple/purple/visible{
	dir = 4
	},
/turf/closed/wall/mineral/plastitanium/nodiagonal,
/area/space)
"c" = (
/obj/machinery/atmospherics/components/unary/shuttle/heater{
	dir = 8
	},
/obj/structure/window/reinforced/survival_pod{
	dir = 4
	},
/turf/open/floor/plating/broken,
/area/space)
"d" = (
/obj/machinery/atmospherics/components/unary/plasma_refiner{
	dir = 4
	},
/turf/open/floor/plating/broken,
/area/space)
"e" = (
/obj/machinery/atmospherics/pipe/simple/supply/hidden/layer2,
/obj/machinery/atmospherics/pipe/simple/scrubbers/hidden/layer4,
/obj/structure/cable/yellow{
	icon_state = "1-2"
	},
/obj/effect/decal/cleanable/dirt,
/turf/open/floor/mineral/plastitanium/red{
	initial_gas_mix = "o2=14;n2=5;co2=13;TEMP=300"
	},
/area/space)
"f" = (
/obj/machinery/atmospherics/components/unary/vent_pump/on/layer2{
	dir = 8
	},
/obj/effect/decal/cleanable/dirt,
/turf/open/floor/mineral/plastitanium/red{
	initial_gas_mix = "o2=14;n2=5;co2=13;TEMP=300"
	},
/area/space)
"g" = (
/obj/machinery/atmospherics/pipe/simple/supply/hidden/layer2{
	dir = 4
	},
/obj/machinery/atmospherics/pipe/simple/scrubbers/hidden/layer4{
	dir = 4
	},
/obj/structure/cable/yellow{
	icon_state = "4-8"
	},
/obj/effect/decal/cleanable/dirt,
/turf/open/floor/mineral/plastitanium/red{
	initial_gas_mix = "o2=14;n2=5;co2=13;TEMP=300"
	},
/area/space)
"i" = (
/obj/machinery/atmospherics/components/unary/vent_scrubber/on/layer4{
	dir = 8
	},
/obj/structure/cable/yellow{
	icon_state = "4-8"
	},
/obj/effect/decal/cleanable/dirt,
/turf/open/floor/mineral/plastitanium/red{
	initial_gas_mix = "o2=14;n2=5;co2=13;TEMP=300"
	},
/area/space)
"j" = (
/turf/closed/wall/mineral/plastitanium/nodiagonal,
/area/space)
"l" = (
/obj/machinery/atmospherics/components/unary/vent_scrubber/on/layer4,
/turf/open/floor/mineral/plastitanium/red{
	initial_gas_mix = "o2=14;n2=5;co2=13;TEMP=300"
	},
/area/space)
"m" = (
/obj/effect/decal/cleanable/dirt,
/turf/open/floor/mineral/plastitanium/red{
	initial_gas_mix = "o2=14;n2=5;co2=13;TEMP=300"
	},
/area/space)
"n" = (
/obj/machinery/door/airlock/hatch{
	req_access_txt = "150"
	},
/obj/machinery/atmospherics/pipe/simple/supply/hidden/layer2{
	dir = 4
	},
/obj/machinery/atmospherics/pipe/simple/scrubbers/hidden/layer4{
	dir = 4
	},
/turf/open/floor/mineral/plastitanium/red{
	initial_gas_mix = "o2=14;n2=5;co2=13;TEMP=300"
	},
/area/space)
"r" = (
/obj/machinery/door/airlock/hatch{
	req_access_txt = "150"
	},
/turf/open/floor/plating/broken,
/area/space)
"s" = (
/obj/machinery/atmospherics/components/unary/portables_connector/visible{
	dir = 4
	},
/turf/open/floor/plating/broken,
/area/space)
"u" = (
/obj/machinery/computer/shuttle_flight{
	dir = 4
	},
/turf/open/floor/mineral/plastitanium/red{
	initial_gas_mix = "o2=14;n2=5;co2=13;TEMP=300"
	},
/area/space)
"v" = (
/obj/machinery/atmospherics/pipe/manifold4w/purple/visible,
/obj/effect/decal/cleanable/dirt,
/turf/open/floor/plating/broken,
/area/space)
"w" = (
/turf/template_noop,
/area/template_noop)
"x" = (
/obj/machinery/door/airlock/hatch{
	req_access_txt = "150"
	},
/obj/docking_port/mobile{
	dheight = 7;
	width = 8;
	dwidth = 8;
	name = "Syndicate Swarmer Transport";
	id = "swarmersyndicate"
	},
/obj/machinery/atmospherics/pipe/simple/supply/hidden/layer2,
/obj/machinery/atmospherics/pipe/simple/scrubbers/hidden/layer4,
/obj/structure/cable/yellow{
	icon_state = "1-2"
	},
/turf/open/floor/plating/broken,
/area/space)
"y" = (
/obj/machinery/shuttle/engine/plasma{
	dir = 8
	},
/turf/open/floor/plating/broken,
/area/space)
"z" = (
/obj/machinery/atmospherics/components/unary/shuttle/heater{
	dir = 8
	},
/turf/open/floor/plating/broken,
/area/space)
"A" = (
/obj/machinery/atmospherics/components/unary/vent_pump/on/layer2{
	dir = 1
	},
/obj/effect/decal/cleanable/dirt,
/turf/open/floor/mineral/plastitanium/red{
	initial_gas_mix = "o2=14;n2=5;co2=13;TEMP=300"
	},
/area/space)
"B" = (
/obj/effect/spawner/structure/window/plastitanium,
/turf/open/floor/plating/broken,
/area/space)
"C" = (
/obj/machinery/atmospherics/pipe/manifold/purple/visible{
	dir = 8
	},
/obj/effect/decal/cleanable/dirt,
/turf/open/floor/plating/broken,
/area/space)
"D" = (
/obj/machinery/atmospherics/pipe/simple/scrubbers/hidden/layer4{
	dir = 4
	},
/obj/structure/cable/yellow{
	icon_state = "4-8"
	},
/turf/open/floor/mineral/plastitanium/red{
	initial_gas_mix = "o2=14;n2=5;co2=13;TEMP=300"
	},
/area/space)
"E" = (
/obj/machinery/atmospherics/pipe/manifold/scrubbers/hidden/layer4{
	dir = 4
	},
/obj/machinery/atmospherics/pipe/simple/supply/hidden/layer2{
	dir = 10
	},
/obj/structure/cable/yellow{
	icon_state = "1-2"
	},
/turf/open/floor/mineral/plastitanium/red{
	initial_gas_mix = "o2=14;n2=5;co2=13;TEMP=300"
	},
/area/space)
"F" = (
/obj/machinery/atmospherics/pipe/simple/supply/hidden/layer2{
	dir = 6
	},
/obj/machinery/atmospherics/pipe/simple/scrubbers/hidden/layer4{
	dir = 5
	},
/obj/effect/decal/cleanable/dirt,
/turf/open/floor/mineral/plastitanium/red{
	initial_gas_mix = "o2=14;n2=5;co2=13;TEMP=300"
	},
/area/space)
"G" = (
/obj/machinery/atmospherics/pipe/simple/scrubbers/hidden/layer4{
	dir = 6
	},
/obj/structure/cable/yellow{
	icon_state = "2-4"
	},
/obj/effect/decal/cleanable/dirt,
/turf/open/floor/mineral/plastitanium/red{
	initial_gas_mix = "o2=14;n2=5;co2=13;TEMP=300"
	},
/area/space)
"H" = (
/obj/machinery/door/window/checkpoint{
	dir = 8
	},
/turf/open/floor/mineral/plastitanium/red{
	initial_gas_mix = "o2=14;n2=5;co2=13;TEMP=300"
	},
/area/space)
"I" = (
/mob/living/simple_animal/hostile/megafauna/swarmer_swarm_beacon/inactivate,
/turf/open/floor/mineral/plastitanium/red{
	initial_gas_mix = "o2=14;n2=5;co2=13;TEMP=300"
	},
/area/space)
"L" = (
/obj/machinery/atmospherics/pipe/simple/purple/visible{
	dir = 6
	},
/turf/open/floor/plating/broken,
/area/space)
"M" = (
/obj/machinery/atmospherics/pipe/simple/scrubbers/hidden/layer4{
	dir = 4
	},
/obj/structure/cable/yellow{
	icon_state = "4-8"
	},
/obj/effect/decal/cleanable/dirt,
/turf/open/floor/mineral/plastitanium/red{
	initial_gas_mix = "o2=14;n2=5;co2=13;TEMP=300"
	},
/area/space)
"N" = (
/obj/machinery/atmospherics/pipe/simple/scrubbers/hidden/layer4,
/obj/structure/cable/yellow{
	icon_state = "1-2"
	},
/turf/open/floor/mineral/plastitanium/red{
	initial_gas_mix = "o2=14;n2=5;co2=13;TEMP=300"
	},
/area/space)
"O" = (
/obj/structure/table/reinforced,
/turf/open/floor/mineral/plastitanium/red{
	initial_gas_mix = "o2=14;n2=5;co2=13;TEMP=300"
	},
/area/space)
"P" = (
/obj/machinery/atmospherics/pipe/simple/scrubbers/hidden/layer4{
	dir = 10
	},
/obj/machinery/atmospherics/pipe/manifold/supply/hidden/layer2{
	dir = 1
	},
/obj/structure/cable/yellow{
	icon_state = "2-8"
	},
/obj/effect/decal/cleanable/dirt,
/turf/open/floor/mineral/plastitanium/red{
	initial_gas_mix = "o2=14;n2=5;co2=13;TEMP=300"
	},
/area/space)
"Q" = (
/obj/machinery/power/port_gen/pacman,
/obj/structure/cable/yellow,
/turf/open/floor/plating/broken,
/area/space)
"R" = (
/obj/structure/chair/fancy/shuttle{
	dir = 8
	},
/obj/effect/decal/cleanable/dirt,
/turf/open/floor/mineral/plastitanium/red{
	initial_gas_mix = "o2=14;n2=5;co2=13;TEMP=300"
	},
/area/space)
"S" = (
/turf/open/floor/mineral/plastitanium/red{
	initial_gas_mix = "o2=14;n2=5;co2=13;TEMP=300"
	},
/area/space)
"T" = (
/obj/machinery/atmospherics/pipe/simple/purple/visible{
	dir = 4
	},
/obj/machinery/atmospherics/components/unary/shuttle/heater{
	dir = 8
	},
/turf/open/floor/plating/broken,
/area/space)
"U" = (
/turf/closed/wall/mineral/plastitanium,
/area/space)
"V" = (
/obj/machinery/power/apc/syndicate{
	pixel_y = 25
	},
/obj/structure/cable/yellow{
	icon_state = "0-2"
	},
/obj/structure/cable/yellow{
	icon_state = "2-8"
	},
/obj/effect/decal/cleanable/dirt,
/turf/open/floor/mineral/plastitanium/red{
	initial_gas_mix = "o2=14;n2=5;co2=13;TEMP=300"
	},
/area/space)
"W" = (
/obj/machinery/atmospherics/pipe/simple/purple/visible{
	dir = 5
	},
/obj/effect/decal/cleanable/dirt,
/turf/open/floor/plating/broken,
/area/space)
"Z" = (
/obj/machinery/atmospherics/pipe/simple/supply/hidden/layer2{
	dir = 5
	},
/obj/machinery/atmospherics/pipe/simple/scrubbers/hidden/layer4{
	dir = 5
	},
/obj/structure/cable/yellow{
	icon_state = "1-4"
	},
/obj/effect/decal/cleanable/dirt,
/turf/open/floor/mineral/plastitanium/red{
	initial_gas_mix = "o2=14;n2=5;co2=13;TEMP=300"
	},
/area/space)

(1,1,1) = {"
w
U
U
B
U
U
w
"}
(2,1,1) = {"
w
U
O
u
O
U
w
"}
(3,1,1) = {"
w
U
S
R
m
U
w
"}
(4,1,1) = {"
w
U
l
F
A
U
w
"}
(5,1,1) = {"
U
U
U
n
U
U
U
"}
(6,1,1) = {"
U
G
N
E
e
Z
U
"}
(7,1,1) = {"
U
D
U
H
U
g
U
"}
(8,1,1) = {"
r
M
B
I
B
P
x
"}
(9,1,1) = {"
U
i
U
U
U
f
U
"}
(10,1,1) = {"
U
V
Q
d
s
S
U
"}
(11,1,1) = {"
j
L
C
v
v
W
j
"}
(12,1,1) = {"
j
a
c
c
c
a
j
"}
(13,1,1) = {"
j
T
y
y
y
z
j
"}
(14,1,1) = {"
j
y
w
w
w
y
j
"}
