//MAP CONVERTED BY dmm2tgm.py THIS HEADER COMMENT PREVENTS RECONVERSION, DO NOT REMOVE
"cy" = (
/obj/structure/table,
/obj/machinery/microwave{
	pixel_y = 5
	},
/obj/effect/turf_decal/tile/neutral/fourcorners/contrasted,
/turf/open/floor/iron/dark/airless,
/area/shuttle/caravan/freighter1)
"de" = (
/obj/effect/decal/cleanable/dirt,
/obj/machinery/atmospherics/pipe/manifold/supply/hidden,
/obj/effect/turf_decal/tile/blue/half/contrasted,
/turf/open/floor/iron{
	initial_gas_mix = "TEMP=2.7"
	},
/area/shuttle/caravan/freighter1)
"dE" = (
/obj/machinery/door/airlock{
	name = "Crew Quarters"
	},
/obj/machinery/atmospherics/pipe/simple/supply/hidden{
	dir = 4
	},
/obj/effect/decal/cleanable/dirt,
/turf/open/floor/iron/airless,
/area/shuttle/caravan/freighter1)
"dP" = (
/obj/machinery/airalarm/all_access{
	pixel_y = 24
	},
/obj/machinery/atmospherics/pipe/manifold/supply/hidden{
	dir = 1
	},
/turf/open/floor/iron/airless,
/area/shuttle/caravan/freighter1)
"ec" = (
/obj/structure/cable/yellow{
	icon_state = "2-8"
	},
/obj/effect/decal/cleanable/dirt,
/obj/machinery/atmospherics/pipe/simple/supply/hidden,
/turf/open/floor/plating/airless,
/area/shuttle/caravan/freighter1)
"eP" = (
/obj/machinery/door/poddoor{
	id = "caravantrade1_cargo";
	name = "Cargo Blast Door"
	},
/obj/effect/decal/cleanable/dirt,
/turf/open/floor/plating/airless,
/area/shuttle/caravan/freighter1)
"fk" = (
/obj/effect/decal/cleanable/dirt,
/obj/machinery/atmospherics/pipe/manifold/supply/hidden,
/obj/machinery/meter,
/turf/open/floor/plating/airless,
/area/shuttle/caravan/freighter1)
"fD" = (
/turf/template_noop,
/area/shuttle/caravan/freighter1)
"gc" = (
/obj/item/stack/sheet/iron/fifty,
/turf/open/floor/iron/airless{
	icon_state = "floorscorched2"
	},
/area/shuttle/caravan/freighter1)
"gi" = (
/obj/structure/closet/crate,
/obj/item/stack/sheet/mineral/titanium{
	amount = 20
	},
/obj/item/stack/sheet/mineral/titanium{
	amount = 20
	},
/obj/effect/turf_decal/tile/neutral/fourcorners/contrasted,
/turf/open/floor/iron/dark/airless,
/area/shuttle/caravan/freighter1)
"go" = (
/obj/effect/decal/cleanable/blood,
/mob/living/simple_animal/hostile/syndicate/melee/sword/space/stormtrooper,
/obj/effect/turf_decal/tile/blue{
	dir = 4
	},
/turf/open/floor/iron/dark{
	initial_gas_mix = "TEMP=2.7"
	},
/area/shuttle/caravan/freighter1)
"hj" = (
/obj/machinery/light/small,
/obj/structure/bed,
/obj/item/bedsheet,
/obj/effect/decal/cleanable/dirt,
/obj/machinery/airalarm/all_access{
	dir = 8;
	pixel_x = 24
	},
/obj/machinery/button/door{
	id = "caravantrade1_cabin2";
	name = "Cabin Bolt Control";
	normaldoorcontrol = 1;
	pixel_x = -25;
	pixel_y = 6;
	specialfunctions = 4
	},
/obj/machinery/atmospherics/components/unary/vent_pump/on{
	dir = 1
	},
/obj/effect/turf_decal/tile/neutral/fourcorners/contrasted,
/turf/open/floor/iron/dark/airless,
/area/shuttle/caravan/freighter1)
"ib" = (
/obj/effect/turf_decal/box/white/corners{
	dir = 4
	},
/turf/open/floor/iron/airless{
	icon_state = "damaged5"
	},
/area/shuttle/caravan/freighter1)
"ie" = (
/obj/machinery/door/airlock{
	id_tag = "caravantrade1_cabin2";
	name = "Cabin 2"
	},
/obj/machinery/atmospherics/pipe/simple/supply/hidden,
/obj/effect/turf_decal/tile/neutral/fourcorners/contrasted,
/turf/open/floor/iron/dark/airless,
/area/shuttle/caravan/freighter1)
"it" = (
/obj/effect/mapping_helpers/airlock/cyclelink_helper,
/obj/effect/mapping_helpers/airlock/locked,
/obj/machinery/door/airlock/external{
	id_tag = "caravantrade1_bolt"
	},
/obj/docking_port/mobile{
	callTime = 250;
	dir = 2;
	dwidth = 5;
	dynamic_id = 1;
	height = 11;
	id = "caravantrade1";
	movement_force = list("KNOCKDOWN" = 0, "THROW" = 0);
	name = "Small Freighter";
	port_direction = 8;
	preferred_direction = 4;
	width = 21
	},
/turf/open/floor/plating,
/area/shuttle/caravan/freighter1)
"iG" = (
/obj/effect/decal/cleanable/dirt,
/obj/machinery/atmospherics/pipe/simple/supply/hidden{
	dir = 4
	},
/turf/open/floor/iron/airless,
/area/shuttle/caravan/freighter1)
"ja" = (
/obj/structure/chair/stool,
/obj/effect/turf_decal/tile/yellow/half/contrasted,
/turf/open/floor/iron{
	initial_gas_mix = "TEMP=2.7"
	},
/area/shuttle/caravan/freighter1)
"jz" = (
/obj/effect/turf_decal/bot_white,
/obj/effect/decal/cleanable/dirt,
/obj/machinery/atmospherics/components/unary/vent_pump/on{
	dir = 1
	},
/obj/effect/turf_decal/tile/neutral/fourcorners/contrasted,
/turf/open/floor/iron/dark/airless,
/area/shuttle/caravan/freighter1)
"lt" = (
/obj/structure/cable,
/obj/machinery/power/port_gen/pacman{
	anchored = 1
	},
/obj/item/wrench,
/obj/effect/turf_decal/stripes/line{
	dir = 6
	},
/turf/open/floor/plating/airless,
/area/shuttle/caravan/freighter1)
"lC" = (
/obj/machinery/power/smes,
/obj/structure/cable/yellow{
	icon_state = "0-4"
	},
/obj/effect/turf_decal/stripes/line{
	dir = 5
	},
/obj/effect/decal/cleanable/dirt,
/obj/effect/decal/cleanable/dirt,
/turf/open/floor/plating/airless,
/area/shuttle/caravan/freighter1)
"lE" = (
/obj/machinery/atmospherics/pipe/simple/supply/hidden{
	dir = 4
	},
/turf/open/floor/iron/airless{
	icon_state = "floorscorched1"
	},
/area/shuttle/caravan/freighter1)
"lM" = (
/obj/machinery/light/small{
	dir = 8
	},
/obj/structure/sign/warning/vacuum{
	pixel_x = 32
	},
/turf/open/floor/plating,
/area/shuttle/caravan/freighter1)
"mo" = (
/obj/structure/shuttle/engine/heater{
	dir = 8
	},
/obj/structure/window/reinforced{
	dir = 4
	},
/turf/open/floor/plating/airless,
/area/shuttle/caravan/freighter1)
"nr" = (
/obj/machinery/door/airlock{
	name = "Restroom"
	},
/obj/effect/decal/cleanable/dirt,
/turf/open/floor/iron/showroomfloor{
	initial_gas_mix = "TEMP=2.7"
	},
/area/shuttle/caravan/freighter1)
"nt" = (
/obj/effect/turf_decal/box/white/corners{
	dir = 1
	},
/obj/structure/closet/crate,
/obj/item/stack/sheet/mineral/uranium{
	amount = 10
	},
/obj/item/stack/sheet/mineral/uranium{
	amount = 10
	},
/obj/effect/decal/cleanable/dirt,
/turf/open/floor/iron/airless/dark,
/area/shuttle/caravan/freighter1)
"oj" = (
/obj/effect/decal/cleanable/dirt,
/obj/machinery/atmospherics/pipe/manifold/supply/hidden{
	dir = 1
	},
/turf/open/floor/plating/airless,
/area/shuttle/caravan/freighter1)
"oF" = (
/obj/effect/turf_decal/box/white/corners{
	dir = 1
	},
/turf/open/floor/iron/airless{
	icon_state = "damaged4"
	},
/area/shuttle/caravan/freighter1)
"oW" = (
/obj/structure/table,
/obj/item/storage/box/donkpockets{
	pixel_x = 6;
	pixel_y = 6
	},
/obj/item/plate{
	pixel_x = -5;
	pixel_y = -3
	},
/obj/effect/decal/cleanable/dirt,
/obj/effect/turf_decal/tile/neutral/fourcorners/contrasted,
/turf/open/floor/iron/dark/airless,
/area/shuttle/caravan/freighter1)
"qc" = (
/obj/effect/decal/cleanable/dirt,
/turf/open/floor/iron/airless/dark,
/area/shuttle/caravan/freighter1)
"qw" = (
/obj/structure/chair/fancy/shuttle{
	dir = 4
	},
/obj/effect/decal/cleanable/dirt,
/obj/effect/mob_spawn/human/corpse/cargo_tech,
/obj/effect/decal/cleanable/blood,
/obj/effect/turf_decal/tile/blue,
/turf/open/floor/iron/dark{
	initial_gas_mix = "TEMP=2.7"
	},
/area/shuttle/caravan/freighter1)
"qx" = (
/obj/effect/turf_decal/box/white/corners{
	dir = 8
	},
/obj/structure/closet/crate,
/obj/item/stack/sheet/plasteel/twenty,
/obj/item/stack/sheet/plasteel/twenty,
/turf/open/floor/iron/airless{
	icon_state = "damaged5"
	},
/area/shuttle/caravan/freighter1)
"ru" = (
/obj/effect/turf_decal/bot_white,
/obj/structure/closet/emcloset,
/obj/effect/turf_decal/tile/neutral/fourcorners/contrasted,
/turf/open/floor/iron/dark/airless,
/area/shuttle/caravan/freighter1)
"rE" = (
/obj/machinery/door/airlock{
	name = "Crew Cabins"
	},
/obj/effect/decal/cleanable/dirt,
/obj/machinery/atmospherics/pipe/simple/supply/hidden{
	dir = 4
	},
/obj/effect/decal/cleanable/dirt,
/turf/open/floor/iron/airless,
/area/shuttle/caravan/freighter1)
"si" = (
/obj/effect/mapping_helpers/airlock/cyclelink_helper{
	dir = 1
	},
/obj/effect/mapping_helpers/airlock/locked,
/obj/machinery/door/airlock/external{
	id_tag = "caravantrade1_bolt"
	},
/turf/open/floor/plating,
/area/shuttle/caravan/freighter1)
"tA" = (
/obj/structure/table,
/obj/item/storage/toolbox/mechanical,
/obj/item/multitool,
/obj/effect/decal/cleanable/dirt,
/obj/effect/decal/cleanable/dirt,
/turf/open/floor/iron/airless,
/area/shuttle/caravan/freighter1)
"vg" = (
/obj/effect/decal/cleanable/dirt,
/obj/structure/table/reinforced,
/obj/item/paper_bin{
	pixel_x = 6;
	pixel_y = 6
	},
/obj/item/pen{
	pixel_x = 6;
	pixel_y = 6
	},
/obj/item/folder/yellow{
	pixel_x = -6
	},
/obj/item/gps{
	gpstag = "Emergency Distress Signal"
	},
/obj/effect/turf_decal/tile/blue/anticorner/contrasted,
/turf/open/floor/iron/dark{
	initial_gas_mix = "TEMP=2.7"
	},
/area/shuttle/caravan/freighter1)
"vt" = (
/obj/structure/shuttle/engine/propulsion/burst{
	dir = 8
	},
/turf/open/floor/plating/airless,
/area/shuttle/caravan/freighter1)
"vG" = (
/obj/machinery/door/airlock{
	id_tag = "caravantrade1_cabin1";
	name = "Cabin 1"
	},
/obj/effect/decal/cleanable/dirt,
/obj/machinery/atmospherics/pipe/simple/supply/hidden,
/obj/effect/turf_decal/tile/neutral/fourcorners/contrasted,
/turf/open/floor/iron/dark/airless,
/area/shuttle/caravan/freighter1)
"vQ" = (
/obj/machinery/atmospherics/pipe/manifold/supply/hidden{
	dir = 8
	},
/obj/effect/decal/cleanable/dirt,
/turf/open/floor/iron/airless,
/area/shuttle/caravan/freighter1)
"wW" = (
/obj/effect/turf_decal/tile/neutral/fourcorners/contrasted,
/turf/open/floor/iron/dark/airless,
/area/shuttle/caravan/freighter1)
"xx" = (
/obj/machinery/airalarm/all_access{
	dir = 8;
	pixel_x = 24
	},
/obj/machinery/atmospherics/pipe/simple/supply/hidden,
/turf/open/floor/plating/airless{
	broken = 1
	},
/area/shuttle/caravan/freighter1)
"yk" = (
/obj/effect/turf_decal/box/white/corners{
	dir = 4
	},
/obj/effect/decal/cleanable/dirt,
/obj/structure/closet/crate,
/obj/item/stack/sheet/mineral/gold{
	amount = 25
	},
/turf/open/floor/iron/airless/dark,
/area/shuttle/caravan/freighter1)
"yy" = (
/obj/machinery/light/small{
	dir = 4
	},
/obj/machinery/firealarm{
	dir = 4;
	pixel_x = 24
	},
/obj/effect/decal/cleanable/blood,
/obj/machinery/atmospherics/components/unary/vent_pump/on{
	dir = 8
	},
/mob/living/simple_animal/hostile/syndicate/ranged/smg/space,
/obj/effect/turf_decal/tile/yellow{
	dir = 4
	},
/turf/open/floor/iron{
	initial_gas_mix = "TEMP=2.7"
	},
/area/shuttle/caravan/freighter1)
"zd" = (
/obj/effect/turf_decal/bot,
/obj/machinery/atmospherics/components/unary/tank/air{
	dir = 4
	},
/obj/effect/decal/cleanable/dirt,
/turf/open/floor/plating/airless,
/area/shuttle/caravan/freighter1)
"Bh" = (
/obj/machinery/light/small{
	dir = 8
	},
/obj/machinery/firealarm{
	dir = 8;
	pixel_x = -24
	},
/obj/effect/decal/cleanable/dirt,
/obj/structure/rack,
/obj/item/storage/toolbox/emergency,
/obj/item/wrench,
/obj/effect/turf_decal/tile/blue/anticorner/contrasted{
	dir = 1
	},
/turf/open/floor/iron/dark{
	initial_gas_mix = "TEMP=2.7"
	},
/area/shuttle/caravan/freighter1)
"BB" = (
/obj/machinery/door/poddoor{
	id = "caravantrade1_cargo";
	name = "Cargo Blast Door"
	},
/obj/effect/decal/cleanable/dirt,
/turf/open/floor/plating/airless{
	broken = 1
	},
/area/shuttle/caravan/freighter1)
"BN" = (
/obj/machinery/door/firedoor,
/obj/machinery/atmospherics/pipe/simple/supply/hidden{
	dir = 4
	},
/obj/machinery/door/airlock/engineering{
	name = "Engine Room"
	},
/turf/open/floor/plating/airless,
/area/shuttle/caravan/freighter1)
"BP" = (
/obj/machinery/airalarm/all_access{
	dir = 4;
	pixel_x = -24
	},
/obj/effect/decal/cleanable/dirt,
/obj/machinery/atmospherics/pipe/simple/supply/hidden,
/obj/effect/mob_spawn/human/corpse/cargo_tech,
/obj/effect/decal/cleanable/blood,
/obj/effect/decal/cleanable/dirt,
/turf/open/floor/iron/airless,
/area/shuttle/caravan/freighter1)
"CT" = (
/obj/machinery/atmospherics/pipe/simple/supply/hidden{
	dir = 4
	},
/obj/effect/turf_decal/tile/yellow{
	dir = 4
	},
/turf/open/floor/iron{
	initial_gas_mix = "TEMP=2.7"
	},
/area/shuttle/caravan/freighter1)
"Dj" = (
/obj/structure/closet/crate,
/obj/item/stack/sheet/mineral/silver{
	amount = 25
	},
/obj/item/stack/sheet/mineral/silver{
	amount = 25
	},
/turf/open/floor/iron/airless/dark,
/area/shuttle/caravan/freighter1)
"Ds" = (
/obj/machinery/door/firedoor,
/obj/machinery/atmospherics/pipe/simple/supply/hidden,
/obj/structure/door_assembly/door_assembly_min{
	anchored = 1;
	density = 0;
	name = "broken airlock"
	},
/obj/effect/decal/cleanable/dirt,
/turf/open/floor/iron/airless,
/area/shuttle/caravan/freighter1)
"DB" = (
/mob/living/simple_animal/hostile/syndicate/ranged/smg/space,
/obj/effect/turf_decal/tile/neutral/fourcorners/contrasted,
/turf/open/floor/iron/dark/airless,
/area/shuttle/caravan/freighter1)
"DP" = (
/obj/effect/decal/cleanable/dirt,
/obj/machinery/atmospherics/pipe/manifold/supply/hidden{
	dir = 8
	},
/obj/effect/decal/cleanable/dirt,
/turf/open/floor/iron/airless,
/area/shuttle/caravan/freighter1)
"El" = (
/turf/closed/wall/mineral/titanium/nodiagonal,
/area/shuttle/caravan/freighter1)
"Em" = (
/obj/machinery/light/small,
/obj/structure/bed,
/obj/item/bedsheet,
/obj/effect/decal/cleanable/dirt,
/obj/machinery/airalarm/all_access{
	dir = 8;
	pixel_x = 24
	},
/obj/machinery/button/door{
	id = "caravantrade1_cabin1";
	name = "Cabin Bolt Control";
	normaldoorcontrol = 1;
	pixel_x = -25;
	pixel_y = 6;
	specialfunctions = 4
	},
/obj/machinery/atmospherics/components/unary/vent_pump/on{
	dir = 1
	},
/obj/effect/turf_decal/tile/neutral/fourcorners/contrasted,
/turf/open/floor/iron/dark/airless,
/area/shuttle/caravan/freighter1)
"Eo" = (
/obj/structure/lattice,
/obj/item/stack/sheet/mineral/titanium,
/turf/template_noop,
/area/shuttle/caravan/freighter1)
"ET" = (
/obj/structure/rack,
/obj/item/storage/belt/utility,
/obj/structure/extinguisher_cabinet{
	pixel_y = 29
	},
/obj/effect/decal/cleanable/dirt,
/obj/effect/decal/cleanable/dirt,
/turf/open/floor/iron/airless,
/area/shuttle/caravan/freighter1)
"Fv" = (
/turf/closed/wall/mineral/titanium,
/area/shuttle/caravan/freighter1)
"Fx" = (
/obj/structure/lattice,
/obj/structure/fluff/broken_flooring{
	icon_state = "singular"
	},
/turf/template_noop,
/area/shuttle/caravan/freighter1)
"FO" = (
/obj/machinery/light/small,
/obj/effect/turf_decal/box/white/corners,
/obj/machinery/button/door{
	id = "caravantrade1_cargo";
	name = "Cargo Blast Door Control";
	pixel_y = -24
	},
/obj/structure/closet/crate,
/obj/item/stack/sheet/mineral/diamond{
	amount = 5
	},
/turf/open/floor/iron/airless/dark,
/area/shuttle/caravan/freighter1)
"Gd" = (
/obj/effect/decal/cleanable/dirt,
/obj/machinery/atmospherics/pipe/simple/supply/hidden{
	dir = 4
	},
/obj/effect/decal/cleanable/dirt,
/turf/open/floor/iron/airless,
/area/shuttle/caravan/freighter1)
"Gn" = (
/obj/machinery/atmospherics/pipe/manifold/supply/hidden{
	dir = 8
	},
/turf/open/floor/iron/airless,
/area/shuttle/caravan/freighter1)
"Gx" = (
/obj/effect/turf_decal/box/white/corners{
	dir = 4
	},
/turf/open/floor/iron/airless/dark,
/area/shuttle/caravan/freighter1)
"Ht" = (
/obj/effect/turf_decal/box/white/corners{
	dir = 8
	},
/obj/effect/decal/cleanable/dirt,
/turf/open/floor/iron/airless/dark,
/area/shuttle/caravan/freighter1)
"HL" = (
/obj/machinery/atmospherics/components/unary/vent_pump/on{
	dir = 1
	},
/obj/effect/turf_decal/tile/neutral/fourcorners/contrasted,
/turf/open/floor/iron/dark/airless,
/area/shuttle/caravan/freighter1)
"Ie" = (
/obj/machinery/door/firedoor,
/obj/machinery/atmospherics/pipe/simple/supply/hidden{
	dir = 4
	},
/obj/machinery/door/airlock/command{
	name = "Bridge"
	},
/turf/open/floor/iron/airless/dark,
/area/shuttle/caravan/freighter1)
"IE" = (
/obj/effect/decal/cleanable/dirt,
/turf/open/floor/iron/airless{
	icon_state = "damaged2"
	},
/area/shuttle/caravan/freighter1)
"IQ" = (
/obj/effect/turf_decal/bot,
/obj/machinery/space_heater,
/obj/effect/decal/cleanable/dirt,
/obj/machinery/atmospherics/components/unary/vent_pump/on{
	dir = 4
	},
/turf/open/floor/plating/airless{
	broken = 1
	},
/area/shuttle/caravan/freighter1)
"Jp" = (
/obj/effect/decal/cleanable/dirt,
/turf/open/floor/plating/airless{
	broken = 1
	},
/area/shuttle/caravan/freighter1)
"Jv" = (
/turf/template_noop,
/area/template_noop)
"JP" = (
/obj/effect/turf_decal/box/white/corners{
	dir = 1
	},
/obj/structure/closet/crate,
/obj/item/stack/sheet/rglass{
	amount = 20
	},
/obj/item/stack/sheet/rglass{
	amount = 20
	},
/turf/open/floor/iron/airless/dark,
/area/shuttle/caravan/freighter1)
"KC" = (
/obj/structure/shuttle/engine/propulsion/burst/right{
	dir = 8
	},
/turf/open/floor/plating/airless,
/area/shuttle/caravan/freighter1)
"KR" = (
/obj/effect/decal/cleanable/dirt,
/obj/machinery/computer/shuttle_flight/caravan/trade1{
	dir = 8
	},
/obj/effect/turf_decal/tile/blue/anticorner/contrasted{
	dir = 8
	},
/turf/open/floor/iron/dark{
	initial_gas_mix = "TEMP=2.7"
	},
/area/shuttle/caravan/freighter1)
"KX" = (
/obj/structure/shuttle/engine/propulsion/burst/left{
	dir = 8
	},
/turf/open/floor/plating/airless,
/area/shuttle/caravan/freighter1)
"LM" = (
/obj/effect/spawner/structure/window/shuttle,
/obj/machinery/door/poddoor{
	id = "caravantrade1_bridge"
	},
/turf/open/floor/plating,
/area/shuttle/caravan/freighter1)
"LN" = (
/obj/effect/turf_decal/box/white/corners,
/obj/structure/closet/crate,
/obj/item/stack/sheet/glass/fifty,
/obj/item/stack/sheet/glass/fifty,
/obj/effect/decal/cleanable/dirt,
/turf/open/floor/iron/airless/dark,
/area/shuttle/caravan/freighter1)
"LV" = (
/obj/machinery/firealarm{
	pixel_y = 24
	},
/obj/machinery/atmospherics/pipe/manifold/supply/hidden{
	dir = 1
	},
/turf/open/floor/iron/airless,
/area/shuttle/caravan/freighter1)
"Ma" = (
/obj/machinery/light/small{
	dir = 1
	},
/obj/machinery/airalarm/all_access{
	pixel_y = 24
	},
/obj/machinery/atmospherics/pipe/simple/supply/hidden{
	dir = 4
	},
/turf/open/floor/iron/airless,
/area/shuttle/caravan/freighter1)
"Mr" = (
/obj/effect/decal/cleanable/dirt,
/obj/structure/frame/computer{
	anchored = 1;
	dir = 8
	},
/obj/effect/turf_decal/tile/blue/anticorner/contrasted{
	dir = 1
	},
/turf/open/floor/iron/dark{
	initial_gas_mix = "TEMP=2.7"
	},
/area/shuttle/caravan/freighter1)
"Mx" = (
/obj/machinery/light/small,
/obj/effect/decal/cleanable/dirt,
/obj/machinery/atmospherics/pipe/simple/supply/hidden{
	dir = 4
	},
/obj/effect/turf_decal/tile/yellow/half/contrasted{
	dir = 4
	},
/turf/open/floor/iron{
	initial_gas_mix = "TEMP=2.7"
	},
/area/shuttle/caravan/freighter1)
"MX" = (
/obj/machinery/atmospherics/pipe/simple/supply/hidden{
	dir = 10
	},
/obj/effect/decal/cleanable/dirt,
/turf/open/floor/iron/airless,
/area/shuttle/caravan/freighter1)
"ND" = (
/obj/structure/rack,
/obj/item/tank/internals/oxygen,
/obj/item/radio,
/obj/item/clothing/mask/gas,
/obj/effect/turf_decal/tile/blue{
	dir = 4
	},
/turf/open/floor/iron{
	initial_gas_mix = "TEMP=2.7"
	},
/area/shuttle/caravan/freighter1)
"Od" = (
/obj/item/stack/sheet/mineral/titanium,
/obj/machinery/atmospherics/pipe/manifold/supply/hidden{
	dir = 4
	},
/turf/open/floor/iron/airless{
	icon_state = "damaged1"
	},
/area/shuttle/caravan/freighter1)
"Ok" = (
/obj/structure/closet/secure_closet/freezer{
	locked = 0;
	name = "fridge"
	},
/obj/item/reagent_containers/food/drinks/beer{
	pixel_x = -3;
	pixel_y = 3
	},
/obj/item/reagent_containers/food/drinks/beer,
/obj/item/reagent_containers/food/drinks/beer{
	pixel_x = 3;
	pixel_y = -3
	},
/obj/item/reagent_containers/glass/waterbottle{
	pixel_x = -3;
	pixel_y = 3
	},
/obj/item/reagent_containers/glass/waterbottle,
/obj/item/reagent_containers/glass/waterbottle{
	pixel_x = 3;
	pixel_y = -3
	},
/obj/item/food/pizzaslice/margherita{
	pixel_x = -3;
	pixel_y = 3
	},
/obj/item/food/pizzaslice/margherita,
/obj/item/food/chocolatebar,
/obj/effect/turf_decal/tile/yellow/anticorner/contrasted{
	dir = 4
	},
/turf/open/floor/iron{
	initial_gas_mix = "TEMP=2.7"
	},
/area/shuttle/caravan/freighter1)
"OX" = (
/obj/machinery/button/door{
	id = "caravantrade1_bolt";
	name = "External Bolt Control";
	normaldoorcontrol = 1;
	pixel_x = -25;
	pixel_y = 8;
	specialfunctions = 4
	},
/obj/machinery/atmospherics/components/unary/vent_pump/on,
/obj/effect/turf_decal/tile/blue,
/turf/open/floor/iron{
	initial_gas_mix = "TEMP=2.7"
	},
/area/shuttle/caravan/freighter1)
"PF" = (
/obj/machinery/light/small,
/obj/effect/decal/cleanable/dirt,
/obj/machinery/atmospherics/pipe/simple/supply/hidden{
	dir = 4
	},
/turf/open/floor/iron/airless,
/area/shuttle/caravan/freighter1)
"Qs" = (
/obj/machinery/light/small{
	dir = 4
	},
/obj/structure/cable/yellow,
/obj/machinery/power/apc{
	dir = 4;
	name = "Small Freighter APC";
	pixel_x = 24;
	req_access = null;
	start_charge = 0
	},
/obj/effect/decal/cleanable/dirt,
/obj/machinery/atmospherics/pipe/simple/supply/hidden,
/turf/open/floor/plating/airless,
/area/shuttle/caravan/freighter1)
"Rx" = (
/obj/effect/decal/cleanable/dirt,
/obj/machinery/atmospherics/pipe/simple/supply/hidden{
	dir = 10
	},
/obj/effect/decal/cleanable/blood,
/obj/effect/turf_decal/tile/yellow/half/contrasted{
	dir = 4
	},
/turf/open/floor/iron{
	initial_gas_mix = "TEMP=2.7"
	},
/area/shuttle/caravan/freighter1)
"RK" = (
/obj/machinery/suit_storage_unit/standard_unit,
/obj/effect/decal/cleanable/dirt,
/turf/open/floor/iron/airless,
/area/shuttle/caravan/freighter1)
"Td" = (
/obj/structure/lattice,
/turf/template_noop,
/area/shuttle/caravan/freighter1)
"Ty" = (
/obj/machinery/light/small{
	dir = 8
	},
/obj/effect/decal/cleanable/dirt,
/obj/structure/rack,
/obj/item/storage/firstaid/regular,
/obj/effect/turf_decal/tile/blue/anticorner/contrasted{
	dir = 8
	},
/turf/open/floor/iron/dark{
	initial_gas_mix = "TEMP=2.7"
	},
/area/shuttle/caravan/freighter1)
"Ua" = (
/obj/structure/girder,
/turf/open/floor/plating/airless{
	broken = 1
	},
/area/shuttle/caravan/freighter1)
"Ut" = (
/obj/effect/decal/cleanable/dirt,
/turf/open/floor/plating/airless,
/area/shuttle/caravan/freighter1)
"UM" = (
/obj/structure/table/reinforced,
/obj/machinery/button/door{
	id = "caravantrade1_bridge";
	name = "Ship Blast Door Control"
	},
/obj/effect/turf_decal/tile/blue/anticorner/contrasted{
	dir = 4
	},
/turf/open/floor/iron/dark{
	initial_gas_mix = "TEMP=2.7"
	},
/area/shuttle/caravan/freighter1)
"UY" = (
/obj/structure/closet/crate{
	opened = 1
	},
/obj/item/stack/sheet/iron/fifty,
/turf/open/floor/iron/airless/dark,
/area/shuttle/caravan/freighter1)
"WV" = (
/obj/machinery/light{
	dir = 1
	},
/obj/structure/table,
/obj/item/stack/package_wrap,
/obj/item/crowbar,
/obj/item/flashlight{
	pixel_x = 1;
	pixel_y = 5
	},
/obj/machinery/airalarm/all_access{
	pixel_y = 24
	},
/obj/effect/decal/cleanable/dirt,
/turf/open/floor/iron/airless,
/area/shuttle/caravan/freighter1)
"WZ" = (
/obj/machinery/power/terminal{
	dir = 1
	},
/obj/structure/cable{
	icon_state = "0-2"
	},
/obj/structure/closet/crate,
/obj/item/stack/sheet/iron/twenty,
/obj/item/stack/sheet/glass{
	amount = 10
	},
/obj/item/stack/rods/ten,
/obj/item/storage/box/lights/bulbs,
/obj/effect/turf_decal/stripes/line{
	dir = 4
	},
/obj/effect/decal/cleanable/dirt,
/turf/open/floor/plating/airless,
/area/shuttle/caravan/freighter1)
"Xh" = (
/obj/machinery/door/poddoor{
	id = "caravantrade1_cargo";
	name = "Cargo Blast Door"
	},
/turf/open/floor/plating/airless,
/area/shuttle/caravan/freighter1)
"Xq" = (
/obj/machinery/airalarm/all_access{
	dir = 4;
	pixel_x = -24
	},
/obj/effect/decal/cleanable/dirt,
/obj/effect/decal/cleanable/blood,
/obj/machinery/atmospherics/components/unary/vent_pump/on,
/turf/open/floor/iron/airless/dark,
/area/shuttle/caravan/freighter1)
"Xw" = (
/turf/open/floor/iron/airless/dark,
/area/shuttle/caravan/freighter1)
"XN" = (
/obj/structure/table,
/obj/machinery/cell_charger,
/obj/machinery/firealarm{
	pixel_y = 24
	},
/obj/item/stack/cable_coil/yellow{
	pixel_x = 12;
	pixel_y = 4
	},
/turf/open/floor/iron/airless,
/area/shuttle/caravan/freighter1)
"YA" = (
/obj/machinery/atmospherics/pipe/simple/supply/hidden{
	dir = 4
	},
/mob/living/simple_animal/hostile/syndicate/ranged/smg/space,
/turf/open/floor/iron/airless,
/area/shuttle/caravan/freighter1)
"YE" = (
/obj/machinery/atmospherics/pipe/simple/supply/hidden{
	dir = 9
	},
/turf/open/floor/iron/airless/dark,
/area/shuttle/caravan/freighter1)
"Zv" = (
/obj/effect/turf_decal/box/white/corners{
	dir = 8
	},
/turf/open/floor/iron/airless/dark,
/area/shuttle/caravan/freighter1)
"ZM" = (
/obj/effect/decal/cleanable/dirt,
/turf/open/floor/iron/airless{
	icon_state = "damaged3"
	},
/area/shuttle/caravan/freighter1)
"ZR" = (
/obj/structure/toilet{
	dir = 4
	},
/obj/structure/sink{
	pixel_y = 24
	},
/obj/machinery/light/small,
/obj/effect/decal/cleanable/dirt,
/obj/effect/decal/cleanable/dirt,
/turf/open/floor/iron/showroomfloor{
	initial_gas_mix = "TEMP=2.7"
	},
/area/shuttle/caravan/freighter1)

(1,1,1) = {"
Jv
KX
vt
vt
vt
KC
Fv
Jv
Jv
Jv
Jv
"}
(2,1,1) = {"
Fv
mo
mo
mo
mo
mo
El
KX
vt
KC
Jv
"}
(3,1,1) = {"
El
IQ
lC
WZ
lt
zd
El
mo
mo
mo
Fv
"}
(4,1,1) = {"
El
oj
ec
Qs
xx
fk
El
nt
Dj
Ht
El
"}
(5,1,1) = {"
El
BN
El
El
El
BN
El
yk
Xw
FO
El
"}
(6,1,1) = {"
El
LV
ie
hj
El
MX
DP
HL
DB
wW
eP
"}
(7,1,1) = {"
LM
PF
El
El
El
ET
lE
JP
qc
Zv
BB
"}
(8,1,1) = {"
El
dP
vG
Em
Fv
WV
iG
Gx
qc
LN
Xh
"}
(9,1,1) = {"
El
rE
El
El
El
XN
YA
gc
gi
ZM
eP
"}
(10,1,1) = {"
El
CT
El
ZR
El
tA
Gd
oF
UY
qx
Xh
"}
(11,1,1) = {"
LM
Mx
El
nr
El
El
lE
ib
IE
Td
Jp
"}
(12,1,1) = {"
LM
Rx
BP
Gn
vQ
Ds
Od
jz
Fx
fD
Eo
"}
(13,1,1) = {"
LM
Ok
ja
yy
iG
El
ru
Ut
Td
fD
fD
"}
(14,1,1) = {"
El
cy
oW
El
dE
El
El
Ua
fD
fD
Jv
"}
(15,1,1) = {"
El
El
El
El
Ma
RK
El
Jv
Jv
Jv
Jv
"}
(16,1,1) = {"
it
lM
si
OX
de
ND
LM
Jv
Jv
Jv
Jv
"}
(17,1,1) = {"
Fv
El
El
El
Ie
El
El
Jv
Jv
Jv
Jv
"}
(18,1,1) = {"
Jv
El
Ty
Xq
YE
Bh
El
Jv
Jv
Jv
Jv
"}
(19,1,1) = {"
Jv
LM
vg
go
qw
UM
LM
Jv
Jv
Jv
Jv
"}
(20,1,1) = {"
Jv
LM
LM
Mr
KR
LM
LM
Jv
Jv
Jv
Jv
"}
(21,1,1) = {"
Jv
Jv
LM
LM
LM
LM
Jv
Jv
Jv
Jv
Jv
"}
