//MAP CONVERTED BY dmm2tgm.py THIS HEADER COMMENT PREVENTS RECONVERSION, DO NOT REMOVE
"ah" = (
/obj/effect/turf_decal/stripes/closeup{
	dir = 1
	},
/obj/effect/decal/cleanable/dirt/dust,
/turf/open/floor/mineral/plastitanium/red,
/area/shuttle/syndicate_scout)
"bS" = (
/turf/closed/wall/r_wall/syndicate,
/area/shuttle/syndicate_scout)
"co" = (
/obj/structure/closet/crate{
	name = "food crate"
	},
/obj/item/reagent_containers/glass/waterbottle/large{
	pixel_x = -5;
	pixel_y = 3
	},
/obj/item/reagent_containers/glass/waterbottle/large{
	pixel_x = 2;
	pixel_y = 3
	},
/obj/item/reagent_containers/glass/waterbottle/large{
	pixel_x = -2
	},
/obj/item/reagent_containers/glass/waterbottle/large{
	pixel_x = 5
	},
/obj/item/reagent_containers/glass/waterbottle/large{
	pixel_x = 1;
	pixel_y = -3
	},
/obj/item/reagent_containers/glass/waterbottle/large{
	pixel_x = 8;
	pixel_y = -3
	},
/obj/effect/turf_decal/stripes/line{
	dir = 5
	},
/obj/effect/turf_decal/tile/brown/tile_marquee,
/turf/open/floor/plasteel/dark,
/area/shuttle/syndicate_scout)
"cA" = (
/obj/effect/turf_decal/stripes/line{
	dir = 6
	},
/obj/machinery/power/port_gen/pacman{
	anchored = 1
	},
/obj/effect/decal/cleanable/dirt,
/obj/effect/decal/cleanable/glass,
/obj/effect/turf_decal/delivery,
/obj/structure/cable,
/turf/open/floor/plasteel/techmaint,
/area/shuttle/syndicate_scout)
"dd" = (
/obj/effect/turf_decal/trimline/neutral/filled/line{
	dir = 8
	},
/turf/open/floor/mineral/plastitanium,
/area/shuttle/syndicate_scout)
"de" = (
/obj/effect/turf_decal/tile/brown/tile_marquee,
/obj/effect/turf_decal/stripes/line{
	dir = 9
	},
/obj/effect/decal/cleanable/dirt/dust,
/turf/open/floor/plasteel/dark,
/area/shuttle/syndicate_scout)
"dn" = (
/obj/structure/table/reinforced,
/obj/effect/turf_decal/stripes/line{
	dir = 1
	},
/obj/item/ammo_box/magazine/smgm45{
	pixel_x = 3;
	pixel_y = 4
	},
/obj/item/ammo_box/magazine/smgm45,
/obj/item/gun/ballistic/automatic/c20r,
/obj/effect/decal/cleanable/dirt/dust,
/obj/machinery/light/small,
/turf/open/floor/mineral/plastitanium,
/area/shuttle/syndicate_scout)
"dL" = (
/obj/effect/turf_decal/stripes/corner{
	dir = 5
	},
/obj/effect/turf_decal/stripes/line{
	dir = 8
	},
/turf/open/floor/mineral/plastitanium/red,
/area/shuttle/syndicate_scout)
"eL" = (
/obj/effect/turf_decal/stripes/corner{
	dir = 4
	},
/obj/effect/decal/cleanable/dirt,
/obj/machinery/atmospherics/pipe/simple/purple/visible{
	dir = 4
	},
/turf/open/floor/plasteel/techmaint,
/area/shuttle/syndicate_scout)
"fk" = (
/obj/effect/turf_decal/stripes/closeup{
	dir = 10
	},
/obj/effect/decal/cleanable/dirt/dust,
/obj/machinery/button/door{
	id = "syndie_ptransport_windows";
	name = "Window shutters";
	pixel_x = 28
	},
/turf/open/floor/mineral/plastitanium/red,
/area/shuttle/syndicate_scout)
"fX" = (
/obj/effect/turf_decal/stripes/closeup{
	dir = 6
	},
/obj/effect/decal/cleanable/dirt/dust,
/turf/open/floor/mineral/plastitanium/red,
/area/shuttle/syndicate_scout)
"he" = (
/obj/effect/landmark/exploration_weapon_spawner{
	dir = 4
	},
/turf/closed/wall/r_wall/syndicate/nodiagonal,
/area/shuttle/syndicate_scout)
"hj" = (
/obj/machinery/door/poddoor/shutters{
	id = "syndie_ptransport_windows";
	name = "blast shutters"
	},
/obj/structure/grille,
/obj/structure/window/plastitanium,
/turf/open/floor/plating,
/area/shuttle/syndicate_scout)
"id" = (
/obj/effect/turf_decal/tile/neutral/tile_full,
/obj/structure/chair/comfy/shuttle{
	dir = 1;
	name = "tactical chair"
	},
/obj/effect/turf_decal/stripes/corner{
	dir = 8
	},
/obj/effect/decal/cleanable/dirt/dust,
/mob/living/simple_animal/hostile/syndicate/melee,
/turf/open/floor/mineral/plastitanium,
/area/shuttle/syndicate_scout)
"kh" = (
/obj/structure/window/reinforced/survival_pod{
	dir = 1
	},
/obj/machinery/atmospherics/components/unary/shuttle/engine_heater{
	dir = 1
	},
/turf/open/floor/plating,
/area/shuttle/syndicate_scout)
"kK" = (
/obj/effect/turf_decal/trimline/brown/filled/warning{
	dir = 8
	},
/obj/effect/turf_decal/trimline/brown/filled/warning{
	dir = 8
	},
/turf/open/floor/plasteel/techmaint,
/area/shuttle/syndicate_scout)
"kX" = (
/obj/machinery/door/poddoor{
	id = "syndie_ptransport_cargo";
	name = "Cargo bay"
	},
/obj/effect/turf_decal/stripes/line{
	dir = 4
	},
/obj/structure/fans/tiny,
/obj/docking_port/mobile{
	dir = 4;
	dwidth = 15;
	dynamic_id = 1;
	height = 10;
	id = "synprison";
	name = "prisoner transport";
	width = 20
	},
/turf/open/floor/plasteel/tech/grid,
/area/shuttle/syndicate_scout)
"lp" = (
/obj/machinery/shuttle/engine/plasma{
	dir = 1
	},
/turf/open/floor/plating,
/area/shuttle/syndicate_scout)
"mj" = (
/obj/structure/bed/pod,
/obj/machinery/shower{
	pixel_y = 15
	},
/obj/effect/decal/cleanable/dirt/dust,
/obj/item/toy/plush/rouny{
	dir = 4;
	pixel_x = -2;
	pixel_y = 8
	},
/obj/effect/decal/cleanable/blood/old,
/obj/effect/decal/cleanable/blood/splatter{
	pixel_x = 13;
	pixel_y = 3
	},
/turf/open/floor/pod,
/area/shuttle/syndicate_scout)
"mA" = (
/obj/effect/turf_decal/stripes/line{
	dir = 10
	},
/obj/effect/turf_decal/tile/neutral{
	dir = 4
	},
/obj/structure/table/reinforced,
/obj/item/stock_parts/cell/high/plus{
	pixel_x = 4;
	pixel_y = 4
	},
/obj/item/storage/toolbox/syndicate{
	pixel_x = -2;
	pixel_y = 1
	},
/obj/machinery/cell_charger,
/obj/item/multitool,
/obj/structure/sign/poster/contraband/random{
	pixel_x = -32
	},
/obj/machinery/atmospherics/pipe/manifold/purple/visible{
	dir = 1
	},
/turf/open/floor/plasteel/techmaint,
/area/shuttle/syndicate_scout)
"mY" = (
/obj/effect/turf_decal/trimline/neutral/filled/line{
	dir = 8
	},
/obj/machinery/light{
	dir = 8
	},
/obj/effect/decal/cleanable/dirt/dust,
/turf/open/floor/mineral/plastitanium,
/area/shuttle/syndicate_scout)
"nh" = (
/obj/effect/turf_decal/stripes/line,
/obj/effect/turf_decal/tile/neutral/tile_side{
	dir = 4
	},
/obj/structure/table/reinforced,
/obj/item/stack/sheet/mineral/plastitanium{
	amount = 30
	},
/obj/item/stack/cable_coil/red,
/obj/item/assembly/prox_sensor{
	desc = "Used for scanning and alerting when someone enters a certain proximity. This one is slightly shifted to the left.";
	pixel_x = -6;
	pixel_y = 6
	},
/obj/item/storage/belt/utility{
	pixel_y = -3
	},
/obj/effect/decal/cleanable/dirt/dust,
/obj/effect/decal/cleanable/generic{
	pixel_x = -12;
	pixel_y = 14
	},
/obj/machinery/light/small,
/obj/machinery/atmospherics/pipe/manifold4w/purple/visible,
/turf/open/floor/plasteel/techmaint,
/area/shuttle/syndicate_scout)
"nA" = (
/obj/effect/turf_decal/stripes/closeup{
	dir = 10
	},
/obj/machinery/atmospherics/pipe/simple/purple/visible{
	dir = 10
	},
/turf/open/floor/mineral/plastitanium/red,
/area/shuttle/syndicate_scout)
"nY" = (
/obj/machinery/porta_turret/syndicate/pod{
	dir = 6
	},
/turf/closed/wall/r_wall/syndicate/nodiagonal,
/area/shuttle/syndicate_scout)
"ob" = (
/obj/effect/turf_decal/tile/brown/tile_marquee,
/obj/effect/turf_decal/stripes/line{
	dir = 10
	},
/obj/item/storage/firstaid/tactical{
	pixel_x = 8;
	pixel_y = -5
	},
/obj/effect/decal/cleanable/dirt/dust,
/obj/item/storage/backpack/duffelbag/syndie/surgery,
/turf/open/floor/plasteel/dark,
/area/shuttle/syndicate_scout)
"ok" = (
/obj/effect/turf_decal/tile/neutral/tile_full,
/obj/structure/table/reinforced,
/obj/item/newspaper{
	pixel_x = -5
	},
/obj/item/toy/cards/deck/syndicate{
	pixel_x = 1;
	pixel_y = 1
	},
/obj/item/storage/pill_bottle/neurine{
	pixel_x = 5;
	pixel_y = 12
	},
/turf/open/floor/pod/dark,
/area/shuttle/syndicate_scout)
"ps" = (
/obj/effect/turf_decal/stripes/line{
	dir = 8
	},
/obj/structure/table/reinforced,
/obj/item/storage/box/lights/bulbs,
/obj/effect/decal/cleanable/dirt/dust,
/obj/effect/decal/cleanable/dirt,
/turf/open/floor/plasteel/techmaint,
/area/shuttle/syndicate_scout)
"pJ" = (
/obj/effect/decal/cleanable/dirt/dust,
/obj/effect/turf_decal/trimline/brown/filled/warning{
	dir = 8
	},
/obj/effect/turf_decal/trimline/brown/filled/warning{
	dir = 8
	},
/obj/machinery/atmospherics/pipe/simple/purple/visible{
	dir = 6
	},
/turf/open/floor/plasteel/techmaint,
/area/shuttle/syndicate_scout)
"pK" = (
/obj/effect/turf_decal/stripes/line{
	dir = 4
	},
/obj/structure/fans/tiny,
/obj/machinery/door/poddoor{
	id = "syndie_ptransport_cargo";
	name = "Cargo bay"
	},
/turf/open/floor/plasteel/tech/grid,
/area/shuttle/syndicate_scout)
"pX" = (
/obj/effect/decal/cleanable/dirt/dust,
/obj/machinery/door/airlock/security/glass{
	req_access_txt = "150"
	},
/turf/open/floor/pod,
/area/shuttle/syndicate_scout)
"qh" = (
/obj/effect/turf_decal/tile/neutral/tile_full,
/obj/structure/table/reinforced,
/obj/machinery/microwave{
	pixel_y = 5
	},
/obj/item/storage/box/donkpockets/donkpocketteriyaki{
	pixel_x = 4;
	pixel_y = 5
	},
/obj/item/storage/box/donkpockets/donkpocketberry,
/obj/machinery/light{
	dir = 1
	},
/turf/open/floor/pod/dark,
/area/shuttle/syndicate_scout)
"qx" = (
/obj/item/clothing/glasses/science{
	pixel_x = 2;
	pixel_y = 9
	},
/obj/item/flashlight/seclite,
/obj/item/flashlight/seclite,
/obj/item/extinguisher/mini,
/obj/item/pickaxe/drill{
	pixel_y = -6
	},
/obj/item/extinguisher/mini,
/obj/structure/rack,
/obj/effect/turf_decal/delivery,
/obj/effect/turf_decal/stripes/line,
/obj/item/pickaxe/drill,
/obj/effect/decal/cleanable/dirt/dust,
/obj/machinery/atmospherics/pipe/manifold/purple/visible{
	dir = 1
	},
/obj/item/mining_scanner,
/turf/open/floor/plasteel/techmaint,
/area/shuttle/syndicate_scout)
"rp" = (
/obj/effect/turf_decal/stripes/closeup{
	dir = 1
	},
/obj/structure/chair/stool/bar{
	pixel_x = -15;
	pixel_y = -2
	},
/obj/effect/decal/cleanable/dirt/dust,
/turf/open/floor/mineral/plastitanium/red,
/area/shuttle/syndicate_scout)
"rE" = (
/obj/effect/turf_decal/stripes/line{
	dir = 8
	},
/obj/machinery/suit_storage_unit/syndicate,
/obj/effect/turf_decal/bot,
/obj/effect/decal/cleanable/dirt/dust,
/obj/effect/decal/cleanable/dirt,
/turf/open/floor/mineral/plastitanium,
/area/shuttle/syndicate_scout)
"tp" = (
/obj/effect/turf_decal/stripes/closeup,
/obj/machinery/door/airlock/hatch{
	req_access_txt = "150"
	},
/turf/open/floor/mineral/plastitanium/red,
/area/shuttle/syndicate_scout)
"tB" = (
/obj/machinery/computer/camera_advanced/syndie,
/obj/effect/turf_decal/tile/neutral/tile_full,
/obj/effect/turf_decal/stripes/line{
	dir = 9
	},
/obj/machinery/light{
	dir = 8
	},
/turf/open/floor/mineral/plastitanium,
/area/shuttle/syndicate_scout)
"uc" = (
/obj/effect/turf_decal/stripes/line{
	dir = 1
	},
/obj/machinery/power/apc/auto_name/north{
	pixel_y = 24
	},
/obj/effect/decal/cleanable/dirt,
/obj/structure/cable{
	icon_state = "0-4"
	},
/obj/machinery/atmospherics/pipe/simple/purple/visible{
	dir = 4
	},
/turf/open/floor/plasteel/techmaint,
/area/shuttle/syndicate_scout)
"ui" = (
/obj/effect/turf_decal/tile/neutral/tile_full,
/obj/structure/dresser,
/turf/open/floor/plasteel/techmaint,
/area/shuttle/syndicate_scout)
"uT" = (
/obj/effect/turf_decal/trimline/neutral/filled/line{
	dir = 8
	},
/obj/structure/table/reinforced,
/obj/item/storage/box/minertracker{
	pixel_x = -8;
	pixel_y = -1
	},
/obj/item/storage/box/handcuffs{
	pixel_x = 5;
	pixel_y = 5
	},
/obj/machinery/light,
/turf/open/floor/mineral/plastitanium,
/area/shuttle/syndicate_scout)
"vx" = (
/obj/effect/turf_decal/box,
/obj/effect/turf_decal/arrows{
	dir = 1
	},
/obj/effect/turf_decal/trimline/brown/filled/line{
	dir = 10
	},
/obj/effect/turf_decal/trimline/brown/filled/line{
	dir = 10
	},
/obj/machinery/atmospherics/components/unary/plasma_refiner{
	dir = 1
	},
/turf/open/floor/plasteel/techmaint,
/area/shuttle/syndicate_scout)
"vW" = (
/obj/machinery/computer/shuttle_flight/syndicate,
/obj/effect/turf_decal/tile/neutral/tile_full,
/obj/effect/turf_decal/stripes/line{
	dir = 1
	},
/turf/open/floor/mineral/plastitanium,
/area/shuttle/syndicate_scout)
"wr" = (
/obj/machinery/vending/sovietsoda,
/obj/effect/turf_decal/bot,
/turf/open/floor/mineral/plastitanium,
/area/shuttle/syndicate_scout)
"wI" = (
/obj/machinery/porta_turret/syndicate/pod{
	dir = 5
	},
/turf/closed/wall/r_wall/syndicate,
/area/shuttle/syndicate_scout)
"xC" = (
/turf/template_noop,
/area/template_noop)
"xD" = (
/obj/effect/turf_decal/stripes/closeup,
/turf/open/floor/mineral/plastitanium/red,
/area/shuttle/syndicate_scout)
"yD" = (
/obj/machinery/vending/cigarette/syndicate,
/obj/effect/turf_decal/bot,
/obj/machinery/light{
	dir = 4
	},
/turf/open/floor/mineral/plastitanium,
/area/shuttle/syndicate_scout)
"yV" = (
/obj/effect/turf_decal/stripes/line{
	dir = 5
	},
/obj/effect/decal/cleanable/dirt/dust,
/obj/machinery/light/small{
	dir = 1
	},
/obj/structure/cable{
	icon_state = "2-8"
	},
/obj/machinery/atmospherics/pipe/simple/purple/visible{
	dir = 4
	},
/turf/open/floor/plasteel/techmaint,
/area/shuttle/syndicate_scout)
"yY" = (
/obj/effect/turf_decal/trimline/neutral/filled/line{
	dir = 4
	},
/obj/structure/sign/poster/contraband/random{
	pixel_x = 32
	},
/obj/machinery/light{
	dir = 4
	},
/obj/effect/decal/cleanable/dirt/dust,
/turf/open/floor/mineral/plastitanium,
/area/shuttle/syndicate_scout)
"AP" = (
/obj/effect/turf_decal/tile/neutral/tile_full,
/obj/item/kirbyplants/random,
/turf/open/floor/pod/dark,
/area/shuttle/syndicate_scout)
"AW" = (
/obj/effect/turf_decal/stripes/closeup{
	dir = 1
	},
/turf/open/floor/mineral/plastitanium/red,
/area/shuttle/syndicate_scout)
"By" = (
/obj/effect/turf_decal/trimline/brown/filled/line{
	dir = 6
	},
/obj/effect/turf_decal/trimline/brown/filled/line{
	dir = 6
	},
/obj/effect/turf_decal/box,
/obj/effect/turf_decal/arrows{
	dir = 1
	},
/obj/machinery/portable_atmospherics/canister/tritium,
/turf/open/floor/plasteel/techmaint,
/area/shuttle/syndicate_scout)
"BF" = (
/obj/structure/bed/pod,
/obj/machinery/shower{
	pixel_y = 15
	},
/obj/effect/decal/cleanable/vomit,
/turf/open/floor/pod,
/area/shuttle/syndicate_scout)
"BG" = (
/obj/effect/turf_decal/stripes/closeup,
/obj/effect/decal/cleanable/dirt,
/turf/open/floor/mineral/plastitanium,
/area/shuttle/syndicate_scout)
"BR" = (
/obj/effect/turf_decal/stripes/line{
	dir = 4
	},
/obj/effect/turf_decal/stripes/corner{
	dir = 6
	},
/turf/open/floor/mineral/plastitanium/red,
/area/shuttle/syndicate_scout)
"CN" = (
/obj/structure/toilet{
	pixel_y = 13
	},
/obj/machinery/light/small{
	dir = 8
	},
/obj/effect/decal/cleanable/dirt/dust,
/obj/effect/decal/cleanable/blood/old,
/obj/effect/decal/cleanable/cobweb,
/obj/effect/decal/cleanable/dirt/dust,
/obj/effect/decal/cleanable/dirt,
/turf/open/floor/plasteel/showroomfloor,
/area/shuttle/syndicate_scout)
"CZ" = (
/turf/closed/wall/r_wall/syndicate/nodiagonal,
/area/shuttle/syndicate_scout)
"Db" = (
/obj/effect/turf_decal/stripes/closeup,
/turf/open/floor/mineral/plastitanium,
/area/shuttle/syndicate_scout)
"Dq" = (
/obj/effect/turf_decal/tile/neutral/tile_full,
/obj/structure/chair/comfy/shuttle{
	dir = 8
	},
/obj/machinery/light,
/obj/effect/decal/cleanable/vomit/old,
/turf/open/floor/pod/dark,
/area/shuttle/syndicate_scout)
"Dx" = (
/obj/effect/turf_decal/trimline/brown/filled/warning{
	dir = 4
	},
/obj/effect/turf_decal/trimline/brown/filled/warning{
	dir = 4
	},
/obj/effect/decal/cleanable/dirt/dust,
/obj/machinery/atmospherics/pipe/simple/purple/visible{
	dir = 4
	},
/turf/open/floor/plasteel/techmaint,
/area/shuttle/syndicate_scout)
"DJ" = (
/obj/effect/turf_decal/tile/neutral/tile_full,
/obj/structure/bed/pod,
/obj/item/bedsheet/black,
/obj/item/toy/plush/renault{
	pixel_y = 4
	},
/obj/machinery/light{
	dir = 1
	},
/turf/open/floor/plasteel/techmaint,
/area/shuttle/syndicate_scout)
"Fy" = (
/obj/effect/turf_decal/stripes/line,
/obj/effect/turf_decal/bot_white,
/obj/structure/closet/syndicate/nuclear,
/obj/effect/decal/cleanable/dirt/dust,
/obj/effect/decal/cleanable/cobweb,
/turf/open/floor/mineral/plastitanium,
/area/shuttle/syndicate_scout)
"Hh" = (
/obj/effect/turf_decal/trimline/brown/filled/line{
	dir = 5
	},
/obj/effect/turf_decal/trimline/brown/filled/line{
	dir = 5
	},
/obj/effect/turf_decal/box,
/obj/effect/turf_decal/arrows,
/obj/structure/tank_dispenser/oxygen,
/turf/open/floor/plasteel/techmaint,
/area/shuttle/syndicate_scout)
"Hj" = (
/obj/machinery/light{
	dir = 4
	},
/obj/effect/turf_decal/tile/neutral{
	dir = 1
	},
/obj/structure/closet/crate,
/obj/item/stack/sheet/mineral/plastitanium{
	amount = 20
	},
/obj/item/storage/box/lights/bulbs,
/obj/item/stack/sheet/mineral/plasma{
	amount = 20
	},
/obj/item/stack/sheet/mineral/plasma{
	amount = 20
	},
/obj/effect/turf_decal/box,
/obj/effect/turf_decal/stripes/line,
/obj/effect/decal/cleanable/dirt/dust,
/obj/machinery/atmospherics/pipe/simple/purple/visible{
	dir = 10
	},
/turf/open/floor/plasteel/techmaint,
/area/shuttle/syndicate_scout)
"Ho" = (
/obj/structure/sink{
	dir = 4;
	pixel_x = 11;
	pixel_y = -2
	},
/obj/structure/mirror{
	pixel_x = 27
	},
/obj/effect/decal/cleanable/dirt/dust,
/obj/effect/decal/cleanable/dirt/dust,
/obj/effect/decal/cleanable/dirt/dust,
/turf/open/floor/plasteel/showroomfloor,
/area/shuttle/syndicate_scout)
"Ik" = (
/obj/effect/decal/cleanable/cobweb/cobweb2,
/obj/machinery/atmospherics/components/unary/portables_connector/visible{
	dir = 8
	},
/obj/item/wrench,
/obj/machinery/portable_atmospherics/canister/tritium,
/turf/open/floor/plasteel/techmaint,
/area/shuttle/syndicate_scout)
"IH" = (
/obj/effect/turf_decal/stripes/closeup,
/obj/machinery/atmospherics/pipe/simple/purple/visible{
	dir = 4
	},
/obj/machinery/door/airlock/hatch{
	req_access_txt = "150"
	},
/turf/open/floor/mineral/plastitanium/red,
/area/shuttle/syndicate_scout)
"IL" = (
/obj/effect/turf_decal/tile/neutral/tile_full,
/turf/open/floor/pod/dark,
/area/shuttle/syndicate_scout)
"JH" = (
/obj/machinery/porta_turret/syndicate/pod{
	dir = 9
	},
/turf/closed/wall/r_wall/syndicate,
/area/shuttle/syndicate_scout)
"KB" = (
/obj/effect/turf_decal/tile/neutral/tile_full,
/obj/effect/turf_decal/stripes/line{
	dir = 5
	},
/obj/machinery/computer/weapons,
/turf/open/floor/mineral/plastitanium,
/area/shuttle/syndicate_scout)
"KI" = (
/obj/machinery/atmospherics/pipe/simple/purple/visible{
	dir = 6
	},
/turf/closed/wall/r_wall/syndicate/nodiagonal,
/area/shuttle/syndicate_scout)
"Mz" = (
/obj/structure/bed/pod,
/obj/machinery/shower{
	pixel_y = 15
	},
/obj/effect/decal/cleanable/dirt/dust,
/obj/effect/decal/cleanable/dirt/dust,
/turf/open/floor/pod,
/area/shuttle/syndicate_scout)
"Nn" = (
/obj/effect/turf_decal/stripes/closeup,
/obj/effect/decal/cleanable/dirt/dust,
/turf/open/floor/mineral/plastitanium/red,
/area/shuttle/syndicate_scout)
"Pn" = (
/obj/effect/turf_decal/trimline/neutral/filled/line{
	dir = 8
	},
/obj/effect/decal/cleanable/dirt/dust,
/turf/open/floor/mineral/plastitanium,
/area/shuttle/syndicate_scout)
"Pz" = (
/obj/item/reagent_containers/food/snacks/canned/beans{
	pixel_x = -5;
	pixel_y = 3
	},
/obj/item/reagent_containers/food/snacks/canned/beans{
	pixel_x = 2;
	pixel_y = 3
	},
/obj/item/reagent_containers/food/snacks/canned/beans{
	pixel_x = -2
	},
/obj/item/reagent_containers/food/snacks/canned/beans{
	pixel_x = 5
	},
/obj/item/reagent_containers/food/snacks/canned/beans{
	pixel_x = 1;
	pixel_y = -3
	},
/obj/item/reagent_containers/food/snacks/canned/beans{
	pixel_x = 8;
	pixel_y = -3
	},
/obj/structure/closet/crate{
	name = "food crate"
	},
/obj/effect/turf_decal/stripes/line{
	dir = 6
	},
/obj/effect/turf_decal/tile/brown/tile_marquee,
/obj/effect/decal/cleanable/dirt/dust,
/obj/machinery/light{
	dir = 4
	},
/turf/open/floor/plasteel/dark,
/area/shuttle/syndicate_scout)
"PQ" = (
/obj/effect/turf_decal/stripes/closeup{
	dir = 1
	},
/obj/machinery/door/airlock/hatch{
	req_access_txt = "150"
	},
/turf/open/floor/mineral/plastitanium/red,
/area/shuttle/syndicate_scout)
"Qn" = (
/obj/effect/turf_decal/box,
/obj/effect/turf_decal/arrows,
/obj/effect/turf_decal/trimline/brown/filled/line{
	dir = 9
	},
/obj/effect/turf_decal/trimline/brown/filled/line{
	dir = 9
	},
/obj/machinery/portable_atmospherics/canister/toxins,
/turf/open/floor/plasteel/techmaint,
/area/shuttle/syndicate_scout)
"Rc" = (
/obj/effect/decal/cleanable/dirt/dust,
/obj/effect/decal/cleanable/dirt,
/obj/machinery/door/airlock/hatch{
	req_access_txt = "150"
	},
/turf/open/floor/plasteel/showroomfloor,
/area/shuttle/syndicate_scout)
"Sr" = (
/obj/effect/turf_decal/stripes/closeup,
/obj/machinery/atmospherics/pipe/simple/purple/visible{
	dir = 4
	},
/turf/open/floor/mineral/plastitanium/red,
/area/shuttle/syndicate_scout)
"Su" = (
/obj/machinery/door/airlock/security/glass{
	req_access_txt = "150"
	},
/turf/open/floor/pod,
/area/shuttle/syndicate_scout)
"SK" = (
/obj/structure/bed/pod,
/obj/machinery/shower{
	pixel_y = 15
	},
/obj/effect/decal/cleanable/dirt/dust,
/obj/item/toy/plush/moth,
/turf/open/floor/pod,
/area/shuttle/syndicate_scout)
"SU" = (
/obj/effect/turf_decal/stripes/closeup{
	dir = 4
	},
/turf/open/floor/mineral/plastitanium/red,
/area/shuttle/syndicate_scout)
"TA" = (
/obj/effect/decal/cleanable/dirt/dust,
/obj/machinery/atmospherics/pipe/manifold/purple/visible{
	dir = 8
	},
/turf/open/floor/plasteel/techmaint,
/area/shuttle/syndicate_scout)
"TT" = (
/obj/effect/turf_decal/stripes/line{
	dir = 5
	},
/obj/structure/closet/toolcloset,
/obj/effect/turf_decal/box,
/obj/item/stack/sheet/mineral/plastitanium{
	amount = 20
	},
/obj/item/stack/sheet/glass{
	amount = 10
	},
/obj/item/stack/sheet/iron/twenty,
/turf/open/floor/plasteel/techmaint,
/area/shuttle/syndicate_scout)
"Ux" = (
/obj/machinery/door/airlock/security/glass{
	req_access_txt = "150"
	},
/obj/effect/decal/cleanable/dirt/dust,
/turf/open/floor/pod,
/area/shuttle/syndicate_scout)
"UI" = (
/obj/effect/turf_decal/trimline/brown/filled/line{
	dir = 4
	},
/obj/effect/turf_decal/trimline/brown/filled/line{
	dir = 4
	},
/obj/effect/decal/cleanable/dirt/dust,
/obj/machinery/light/small{
	dir = 4
	},
/obj/machinery/button/door{
	id = "syndie_ptransport_cargo";
	name = "Cargo Shutters";
	pixel_x = 28
	},
/turf/open/floor/plasteel/techmaint,
/area/shuttle/syndicate_scout)
"UW" = (
/obj/effect/turf_decal/tile/neutral/tile_full,
/obj/effect/decal/cleanable/dirt/dust,
/turf/open/floor/plasteel/techmaint,
/area/shuttle/syndicate_scout)
"Vn" = (
/obj/structure/table/reinforced,
/obj/effect/turf_decal/tile/neutral/tile_full,
/obj/item/toy/figure/syndie{
	pixel_x = -9;
	pixel_y = 10
	},
/obj/item/taperecorder{
	pixel_x = -7;
	pixel_y = -1
	},
/obj/item/paper_bin{
	pixel_x = 5;
	pixel_y = 4
	},
/obj/item/pen{
	pixel_x = 5;
	pixel_y = 6
	},
/obj/effect/turf_decal/stripes/line{
	dir = 10
	},
/turf/open/floor/mineral/plastitanium,
/area/shuttle/syndicate_scout)
"Vt" = (
/obj/effect/turf_decal/stripes/red/line{
	dir = 8;
	icon_state = "warningline_red"
	},
/obj/effect/decal/cleanable/dirt/dust,
/obj/effect/decal/cleanable/dirt/dust,
/turf/open/floor/mineral/plastitanium,
/area/shuttle/syndicate_scout)
"VB" = (
/obj/structure/table/reinforced,
/obj/effect/turf_decal/stripes/corner{
	dir = 1
	},
/obj/item/storage/firstaid/tactical{
	pixel_x = 8;
	pixel_y = -5
	},
/obj/item/melee/powerfist{
	pixel_x = 6;
	pixel_y = 10
	},
/obj/effect/decal/cleanable/dirt/dust,
/obj/effect/decal/cleanable/dirt/dust,
/turf/open/floor/mineral/plastitanium,
/area/shuttle/syndicate_scout)
"Xu" = (
/obj/machinery/porta_turret/syndicate/pod{
	dir = 10
	},
/turf/closed/wall/r_wall/syndicate/nodiagonal,
/area/shuttle/syndicate_scout)
"XO" = (
/obj/effect/turf_decal/tile/neutral/tile_full,
/obj/structure/table/reinforced,
/obj/item/storage/fancy/cigarettes/cigpack_shadyjims{
	pixel_x = 9;
	pixel_y = 11
	},
/obj/item/flashlight/lamp{
	pixel_x = -1;
	pixel_y = 10
	},
/obj/item/paper_bin{
	pixel_x = -6;
	pixel_y = -1
	},
/obj/item/pen{
	pixel_x = -6
	},
/obj/item/lighter/greyscale{
	pixel_x = 10;
	pixel_y = 3
	},
/turf/open/floor/pod/dark,
/area/shuttle/syndicate_scout)
"Yg" = (
/obj/effect/turf_decal/trimline/neutral/filled/line{
	dir = 4
	},
/turf/open/floor/mineral/plastitanium,
/area/shuttle/syndicate_scout)
"Yk" = (
/obj/effect/turf_decal/tile/neutral/tile_full,
/obj/machinery/computer/arcade/orion_trail{
	dir = 4;
	pixel_x = -5
	},
/obj/structure/sign/poster/contraband/random{
	pixel_y = 32
	},
/turf/open/floor/pod/dark,
/area/shuttle/syndicate_scout)
"Zd" = (
/obj/effect/landmark/exploration_weapon_spawner{
	dir = 8
	},
/turf/closed/wall/r_wall/syndicate/nodiagonal,
/area/shuttle/syndicate_scout)

(1,1,1) = {"
xC
xC
xC
JH
hj
CZ
CZ
hj
hj
bS
xC
xC
xC
bS
CZ
kX
pK
CZ
bS
xC
xC
"}
(2,1,1) = {"
xC
bS
Zd
CZ
ui
CZ
Yk
XO
ok
CZ
CZ
CZ
CZ
CZ
Qn
kK
pJ
vx
CZ
Xu
xC
"}
(3,1,1) = {"
CZ
he
CZ
DJ
UW
PQ
rp
fX
Dq
CZ
SK
CZ
mj
CZ
Hh
UI
Dx
By
CZ
CZ
CZ
"}
(4,1,1) = {"
xC
xC
CZ
CZ
CZ
CZ
qh
Nn
IL
CZ
Ux
CZ
Su
CZ
CZ
CZ
IH
CZ
KI
kh
lp
"}
(5,1,1) = {"
xC
xC
hj
tB
Vn
CZ
CZ
Nn
AP
CZ
Pn
mY
dd
dd
uT
CZ
Sr
ps
mA
kh
lp
"}
(6,1,1) = {"
xC
xC
hj
vW
id
SU
PQ
BR
dL
PQ
AW
AW
AW
ah
dL
PQ
nA
TA
nh
kh
lp
"}
(7,1,1) = {"
xC
xC
hj
KB
SU
fk
CZ
wr
Db
CZ
Yg
yY
Yg
Yg
xD
CZ
TT
eL
qx
kh
lp
"}
(8,1,1) = {"
xC
xC
CZ
CZ
tp
CZ
CZ
yD
BG
CZ
pX
CZ
Su
CZ
tp
CZ
CZ
uc
Hj
kh
lp
"}
(9,1,1) = {"
CZ
Zd
CZ
Fy
Vt
dn
CZ
CZ
Rc
CZ
BF
CZ
Mz
CZ
de
ob
CZ
yV
cA
CZ
CZ
"}
(10,1,1) = {"
xC
bS
he
CZ
rE
VB
CZ
CN
Ho
CZ
CZ
CZ
CZ
CZ
co
Pz
CZ
Ik
CZ
nY
xC
"}
(11,1,1) = {"
xC
xC
xC
wI
CZ
CZ
CZ
CZ
CZ
bS
xC
xC
xC
bS
CZ
CZ
CZ
CZ
bS
xC
xC
"}
