//MAP CONVERTED BY dmm2tgm.py THIS HEADER COMMENT PREVENTS RECONVERSION, DO NOT REMOVE
"a" = (
/obj/effect/decal/cleanable/dirt,
/obj/structure/sink{
	dir = 8;
	pixel_x = -12;
	pixel_y = 2
	},
/turf/open/floor/plasteel,
/area/template_noop)
"b" = (
/obj/effect/decal/cleanable/dirt,
/turf/open/floor/plasteel,
/area/template_noop)
"c" = (
/obj/structure/table,
/obj/item/retractor,
/obj/item/hemostat,
/obj/item/healthanalyzer,
/obj/item/clothing/glasses/eyepatch,
/obj/item/reagent_containers/food/drinks/bottle/vodka{
	pixel_x = 3;
	pixel_y = 2
	},
/obj/effect/decal/cleanable/cobweb/cobweb2,
/obj/effect/decal/cleanable/dirt,
/turf/open/floor/plasteel,
/area/template_noop)
"d" = (
/obj/effect/decal/cleanable/dirt,
/obj/effect/decal/cleanable/blood/gibs/old,
/turf/open/floor/plasteel,
/area/template_noop)
"e" = (
/obj/effect/decal/cleanable/oil,
/obj/effect/decal/cleanable/dirt,
/turf/open/floor/plasteel,
/area/template_noop)
"f" = (
/obj/structure/table,
/obj/item/reagent_containers/glass/beaker{
	pixel_x = 8;
	pixel_y = 2
	},
/obj/item/reagent_containers/blood,
/obj/item/reagent_containers/blood,
/obj/item/reagent_containers/syringe,
/obj/item/reagent_containers/dropper,
/obj/effect/decal/cleanable/dirt,
/turf/open/floor/plasteel,
/area/template_noop)
"h" = (
/turf/open/floor/plating,
/area/template_noop)
"i" = (
/obj/item/clothing/gloves/color/latex/nitrile,
/obj/structure/rack,
/obj/item/clothing/suit/toggle/labcoat,
/obj/item/clothing/suit/apron/surgical,
/obj/item/clothing/mask/surgical,
/obj/item/clothing/mask/breath/medical,
/turf/open/floor/plating{
	icon_state = "platingdmg2"
	},
/area/template_noop)

(1,1,1) = {"
a
d
f
"}
(2,1,1) = {"
b
e
h
"}
(3,1,1) = {"
c
h
i
"}
