//MAP CONVERTED BY dmm2tgm.py THIS HEADER COMMENT PREVENTS RECONVERSION, DO NOT REMOVE
"e" = (
/obj/structure/chair/stool/bar,
/turf/open/floor/wood{
	broken = 1
	},
/area/template_noop)
"f" = (
/obj/effect/decal/cleanable/blood/gibs/old,
/obj/effect/decal/cleanable/blood/old,
/turf/open/floor/wood,
/area/template_noop)
"h" = (
/obj/effect/decal/cleanable/blood/old,
/turf/open/floor/wood,
/area/template_noop)
"q" = (
/obj/structure/table/wood,
/obj/effect/decal/cleanable/cobweb,
/obj/item/toy/katana,
/obj/item/clothing/shoes/sandal,
/obj/effect/decal/cleanable/dirt,
/obj/structure/mirror{
	pixel_y = 26
	},
/obj/effect/turf_decal/tile/neutral,
/turf/open/floor/iron/dark,
/area/template_noop)
"u" = (
/obj/effect/turf_decal/tile/neutral/half/contrasted,
/turf/open/floor/iron/dark,
/area/template_noop)
"J" = (
/obj/effect/decal/cleanable/dirt,
/obj/effect/turf_decal/tile/neutral/half/contrasted{
	dir = 8
	},
/turf/open/floor/iron/dark,
/area/template_noop)
"Q" = (
/obj/machinery/vending/autodrobe/all_access,
/obj/structure/noticeboard{
	dir = 4;
	pixel_x = -27
	},
/obj/effect/decal/cleanable/dirt,
/obj/effect/turf_decal/tile/neutral/half/contrasted,
/turf/open/floor/iron/dark,
/area/template_noop)
"S" = (
/obj/structure/dresser,
/obj/effect/decal/cleanable/cobweb/cobweb2,
/obj/effect/decal/cleanable/dirt,
/obj/effect/turf_decal/tile/neutral/half/contrasted{
	dir = 8
	},
/turf/open/floor/iron/dark,
/area/template_noop)
"Z" = (
/obj/structure/table/wood,
/obj/item/clothing/shoes/jackboots,
/obj/item/clothing/glasses/eyepatch{
	pixel_y = 5
	},
/obj/effect/decal/cleanable/dirt,
/obj/machinery/light/small{
	dir = 4
	},
/obj/effect/turf_decal/tile/neutral/half/contrasted{
	dir = 8
	},
/turf/open/floor/iron/dark,
/area/template_noop)

(1,1,1) = {"
q
u
Q
"}
(2,1,1) = {"
J
e
h
"}
(3,1,1) = {"
S
f
Z
"}
