//MAP CONVERTED BY dmm2tgm.py THIS HEADER COMMENT PREVENTS RECONVERSION, DO NOT REMOVE
"a" = (
/obj/effect/decal/cleanable/glitter/pink,
/turf/open/floor/plating,
/area/template_noop)
"b" = (
/obj/item/stack/sheet/iron,
/obj/item/stack/cable_coil/cut,
/obj/effect/decal/cleanable/glitter/pink,
/turf/open/floor/plating,
/area/template_noop)
"c" = (
/obj/machinery/igniter,
/obj/effect/decal/cleanable/glitter/pink,
/turf/open/floor/plating,
/area/template_noop)

(1,1,1) = {"
a
a
a
"}
(2,1,1) = {"
a
c
a
"}
(3,1,1) = {"
b
a
a
"}
