//MAP CONVERTED BY dmm2tgm.py THIS HEADER COMMENT PREVENTS RECONVERSION, DO NOT REMOVE
"a" = (
/obj/effect/decal/cleanable/dirt/dust{
	dir = 4
	},
/turf/open/floor/mineral/plastitanium/red,
/area/template_noop)
"b" = (
/obj/effect/decal/hammerandsickle{
	dir = 4
	},
/obj/effect/decal/cleanable/dirt/dust{
	dir = 4
	},
/turf/open/floor/mineral/plastitanium/red,
/area/template_noop)
"c" = (
/obj/effect/decal/cleanable/dirt/dust{
	dir = 4
	},
/obj/machinery/light/small/built{
	icon_state = "bulb-empty";
	dir = 8
	},
/turf/open/floor/mineral/plastitanium/red,
/area/template_noop)
"d" = (
/obj/structure/closet/crate{
	dir = 1
	},
/obj/item/clothing/under/costume/soviet{
	dir = 1
	},
/obj/item/clothing/under/costume/soviet{
	dir = 1
	},
/obj/item/clothing/under/costume/soviet{
	dir = 1
	},
/obj/item/clothing/shoes/jackboots{
	dir = 1
	},
/obj/item/clothing/shoes/jackboots{
	dir = 1
	},
/obj/item/clothing/shoes/jackboots{
	dir = 1
	},
/obj/item/clothing/head/ushanka{
	dir = 1
	},
/obj/item/clothing/head/ushanka{
	dir = 1
	},
/obj/item/clothing/head/ushanka{
	dir = 1
	},
/obj/effect/decal/cleanable/dirt/dust{
	dir = 4
	},
/obj/machinery/light/small/broken{
	icon_state = "bulb-broken";
	dir = 4
	},
/turf/open/floor/mineral/plastitanium/red,
/area/template_noop)

(1,1,1) = {"
a
a
c"}(2,1,1) = {"
a
b
a"}(3,1,1) = {"
d
a
a"}