"a" = (/obj/structure/flora/tree/jungle/small,/turf/open/floor/grass,/area/template_noop)
"b" = (/turf/open/floor/grass,/area/template_noop)
"c" = (/obj/structure/flora/ausbushes/sparsegrass,/turf/open/floor/grass,/area/template_noop)
"d" = (/mob/living/simple_animal/pet/gondola,/turf/open/floor/grass,/area/template_noop)
"e" = (/obj/structure/flora/ausbushes/sunnybush,/turf/open/floor/grass,/area/template_noop)

(1,1,1) = {"
abb
bbc
bde
"}
