//MAP CONVERTED BY dmm2tgm.py THIS HEADER COMMENT PREVENTS RECONVERSION, DO NOT REMOVE
"a" = (
/obj/structure/mopbucket,
/obj/effect/decal/cleanable/dirt,
/obj/item/mop,
/turf/open/floor/plating,
/area/template_noop)
"b" = (
/obj/effect/decal/cleanable/dirt,
/turf/open/floor/plating,
/area/template_noop)
"c" = (
/obj/structure/sink/kitchen{
	desc = "A sink used for washing one's hands and face. It looks rusty and home-made";
	name = "old sink";
	pixel_y = 28
	},
/obj/item/reagent_containers/glass/bucket,
/turf/open/floor/plating,
/area/template_noop)
"d" = (
/obj/effect/decal/cleanable/dirt,
/obj/effect/turf_decal/tile/green{
	dir = 1
	},
/obj/effect/turf_decal/tile/green{
	dir = 8
	},
/turf/open/floor/plasteel,
/area/template_noop)
"e" = (
/obj/effect/decal/cleanable/dirt,
/obj/effect/turf_decal/tile/neutral,
/obj/effect/turf_decal/tile/neutral{
	dir = 4
	},
/turf/open/floor/plasteel,
/area/template_noop)
"f" = (
/obj/effect/decal/cleanable/dirt,
/obj/effect/decal/cleanable/dirt,
/obj/effect/turf_decal/tile/purple,
/obj/effect/turf_decal/tile/purple{
	dir = 4
	},
/turf/open/floor/plasteel,
/area/template_noop)
"g" = (
/obj/structure/reagent_dispensers/watertank,
/obj/effect/decal/cleanable/dirt,
/turf/open/floor/plating,
/area/template_noop)
"h" = (
/obj/effect/decal/cleanable/dirt,
/obj/effect/turf_decal/tile/green,
/obj/effect/turf_decal/tile/green{
	dir = 8
	},
/turf/open/floor/plasteel,
/area/template_noop)
"i" = (
/obj/effect/decal/cleanable/dirt,
/obj/effect/turf_decal/tile/green,
/obj/effect/turf_decal/tile/green{
	dir = 4
	},
/obj/effect/turf_decal/tile/green{
	dir = 8
	},
/obj/item/clothing/gloves/color/orange,
/obj/item/storage/box/lights/mixed,
/obj/item/storage/box/mousetraps{
	pixel_x = 3;
	pixel_y = 3
	},
/obj/item/grenade/chem_grenade/cleaner,
/obj/structure/table,
/turf/open/floor/plasteel,
/area/template_noop)

(1,1,1) = {"
a
d
g
"}
(2,1,1) = {"
b
e
h
"}
(3,1,1) = {"
c
f
i
"}
