//MAP CONVERTED BY dmm2tgm.py THIS HEADER COMMENT PREVENTS RECONVERSION, DO NOT REMOVE
"a" = (
/obj/structure/mopbucket,
/obj/effect/decal/cleanable/dirt,
/obj/item/mop,
/turf/open/floor/plating,
/area/template_noop)
"b" = (
/obj/effect/decal/cleanable/dirt,
/turf/open/floor/plating,
/area/template_noop)
"c" = (
/obj/structure/sink/kitchen{
	desc = "A sink used for washing one's hands and face. It looks rusty and home-made";
	name = "old sink";
	pixel_y = 28
	},
/obj/item/reagent_containers/cup/bucket,
/turf/open/floor/plating,
/area/template_noop)
"g" = (
/obj/structure/reagent_dispensers/watertank,
/obj/effect/decal/cleanable/dirt,
/turf/open/floor/plating,
/area/template_noop)
"I" = (
/obj/effect/decal/cleanable/dirt,
/obj/effect/turf_decal/tile/neutral/half/contrasted,
/turf/open/floor/iron,
/area/template_noop)
"J" = (
/obj/effect/decal/cleanable/dirt,
/obj/effect/decal/cleanable/dirt,
/obj/effect/turf_decal/tile/purple/half/contrasted,
/turf/open/floor/iron,
/area/template_noop)
"K" = (
/obj/effect/decal/cleanable/dirt,
/obj/effect/turf_decal/tile/green/half/contrasted{
	dir = 1
	},
/turf/open/floor/iron,
/area/template_noop)
"L" = (
/obj/effect/decal/cleanable/dirt,
/obj/effect/turf_decal/tile/green/half/contrasted{
	dir = 8
	},
/turf/open/floor/iron,
/area/template_noop)
"M" = (
/obj/effect/decal/cleanable/dirt,
/obj/item/clothing/gloves/color/orange,
/obj/item/storage/box/lights/mixed,
/obj/item/storage/box/mousetraps{
	pixel_x = 3;
	pixel_y = 3
	},
/obj/item/grenade/chem_grenade/cleaner,
/obj/structure/table,
/obj/effect/turf_decal/tile/green/anticorner/contrasted,
/turf/open/floor/iron,
/area/template_noop)

(1,1,1) = {"
a
K
g
"}
(2,1,1) = {"
b
I
L
"}
(3,1,1) = {"
c
J
M
"}
