//MAP CONVERTED BY dmm2tgm.py THIS HEADER COMMENT PREVENTS RECONVERSION, DO NOT REMOVE
"a" = (
/turf/open/floor/plating,
/area/template_noop)
"b" = (
/obj/machinery/portable_atmospherics/canister{
	dir = 1
	},
/obj/machinery/atmospherics/components/unary/portables_connector{
	dir = 1
	},
/obj/item/wrench{
	dir = 1
	},
/obj/effect/turf_decal/stripes/box{
	dir = 4
	},
/turf/open/floor/plating,
/area/template_noop)
"c" = (
/obj/machinery/atmospherics/pipe/simple/general{
	icon_state = "pipe11-2";
	dir = 8
	},
/obj/machinery/meter{
	dir = 1
	},
/turf/open/floor/plating,
/area/template_noop)
"d" = (
/obj/machinery/atmospherics/components/unary/tank/air{
	dir = 8
	},
/obj/machinery/light{
	icon_state = "tube";
	dir = 4
	},
/turf/open/floor/plating,
/area/template_noop)
"e" = (
/obj/machinery/atmospherics/components/binary/valve{
	dir = 1
	},
/turf/open/floor/plating,
/area/template_noop)
"f" = (
/obj/machinery/atmospherics/pipe/simple/general{
	icon_state = "pipe11-2";
	dir = 6
	},
/turf/open/floor/plating,
/area/template_noop)

(1,1,1) = {"
f
e
b"}(2,1,1) = {"
c
a
a"}(3,1,1) = {"
d
a
a"}