//MAP CONVERTED BY dmm2tgm.py THIS HEADER COMMENT PREVENTS RECONVERSION, DO NOT REMOVE
"a" = (
/obj/structure/bookcase/random,
/turf/open/floor/carpet/green,
/area/template_noop)
"e" = (
/obj/item/kirbyplants{
	icon_state = "plant-21"
	},
/obj/effect/turf_decal/stripes/corner{
	dir = 4
	},
/obj/effect/turf_decal/stripes/corner{
	dir = 8
	},
/turf/open/floor/wood{
	icon_state = "wood-broken7"
	},
/area/template_noop)
"u" = (
/obj/effect/decal/cleanable/dirt,
/obj/structure/fluff/paper{
	dir = 5
	},
/obj/structure/fluff/paper/stack{
	dir = 1
	},
/turf/open/floor/carpet/green,
/area/template_noop)
"D" = (
/obj/structure/sign/painting/library{
	pixel_y = 32
	},
/obj/machinery/light/small{
	dir = 1;
	icon_state = "bulb"
	},
/obj/effect/decal/cleanable/dirt,
/obj/effect/turf_decal/stripes/line{
	dir = 8
	},
/obj/structure/fluff/paper/stack{
	dir = 8
	},
/turf/open/floor/carpet/green,
/area/template_noop)
"Q" = (
/obj/structure/fluff/paper/corner{
	dir = 1
	},
/turf/open/floor/carpet/green,
/area/template_noop)
"R" = (
/obj/effect/decal/cleanable/dirt,
/obj/effect/decal/cleanable/blood/old,
/obj/structure/fluff/paper{
	dir = 1
	},
/obj/effect/turf_decal/stripes/line{
	dir = 4
	},
/turf/open/floor/carpet/green,
/area/template_noop)
"U" = (
/obj/effect/decal/cleanable/dirt,
/obj/effect/turf_decal/stripes/line,
/obj/structure/fluff/paper/stack{
	dir = 9
	},
/turf/open/floor/carpet/green,
/area/template_noop)
"W" = (
/turf/closed/wall,
/area/template_noop)

(1,1,1) = {"
W
D
a
"}
(2,1,1) = {"
u
Q
U
"}
(3,1,1) = {"
a
R
e
"}
