"a" = (/obj/effect/decal/cleanable/glitter/pink,/turf/open/floor/plating,/area/template_noop)
"b" = (/obj/item/stack/sheet/iron,/obj/item/stack/cable_coil/cut,/obj/effect/decal/cleanable/glitter/pink,/turf/open/floor/plating,/area/template_noop)
"c" = (/obj/machinery/igniter,/obj/effect/decal/cleanable/glitter/pink,/turf/open/floor/plating,/area/template_noop)

(1,1,1) = {"
aab
aca
aaa
"}
