//MAP CONVERTED BY dmm2tgm.py THIS HEADER COMMENT PREVENTS RECONVERSION, DO NOT REMOVE
"a" = (
/turf/open/floor/plating/asteroid/airless,
/area/template_noop)
"b" = (
/obj/effect/decal/cleanable/blood/footprints{
	dir = 8
	},
/obj/effect/decal/cleanable/blood/footprints,
/turf/open/floor/plating/asteroid/airless,
/area/template_noop)
"e" = (
/obj/machinery/smartfridge/survival_pod/empty,
/turf/open/floor/pod/dark,
/area/template_noop)
"f" = (
/obj/effect/decal/cleanable/blood/footprints{
	dir = 8
	},
/obj/effect/decal/cleanable/blood/drip,
/turf/open/floor/plating/asteroid/airless,
/area/template_noop)
"h" = (
/turf/closed/wall/mineral/titanium/survival/pod,
/area/template_noop)
"i" = (
/obj/item/gps/computer,
/obj/structure/tubes,
/turf/open/floor/pod/dark,
/area/template_noop)
"j" = (
/obj/effect/decal/cleanable/blood/footprints,
/obj/effect/decal/cleanable/blood/drip,
/turf/open/floor/plating/asteroid/airless,
/area/template_noop)
"r" = (
/obj/effect/decal/cleanable/blood/drip,
/turf/open/floor/plating/asteroid/airless,
/area/template_noop)
"s" = (
/obj/item/pickaxe,
/obj/effect/decal/cleanable/blood,
/turf/open/floor/pod/dark,
/area/template_noop)
"t" = (
/obj/structure/sign/mining{
	pixel_y = 32
	},
/obj/effect/decal/cleanable/blood/footprints{
	dir = 8
	},
/turf/open/floor/plating/asteroid/airless,
/area/template_noop)
"v" = (
/obj/structure/bed/pod,
/obj/item/bedsheet/black,
/obj/structure/tubes,
/obj/machinery/light/small{
	dir = 4
	},
/turf/open/floor/pod/dark,
/area/template_noop)
"w" = (
/obj/structure/sign/mining/survival{
	dir = 4;
	pixel_x = 32
	},
/turf/open/floor/plating/asteroid/airless,
/area/template_noop)
"x" = (
/obj/structure/sign/mining/survival{
	pixel_y = -32
	},
/turf/open/floor/plating/asteroid/airless,
/area/template_noop)
"z" = (
/obj/structure/sign/mining/survival{
	pixel_y = 32
	},
/turf/open/floor/plating/asteroid/airless,
/area/template_noop)
"B" = (
/obj/structure/sign/mining/survival{
	dir = 8;
	pixel_x = -32
	},
/turf/open/floor/plating/asteroid/airless,
/area/template_noop)
"C" = (
/obj/structure/table/survival_pod,
/obj/item/kitchen/knife/combat/survival,
/turf/open/floor/pod/dark,
/area/template_noop)
"D" = (
/obj/effect/decal/cleanable/blood,
/turf/open/floor/plating/asteroid/airless,
/area/template_noop)
"E" = (
/obj/effect/decal/cleanable/blood/footprints{
	dir = 8
	},
/turf/open/floor/plating/asteroid/airless,
/area/template_noop)
"J" = (
/obj/structure/fans,
/turf/open/floor/pod/dark,
/area/template_noop)
"L" = (
/obj/effect/decal/cleanable/blood,
/mob/living/simple_animal/hostile/asteroid/goliath/beast{
	health = 0
	},
/turf/open/floor/plating/asteroid/airless,
/area/template_noop)
"M" = (
/obj/effect/decal/cleanable/blood/drip,
/obj/effect/decal/cleanable/blood/footprints{
	dir = 1
	},
/turf/open/floor/plating/asteroid/airless,
/area/template_noop)
"O" = (
/obj/machinery/sleeper/survival_pod,
/turf/open/floor/pod/dark,
/area/template_noop)
"S" = (
/obj/structure/tubes,
/obj/item/crowbar,
/obj/effect/decal/cleanable/blood/drip,
/turf/open/floor/pod/dark,
/area/template_noop)
"W" = (
/turf/template_noop,
/area/template_noop)
"X" = (
/obj/effect/decal/cleanable/blood/footprints{
	dir = 1
	},
/obj/machinery/door/airlock/survival_pod/glass,
/turf/open/floor/pod/dark,
/area/template_noop)
"Y" = (
/obj/effect/decal/cleanable/blood/footprints,
/turf/open/floor/plating/asteroid/airless,
/area/template_noop)
"Z" = (
/obj/effect/mob_spawn/human/miner/explorer{
	brute_damage = 150;
	oxy_damage = 50
	},
/obj/effect/decal/cleanable/blood,
/obj/effect/decal/cleanable/blood/drip,
/obj/effect/decal/cleanable/blood/footprints{
	dir = 1
	},
/turf/open/floor/pod/dark,
/area/template_noop)

(1,1,1) = {"
W
W
W
a
a
a
a
a
W
W
W
"}
(2,1,1) = {"
W
W
a
a
w
a
w
a
a
W
W
"}
(3,1,1) = {"
W
W
a
h
h
h
h
h
a
W
W
"}
(4,1,1) = {"
W
a
x
h
J
O
C
h
z
a
a
"}
(5,1,1) = {"
W
a
a
h
e
s
Z
X
M
a
a
"}
(6,1,1) = {"
a
a
x
h
i
v
S
h
t
a
a
"}
(7,1,1) = {"
W
a
a
h
h
h
h
h
E
r
r
"}
(8,1,1) = {"
W
W
a
a
B
a
B
f
j
a
a
"}
(9,1,1) = {"
W
W
a
a
r
D
Y
b
W
W
W
"}
(10,1,1) = {"
W
W
W
W
W
L
r
a
W
W
W
"}
