//MAP CONVERTED BY dmm2tgm.py THIS HEADER COMMENT PREVENTS RECONVERSION, DO NOT REMOVE
"a" = (
/turf/open/space/basic,
/area/space)
"b" = (
/turf/open/floor/plating,
/area/template_noop)
"c" = (
/obj/machinery/light{
	dir = 1
	},
/turf/open/floor/plating,
/area/template_noop)
"d" = (
/obj/structure/closet/crate/science,
/obj/item/circuitboard/computer/shuttle/docker,
/obj/item/circuitboard/computer/shuttle/flight_control,
/obj/item/circuitboard/machine/shuttle/heater,
/obj/item/circuitboard/machine/shuttle/engine/plasma,
/obj/item/shuttle_creator,
/obj/item/circuitboard/machine/shuttle/engine/plasma,
/obj/item/circuitboard/machine/shuttle/heater,
/obj/item/pipe_dispenser,
/turf/open/floor/plating,
/area/template_noop)
"e" = (
/obj/structure/window/reinforced/spawner,
/obj/structure/rack,
/obj/item/stack/sheet/glass/fifty,
/turf/open/floor/plating,
/area/template_noop)
"f" = (
/obj/structure/window/reinforced/spawner,
/obj/structure/rack,
/obj/item/stack/sheet/iron/fifty,
/turf/open/floor/plating,
/area/template_noop)
"g" = (
/obj/machinery/door/window,
/obj/machinery/door/window/northleft,
/obj/structure/window/reinforced/spawner/east,
/obj/structure/window/reinforced/spawner/west,
/turf/open/floor/plating,
/area/template_noop)
"h" = (
/obj/machinery/door/airlock/external/glass,
/turf/open/floor/plating,
/area/template_noop)
"i" = (
/obj/structure/window/reinforced/spawner,
/obj/structure/window/reinforced/spawner/west,
/obj/structure/rack,
/obj/item/stack/cable_coil/random,
/obj/item/stack/cable_coil/random,
/obj/item/storage/toolbox/electrical,
/turf/open/floor/plating,
/area/template_noop)
"j" = (
/obj/structure/window/reinforced/spawner,
/obj/structure/rack,
/obj/item/stack/rods,
/obj/item/stack/rods,
/turf/open/floor/plating,
/area/template_noop)
"k" = (
/obj/machinery/portable_atmospherics/canister/oxygen,
/turf/open/floor/plating,
/area/template_noop)
"l" = (
/obj/structure/window/reinforced/spawner/east,
/obj/structure/closet/secure_closet/chemical,
/turf/open/floor/plating,
/area/template_noop)
"m" = (
/obj/structure/lattice,
/turf/open/space/basic,
/area/space)
"n" = (
/obj/structure/window/reinforced/spawner/west,
/obj/machinery/portable_atmospherics/canister/air,
/turf/open/floor/plating,
/area/template_noop)
"o" = (
/obj/machinery/light{
	dir = 8
	},
/turf/open/floor/plating,
/area/template_noop)
"p" = (
/obj/structure/window/reinforced/spawner/east,
/obj/structure/table,
/obj/effect/spawner/lootdrop/maintenance/five,
/turf/open/floor/plating,
/area/template_noop)
"q" = (
/obj/structure/window/reinforced/spawner/west,
/obj/structure/table,
/obj/effect/spawner/lootdrop/maintenance/eight,
/turf/open/floor/plating,
/area/template_noop)
"r" = (
/obj/machinery/light{
	dir = 4
	},
/turf/open/floor/plating,
/area/template_noop)
"s" = (
/obj/structure/window/reinforced/spawner/east,
/obj/structure/table,
/obj/effect/spawner/lootdrop/maintenance/two,
/turf/open/floor/plating,
/area/template_noop)
"t" = (
/obj/structure/window/reinforced/spawner/west,
/obj/structure/table,
/obj/effect/spawner/lootdrop/maintenance/two,
/turf/open/floor/plating,
/area/template_noop)
"u" = (
/obj/structure/window/reinforced/spawner/east,
/obj/structure/table,
/obj/item/storage/toolbox/mechanical,
/turf/open/floor/plating,
/area/template_noop)
"v" = (
/obj/structure/window/reinforced/spawner/west,
/obj/structure/table,
/obj/item/electronics/airlock,
/obj/item/electronics/airlock,
/obj/item/electronics/airlock,
/obj/item/airlock_painter,
/turf/open/floor/plating,
/area/template_noop)
"w" = (
/obj/structure/window/reinforced/spawner/east,
/obj/structure/table,
/obj/effect/spawner/lootdrop/maintenance/seven,
/turf/open/floor/plating,
/area/template_noop)
"x" = (
/obj/structure/window/reinforced/spawner/west,
/obj/structure/table,
/obj/effect/spawner/lootdrop/maintenance,
/turf/open/floor/plating,
/area/template_noop)
"y" = (
/obj/structure/window/reinforced/spawner/east,
/obj/machinery/portable_atmospherics/scrubber,
/turf/open/floor/plating,
/area/template_noop)
"z" = (
/obj/structure/window/reinforced/spawner/west,
/obj/machinery/portable_atmospherics/canister/toxins,
/turf/open/floor/plating,
/area/template_noop)
"A" = (
/obj/structure/window/reinforced/spawner/north,
/turf/open/floor/plating,
/area/template_noop)
"B" = (
/obj/machinery/light,
/turf/open/floor/plating,
/area/template_noop)

(1,1,1) = {"
b
b
b
o
b
b
o
b
b
b
"}
(2,1,1) = {"
b
d
l
p
s
u
w
y
b
b
"}
(3,1,1) = {"
b
e
a
m
a
a
m
a
A
b
"}
(4,1,1) = {"
c
f
m
m
m
m
m
m
A
B
"}
(5,1,1) = {"
b
g
a
m
a
a
m
a
A
b
"}
(6,1,1) = {"
b
h
a
m
a
a
m
a
A
b
"}
(7,1,1) = {"
c
i
m
m
m
m
m
m
A
B
"}
(8,1,1) = {"
b
j
a
m
a
a
m
a
A
b
"}
(9,1,1) = {"
b
k
n
q
t
v
x
z
b
b
"}
(10,1,1) = {"
b
b
b
r
b
b
r
b
b
b
"}
