//MAP CONVERTED BY dmm2tgm.py THIS HEADER COMMENT PREVENTS RECONVERSION, DO NOT REMOVE
"aO" = (
/obj/structure/bookcase/random,
/turf/open/floor/carpet/blue,
/area/space)
"bI" = (
/obj/structure/chair/sofa/right{
	dir = 1
	},
/turf/open/floor/carpet/blue,
/area/space)
"bN" = (
/obj/machinery/door/airlock/wood,
/turf/open/floor/plasteel/white,
/area/space)
"cl" = (
/obj/effect/decal/cleanable/dirt/dust,
/obj/structure/sign/poster/contraband/sun_kist{
	pixel_x = 30
	},
/turf/open/floor/plasteel/white,
/area/space)
"ec" = (
/obj/structure/table/wood,
/obj/item/paper_bin{
	pixel_y = 6
	},
/obj/item/pen,
/obj/item/pen/red,
/obj/item/taperecorder{
	pixel_x = 9
	},
/obj/machinery/button/flasher{
	id = "sanitarium2";
	pixel_x = -25;
	pixel_y = 5
	},
/obj/machinery/button/door{
	id = "sanitarium2";
	name = "Therapy Room Bolt Control";
	normaldoorcontrol = 1;
	pixel_x = -25;
	pixel_y = -5;
	specialfunctions = 4
	},
/obj/structure/sign/poster/contraband/ambrosia_vulgaris{
	pixel_y = 30
	},
/obj/item/reagent_containers/spray/cleaner{
	pixel_x = -12
	},
/turf/open/floor/carpet/blue,
/area/space)
"eX" = (
/obj/structure/table/reinforced,
/obj/item/healthanalyzer,
/turf/open/floor/plasteel/white,
/area/space)
"fJ" = (
/obj/effect/decal/cleanable/dirt/dust,
/obj/effect/decal/cleanable/blood,
/turf/open/floor/carpet/cyan,
/area/space)
"gK" = (
/obj/item/bedsheet,
/obj/structure/bed,
/obj/structure/curtain,
/obj/structure/sign/poster/official/no_erp{
	pixel_x = 30
	},
/turf/open/floor/carpet/cyan,
/area/space)
"gO" = (
/obj/item/chair,
/obj/effect/decal/cleanable/dirt/dust,
/obj/structure/sign/poster/official/do_not_question{
	pixel_x = -30
	},
/turf/open/floor/plating,
/area/space)
"iK" = (
/obj/structure/disposalpipe/segment,
/obj/effect/decal/cleanable/dirt/dust,
/obj/structure/sign/poster/official/obey{
	pixel_x = 30
	},
/obj/effect/decal/remains/human,
/turf/open/floor/plating,
/area/space)
"iY" = (
/obj/structure/disposalpipe/segment,
/obj/effect/decal/cleanable/dirt/dust,
/obj/effect/decal/cleanable/blood/tracks,
/obj/effect/decal/cleanable/blood/gibs/up,
/obj/structure/sign/warning{
	pixel_x = -30
	},
/turf/open/floor/plating,
/area/space)
"jc" = (
/obj/effect/decal/cleanable/dirt/dust,
/turf/open/floor/plasteel/white,
/area/space)
"jT" = (
/obj/machinery/light/small{
	dir = 4
	},
/obj/structure/sign/poster/official/soft_cap_pop_art{
	pixel_x = -30
	},
/turf/open/floor/plasteel/white,
/area/space)
"jY" = (
/obj/structure/sign/poster/official/nanomichi_ad{
	pixel_y = -30
	},
/turf/open/floor/carpet/blue,
/area/space)
"lF" = (
/turf/open/floor/carpet/blue,
/area/space)
"lL" = (
/obj/effect/decal/cleanable/dirt/dust,
/turf/open/floor/carpet/cyan,
/area/space)
"ml" = (
/obj/structure/table/wood,
/obj/item/storage/pill_bottle/happiness{
	pixel_x = 8;
	pixel_y = 3
	},
/obj/item/paper_bin{
	pixel_x = -4
	},
/obj/item/pen,
/turf/open/floor/carpet/blue,
/area/space)
"mV" = (
/turf/open/floor/plasteel/white,
/area/space)
"ni" = (
/obj/effect/decal/cleanable/dirt/dust,
/turf/open/floor/carpet/blue,
/area/space)
"nO" = (
/obj/machinery/light,
/obj/structure/sign/warning/nosmoking/circle{
	pixel_y = -30
	},
/turf/open/floor/carpet/blue,
/area/space)
"pk" = (
/obj/structure/chair/sofa/left,
/turf/open/floor/carpet/blue,
/area/space)
"ql" = (
/obj/structure/table/reinforced,
/obj/item/folder/blue,
/obj/item/storage/pill_bottle/mannitol,
/obj/effect/decal/cleanable/dirt/dust,
/turf/open/floor/plasteel/white,
/area/space)
"sc" = (
/obj/machinery/door/airlock/wood{
	id_tag = "sanitarium2"
	},
/turf/open/floor/plasteel/white,
/area/space)
"st" = (
/obj/machinery/door/airlock/wood,
/turf/open/floor/plating,
/area/space)
"sz" = (
/obj/structure/disposalpipe/trunk{
	dir = 1
	},
/obj/structure/sign/poster/official/no_erp{
	pixel_y = -30
	},
/obj/effect/decal/cleanable/blood/gibs/old,
/turf/open/floor/plating,
/area/space)
"tz" = (
/obj/structure/chair/sofa/corner{
	dir = 8
	},
/turf/open/floor/carpet/blue,
/area/space)
"uS" = (
/obj/structure/chair/office,
/obj/effect/landmark/start/randommaint/shrink,
/turf/open/floor/carpet/blue,
/area/space)
"yb" = (
/obj/effect/spawner/structure/window/reinforced,
/turf/open/floor/plasteel/white,
/area/space)
"yM" = (
/obj/structure/sign/poster/contraband/clown{
	pixel_y = -30
	},
/turf/open/floor/carpet/blue,
/area/space)
"yQ" = (
/obj/machinery/door/airlock/maintenance_hatch{
	id_tag = "sanitarium1";
	name = "sanitarium"
	},
/obj/structure/disposalpipe/segment,
/obj/effect/decal/cleanable/blood/tracks,
/turf/open/floor/plating,
/area/space)
"zX" = (
/obj/machinery/light{
	dir = 1
	},
/obj/effect/decal/cleanable/dirt/dust,
/obj/structure/sign/poster/official/help_others{
	pixel_y = 30
	},
/turf/open/floor/plasteel/white,
/area/space)
"Ah" = (
/obj/machinery/button/flasher{
	id = "sanitarium2";
	pixel_x = 25;
	pixel_y = 5
	},
/obj/machinery/button/door{
	id = "sanitarium2";
	name = "Therapy Room Bolt Control";
	normaldoorcontrol = 1;
	pixel_x = 25;
	pixel_y = -5;
	specialfunctions = 4
	},
/obj/effect/decal/cleanable/dirt/dust,
/turf/open/floor/plasteel/white,
/area/space)
"At" = (
/obj/item/electropack,
/obj/item/storage/toolbox/mechanical{
	pixel_x = 2;
	pixel_y = 3
	},
/obj/structure/closet,
/obj/item/storage/pill_bottle/mannitol,
/obj/item/reagent_containers/glass/bottle/morphine,
/obj/item/reagent_containers/glass/bottle/morphine,
/obj/item/gun/syringe,
/obj/item/storage/box/syringes,
/obj/item/restraints/handcuffs,
/obj/item/clothing/suit/straight_jacket,
/obj/item/clothing/mask/muzzle,
/obj/item/clothing/glasses/blindfold,
/obj/item/clothing/head/helmet{
	desc = "A special helmet, to prevent a psychotic individual from injuring their head.";
	name = "safety helmet"
	},
/obj/item/tape/random,
/obj/item/tape/random,
/obj/item/tape/random,
/obj/item/camera,
/obj/item/camera_film,
/obj/item/storage/pill_bottle/happiness{
	pixel_x = -7
	},
/obj/item/storage/pill_bottle/happiness{
	pixel_x = -7
	},
/obj/item/storage/pill_bottle/mannitol,
/obj/item/clothing/glasses/hud/health,
/turf/open/floor/carpet/blue,
/area/space)
"Cz" = (
/turf/closed/wall,
/area/space)
"Eq" = (
/obj/structure/chair/sofa/right,
/turf/open/floor/carpet/blue,
/area/space)
"Eu" = (
/obj/effect/decal/cleanable/dirt/dust,
/obj/effect/decal/cleanable/dirt/dust,
/turf/open/floor/carpet/blue,
/area/space)
"Gz" = (
/obj/effect/decal/cleanable/dirt/dust,
/obj/structure/sign/poster/official/moth1{
	pixel_y = -30
	},
/turf/open/floor/carpet/blue,
/area/space)
"IY" = (
/obj/machinery/door/window,
/obj/machinery/disposal/deliveryChute{
	name = "feeding chute"
	},
/obj/structure/disposalpipe/trunk,
/obj/machinery/light/small{
	brightness = 0.25;
	dir = 1
	},
/turf/open/floor/plating,
/area/space)
"Jd" = (
/obj/structure/reagent_dispensers/water_cooler,
/obj/structure/sign/poster/official/cleanliness{
	pixel_y = 30
	},
/turf/open/floor/plasteel/white,
/area/space)
"Jg" = (
/obj/structure/toilet,
/obj/machinery/flasher{
	id = "sanitarium1";
	pixel_y = 28
	},
/obj/effect/spawner/lootdrop/sanitarium,
/obj/effect/decal/cleanable/dirt/dust,
/turf/open/floor/plating,
/area/space)
"Kr" = (
/obj/structure/table/wood,
/obj/item/storage/pill_bottle/happiness{
	pixel_x = -7
	},
/obj/item/toy/crayon/black,
/obj/item/paper_bin{
	pixel_x = 7;
	pixel_y = 3
	},
/obj/effect/decal/cleanable/dirt/dust,
/obj/structure/sign/poster/official/walk{
	pixel_y = -30
	},
/turf/open/floor/carpet/cyan,
/area/space)
"KA" = (
/obj/structure/disposalpipe/segment,
/obj/machinery/button/flasher{
	id = "sanitarium1";
	pixel_x = 25;
	pixel_y = 5
	},
/obj/machinery/button/door{
	id = "sanitarium1";
	name = "Sanitarium Bolt Control";
	normaldoorcontrol = 1;
	pixel_x = 25;
	pixel_y = -5;
	specialfunctions = 4
	},
/obj/structure/barricade/wooden/crude,
/obj/effect/decal/cleanable/dirt/dust,
/obj/effect/decal/cleanable/blood/tracks,
/obj/effect/decal/cleanable/blood/gibs/down,
/obj/structure/sign/warning/biohazard{
	pixel_x = -30
	},
/turf/open/floor/plating,
/area/space)
"KL" = (
/obj/structure/chair/sofa/left{
	dir = 1
	},
/turf/open/floor/carpet/blue,
/area/space)
"KV" = (
/obj/structure/table/wood,
/obj/item/reagent_containers/food/drinks/sillycup{
	pixel_y = 6;
	pixel_x = -4
	},
/obj/item/reagent_containers/food/drinks/sillycup{
	pixel_y = -2;
	pixel_x = 9
	},
/obj/item/reagent_containers/food/drinks/sillycup,
/obj/item/reagent_containers/food/drinks/sillycup,
/obj/item/reagent_containers/food/drinks/sillycup,
/turf/open/floor/plasteel/white,
/area/space)
"Ls" = (
/obj/structure/sign/poster/official/ian{
	pixel_x = -30
	},
/turf/open/floor/plasteel/white,
/area/space)
"Ms" = (
/obj/machinery/light{
	dir = 8
	},
/obj/structure/filingcabinet/chestdrawer,
/obj/structure/sign/poster/official/work_for_a_future{
	pixel_y = -30
	},
/turf/open/floor/carpet/blue,
/area/space)
"Ov" = (
/obj/structure/dresser,
/obj/item/flashlight/lamp/green{
	pixel_x = 1;
	pixel_y = 14
	},
/obj/machinery/flasher{
	id = "sanitarium2";
	pixel_x = -28
	},
/turf/open/floor/carpet/cyan,
/area/space)
"Pg" = (
/obj/structure/chair/sofa/right{
	dir = 8
	},
/obj/structure/sign/poster/contraband/donut_corp{
	pixel_x = 30
	},
/turf/open/floor/carpet/blue,
/area/space)
"RY" = (
/obj/structure/chair/office,
/obj/structure/sign/warning/nosmoking/circle{
	pixel_y = 30
	},
/turf/open/floor/plasteel/white,
/area/space)
"SI" = (
/obj/structure/sign/poster/official/do_not_question{
	pixel_y = -30
	},
/turf/open/floor/plasteel/white,
/area/space)
"VC" = (
/obj/machinery/light/small{
	dir = 4
	},
/obj/effect/decal/cleanable/dirt/dust,
/turf/open/floor/plasteel/white,
/area/space)
"VT" = (
/obj/machinery/light/small{
	dir = 1
	},
/obj/structure/chair/comfy/brown,
/obj/effect/decal/cleanable/dirt/dust,
/obj/structure/sign/poster/official/cleanliness{
	pixel_y = 30
	},
/turf/open/floor/carpet/cyan,
/area/space)
"WC" = (
/obj/structure/table/reinforced,
/obj/item/paper_bin{
	pixel_y = 6
	},
/obj/item/pen/red,
/obj/effect/decal/cleanable/dirt/dust,
/turf/open/floor/plasteel/white,
/area/space)
"XI" = (
/obj/structure/sign/poster/official/the_owl{
	pixel_x = 30
	},
/turf/open/floor/plasteel/white,
/area/space)

(1,1,1) = {"
aO
lF
bN
cl
VC
mV
Cz
Cz
Cz
Cz
"}
(2,1,1) = {"
Eq
Gz
Cz
Cz
Cz
Cz
Cz
Jg
gO
Cz
"}
(3,1,1) = {"
pk
nO
Cz
IY
iY
KA
yQ
iK
sz
Cz
"}
(4,1,1) = {"
ml
jY
Cz
Cz
st
Cz
Cz
Cz
Cz
Cz
"}
(5,1,1) = {"
jc
jc
bN
jT
jc
XI
bN
mV
WC
Ls
"}
(6,1,1) = {"
Ah
SI
Cz
Cz
bN
Cz
Cz
RY
eX
mV
"}
(7,1,1) = {"
Cz
sc
Cz
ec
ni
Ms
Cz
jc
ql
mV
"}
(8,1,1) = {"
Ov
lL
yb
ni
lF
bI
Cz
zX
ni
ni
"}
(9,1,1) = {"
VT
fJ
yb
uS
Eu
KL
Cz
Jd
lF
bI
"}
(10,1,1) = {"
gK
Kr
Cz
At
lF
yM
Cz
KV
Pg
tz
"}
