//MAP CONVERTED BY dmm2tgm.py THIS HEADER COMMENT PREVENTS RECONVERSION, DO NOT REMOVE
"aa" = (
/turf/open/floor/plating,
/area/template_noop)
"ab" = (
/obj/effect/decal/cleanable/dirt,
/turf/open/floor/plating,
/area/template_noop)
"ac" = (
/turf/closed/wall,
/area/template_noop)
"ae" = (
/obj/effect/decal/cleanable/dirt,
/turf/open/floor/iron,
/area/template_noop)
"ah" = (
/obj/machinery/door/airlock/security{
	id_tag = "confine1";
	name = "Confinement Room 1"
	},
/turf/open/floor/iron/dark,
/area/template_noop)
"ai" = (
/obj/effect/decal/cleanable/dirt,
/turf/open/floor/plating{
	broken = 1
	},
/area/template_noop)
"ak" = (
/obj/effect/turf_decal/tile/red{
	dir = 1
	},
/turf/open/floor/iron,
/area/template_noop)
"al" = (
/obj/effect/decal/cleanable/blood/old,
/obj/effect/decal/cleanable/dirt,
/turf/open/floor/plating,
/area/template_noop)
"am" = (
/obj/effect/decal/cleanable/dirt,
/obj/effect/decal/remains/xeno,
/turf/open/floor/plating{
	broken = 1
	},
/area/template_noop)
"ao" = (
/obj/machinery/door/airlock/security{
	id_tag = "confine3";
	name = "Confinement Room 3"
	},
/turf/open/floor/iron/dark,
/area/template_noop)
"ap" = (
/obj/machinery/light/small/broken{
	icon_state = "bulb-broken";
	dir = 4
	},
/obj/effect/decal/cleanable/dirt,
/obj/effect/spawner/random/unsorted/sanitarium,
/turf/open/floor/plating,
/area/template_noop)
"aq" = (
/obj/machinery/light/small/built{
	icon_state = "bulb-empty";
	dir = 8
	},
/obj/effect/decal/cleanable/dirt,
/turf/open/floor/iron,
/area/template_noop)
"ar" = (
/obj/machinery/light/broken,
/turf/open/floor/plating,
/area/template_noop)
"aw" = (
/obj/effect/decal/cleanable/blood/old,
/obj/effect/decal/cleanable/dirt,
/obj/machinery/button/door{
	id = "confine3";
	name = "Confinement Lock 3";
	normaldoorcontrol = 1;
	specialfunctions = 4;
	pixel_y = 25
	},
/turf/open/floor/plating,
/area/template_noop)
"az" = (
/obj/effect/decal/cleanable/dirt,
/turf/open/floor/plating{
	burnt = 1
	},
/area/template_noop)
"aA" = (
/obj/structure/table_frame,
/obj/effect/decal/cleanable/dirt,
/turf/open/floor/plating{
	burnt = 1
	},
/area/template_noop)
"aB" = (
/obj/effect/decal/cleanable/blood/old,
/obj/effect/decal/cleanable/dirt,
/obj/machinery/light/small{
	dir = 4
	},
/turf/open/floor/iron,
/area/template_noop)
"aD" = (
/obj/machinery/light/small/broken{
	icon_state = "bulb-broken";
	dir = 8
	},
/obj/effect/decal/cleanable/dirt,
/turf/open/floor/plating,
/area/template_noop)
"aE" = (
/obj/effect/spawner/random/maintenance,
/turf/open/floor/plating,
/area/template_noop)
"aG" = (
/obj/machinery/door/airlock/security{
	id_tag = "confine2";
	name = "Confinement Room 2"
	},
/turf/open/floor/iron/dark,
/area/template_noop)
"aH" = (
/obj/machinery/door/airlock/security{
	id_tag = "confine4";
	name = "Confinement Room 4"
	},
/turf/open/floor/plating,
/area/template_noop)
"aI" = (
/obj/effect/decal/cleanable/blood/old,
/obj/effect/decal/cleanable/dirt,
/obj/effect/decal/remains/human,
/turf/open/floor/plating,
/area/template_noop)
"aJ" = (
/obj/effect/decal/cleanable/dirt,
/obj/effect/spawner/random/unsorted/sanitarium,
/turf/open/floor/plating,
/area/template_noop)
"aK" = (
/obj/effect/decal/cleanable/dirt,
/obj/effect/trap/nexus/doorbolt,
/turf/open/floor/plating,
/area/template_noop)
"aL" = (
/obj/effect/decal/cleanable/dirt,
/obj/effect/spawner/random/unsorted/sanitarium,
/obj/effect/trap/nexus/doorbolt,
/turf/open/floor/iron,
/area/template_noop)
"aM" = (
/obj/effect/decal/cleanable/dirt,
/obj/effect/trap/nexus/doorbolt,
/turf/open/floor/iron,
/area/template_noop)
"aN" = (
/obj/effect/decal/cleanable/dirt,
/obj/effect/spawner/random/maintenance,
/obj/machinery/button/door{
	id = "confine4";
	name = "Confinement Lock 4";
	normaldoorcontrol = 1;
	specialfunctions = 4;
	pixel_y = -25
	},
/obj/effect/turf_decal/tile/red/half/contrasted{
	dir = 8
	},
/turf/open/floor/iron,
/area/template_noop)
"aO" = (
/obj/structure/chair,
/obj/effect/decal/cleanable/dirt,
/obj/effect/turf_decal/tile/red/half/contrasted{
	dir = 4
	},
/turf/open/floor/iron,
/area/template_noop)
"aP" = (
/obj/effect/decal/cleanable/dirt,
/obj/effect/trap/nexus/doorbolt,
/turf/open/floor/plating{
	broken = 1
	},
/area/template_noop)
"aQ" = (
/obj/effect/turf_decal/tile/red/half/contrasted{
	dir = 1
	},
/turf/open/floor/iron,
/area/template_noop)
"aR" = (
/obj/effect/decal/cleanable/dirt,
/obj/effect/turf_decal/tile/red/half/contrasted{
	dir = 1
	},
/turf/open/floor/iron,
/area/template_noop)
"aS" = (
/obj/effect/decal/cleanable/dirt,
/obj/effect/turf_decal/tile/red{
	dir = 4
	},
/turf/open/floor/iron,
/area/template_noop)
"aT" = (
/obj/effect/decal/cleanable/dirt,
/obj/machinery/button/door{
	bound_y = 0;
	id = "confine1";
	name = "Confinement Lock 1";
	normaldoorcontrol = 1;
	specialfunctions = 4;
	pixel_y = 25
	},
/obj/effect/turf_decal/tile/red/half/contrasted{
	dir = 4
	},
/turf/open/floor/iron,
/area/template_noop)
"aU" = (
/obj/effect/decal/cleanable/dirt,
/obj/effect/spawner/random/unsorted/trap,
/turf/open/floor/iron,
/area/template_noop)
"aV" = (
/obj/effect/decal/cleanable/dirt,
/obj/effect/spawner/random/unsorted/trap,
/turf/open/floor/plating{
	broken = 1
	},
/area/template_noop)
"aW" = (
/obj/effect/decal/cleanable/dirt,
/obj/effect/spawner/random/unsorted/sanitarium,
/obj/effect/spawner/random/unsorted/trap,
/turf/open/floor/plating,
/area/template_noop)
"aX" = (
/obj/effect/turf_decal/tile/red/half/contrasted,
/turf/open/floor/iron,
/area/template_noop)
"aY" = (
/obj/effect/decal/cleanable/dirt,
/obj/machinery/button/door{
	id = "confine2";
	name = "Confinement Lock 2";
	normaldoorcontrol = 1;
	specialfunctions = 4;
	pixel_y = -25
	},
/obj/effect/turf_decal/tile/red/half/contrasted{
	dir = 8
	},
/turf/open/floor/iron,
/area/template_noop)
"aZ" = (
/obj/effect/turf_decal/tile/red/half/contrasted{
	dir = 8
	},
/turf/open/floor/iron,
/area/template_noop)
"lf" = (
/obj/effect/turf_decal/tile/red/half/contrasted{
	dir = 4
	},
/turf/open/floor/iron,
/area/template_noop)
"Ac" = (
/obj/effect/decal/cleanable/dirt,
/obj/machinery/light{
	dir = 1;
	light_color = "#e8eaff"
	},
/obj/effect/turf_decal/tile/red/half/contrasted{
	dir = 4
	},
/turf/open/floor/iron,
/area/template_noop)
"Fn" = (
/obj/effect/decal/cleanable/dirt,
/obj/effect/turf_decal/tile/red/half/contrasted,
/turf/open/floor/iron,
/area/template_noop)

(1,1,1) = {"
ab
az
ab
ac
aE
ai
ac
ab
ab
ai
"}
(2,1,1) = {"
ab
aM
aU
ah
aa
ab
aG
aV
aK
aJ
"}
(3,1,1) = {"
ae
ap
am
ac
aT
aY
ac
ae
aB
ae
"}
(4,1,1) = {"
ac
ac
ac
ac
aO
ar
ac
ac
ac
ac
"}
(5,1,1) = {"
aa
aQ
aE
aQ
ak
ab
aA
az
aR
aQ
"}
(6,1,1) = {"
Fn
Fn
aa
aa
aS
az
az
aX
aX
aX
"}
(7,1,1) = {"
ac
ac
ac
ac
Ac
aZ
ac
ac
ac
ac
"}
(8,1,1) = {"
ab
aq
ab
ac
aw
aN
ac
ae
aD
ae
"}
(9,1,1) = {"
ai
aL
aU
ao
ai
ab
aH
aW
aP
ab
"}
(10,1,1) = {"
al
ab
ab
ac
lf
ab
ac
ab
ae
aI
"}
