//MAP CONVERTED BY dmm2tgm.py THIS HEADER COMMENT PREVENTS RECONVERSION, DO NOT REMOVE
"a" = (
/turf/open/floor/plating,
/area/template_noop)
"b" = (
/obj/effect/decal/cleanable/dirt{
	dir = 4
	},
/turf/open/floor/plating,
/area/template_noop)
"c" = (
/obj/structure/table{
	dir = 1
	},
/obj/effect/spawner/lootdrop/maintenance/three{
	dir = 1
	},
/turf/open/floor/plating,
/area/template_noop)
"d" = (
/obj/structure/table{
	dir = 1
	},
/obj/item/storage/toolbox/electrical{
	dir = 1
	},
/obj/item/stack/sheet/iron/five{
	dir = 1
	},
/turf/open/floor/plating,
/area/template_noop)
"e" = (
/obj/structure/table{
	dir = 1
	},
/obj/item/storage/toolbox/mechanical{
	dir = 1
	},
/turf/open/floor/plating,
/area/template_noop)
"f" = (
/obj/structure/reagent_dispensers/fueltank{
	dir = 1
	},
/turf/open/floor/plating,
/area/template_noop)
"g" = (
/obj/effect/decal/cleanable/oil{
	dir = 4
	},
/turf/open/floor/plating,
/area/template_noop)
"h" = (
/obj/effect/spawner/lootdrop/maintenance{
	dir = 1
	},
/turf/open/floor/plating,
/area/template_noop)
"i" = (
/obj/structure/shuttle/engine/propulsion{
	dir = 2
	},
/turf/closed/wall/mineral/titanium,
/area/template_noop)
"j" = (
/obj/machinery/door/airlock/titanium{
	name = "Escape Pod Airlock";
	dir = 1
	},
/turf/open/floor/mineral/titanium/blue,
/area/template_noop)
"k" = (
/obj/effect/decal/cleanable/oil/streak{
	dir = 4
	},
/obj/effect/landmark/blobstart{
	dir = 1
	},
/turf/open/floor/plating,
/area/template_noop)
"l" = (
/obj/item/clothing/glasses/welding{
	dir = 1
	},
/turf/open/floor/plating,
/area/template_noop)
"m" = (
/obj/effect/decal/cleanable/robot_debris/old{
	dir = 4
	},
/turf/open/floor/plating,
/area/template_noop)
"n" = (
/turf/closed/wall/mineral/titanium,
/area/template_noop)
"o" = (
/obj/structure/chair/comfy/shuttle{
	dir = 1
	},
/obj/machinery/light/small{
	dir = 4
	},
/turf/open/floor/mineral/titanium/blue,
/area/template_noop)
"p" = (
/obj/item/storage/secure/safe{
	dir = 1
	},
/turf/closed/wall/mineral/titanium,
/area/template_noop)
"r" = (
/obj/structure/chair/comfy/shuttle{
	dir = 1
	},
/turf/open/floor/mineral/titanium/blue,
/area/template_noop)
"t" = (
/obj/effect/spawner/structure/window/shuttle{
	dir = 1
	},
/turf/open/floor/plating,
/area/template_noop)
"u" = (
/obj/item/clothing/gloves/color/fyellow{
	dir = 1
	},
/turf/open/floor/plating,
/area/template_noop)
"v" = (
/obj/effect/decal/cleanable/shreds{
	dir = 4
	},
/turf/open/floor/plating,
/area/template_noop)
"w" = (
/obj/item/weldingtool{
	dir = 1
	},
/turf/open/floor/plating,
/area/template_noop)
"x" = (
/obj/structure/table{
	dir = 1
	},
/obj/effect/spawner/lootdrop/maintenance{
	dir = 1
	},
/turf/open/floor/plating,
/area/template_noop)
"y" = (
/obj/structure/table{
	dir = 1
	},
/turf/open/floor/plating,
/area/template_noop)
"z" = (
/obj/structure/table{
	dir = 1
	},
/obj/item/stack/sheet/mineral/titanium{
	dir = 1
	},
/obj/item/stack/sheet/mineral/titanium{
	dir = 1
	},
/obj/item/stack/sheet/mineral/titanium{
	dir = 1
	},
/obj/item/stack/sheet/mineral/titanium{
	dir = 1
	},
/obj/item/stack/sheet/mineral/titanium{
	dir = 1
	},
/turf/open/floor/plating,
/area/template_noop)
"A" = (
/obj/structure/table{
	dir = 1
	},
/obj/item/stack/rods/ten{
	dir = 1
	},
/obj/effect/spawner/lootdrop/maintenance{
	dir = 1
	},
/turf/open/floor/plating,
/area/template_noop)
"B" = (
/obj/effect/decal/remains/robot{
	dir = 4
	},
/turf/open/floor/plating,
/area/template_noop)
"C" = (
/obj/effect/landmark/event_spawn{
	dir = 1
	},
/turf/open/floor/plating,
/area/template_noop)
"E" = (
/obj/effect/decal/cleanable/dirt{
	dir = 4
	},
/obj/effect/decal/cleanable/blood/old{
	dir = 4
	},
/turf/open/floor/plating,
/area/template_noop)
"J" = (
/obj/effect/decal/cleanable/vomit/old{
	dir = 4
	},
/turf/open/floor/plating,
/area/template_noop)
"Q" = (
/obj/structure/chair/comfy/shuttle{
	dir = 1
	},
/obj/effect/decal/cleanable/vomit/old{
	dir = 4
	},
/turf/open/floor/mineral/titanium/blue,
/area/template_noop)
"R" = (
/obj/effect/decal/cleanable/oil{
	dir = 4
	},
/obj/effect/decal/cleanable/blood/old{
	dir = 4
	},
/turf/open/floor/plating,
/area/template_noop)

(1,1,1) = {"
a
a
a
a
b
b
b
a
g
a"}(2,1,1) = {"
a
A
x
v
n
n
n
i
h
a"}(3,1,1) = {"
a
y
y
a
t
r
o
j
a
E"}(4,1,1) = {"
b
x
z
J
n
n
p
i
b
b"}(5,1,1) = {"
b
B
C
g
u
b
f
a
b
b"}(6,1,1) = {"
b
b
a
w
b
b
b
R
b
a"}(7,1,1) = {"
h
b
n
n
n
i
b
k
a
c"}(8,1,1) = {"
a
g
t
Q
o
j
a
l
a
d"}(9,1,1) = {"
a
h
n
n
p
i
h
m
b
e"}(10,1,1) = {"
b
a
a
b
b
a
a
b
b
f"}