//MAP CONVERTED BY dmm2tgm.py THIS HEADER COMMENT PREVENTS RECONVERSION, DO NOT REMOVE
"a" = (
/turf/open/floor/plating,
/area/template_noop)
"b" = (
/obj/item/trash/boritos{
	dir = 1
	},
/turf/open/floor/carpet/red,
/area/template_noop)
"c" = (
/obj/item/stack/cable_coil/cut,
/turf/open/floor/plating,
/area/template_noop)
"d" = (
/obj/machinery/vending/boozeomat{
	dir = 1
	},
/obj/structure/window/reinforced/spawner/west,
/turf/open/floor/plating,
/area/template_noop)
"e" = (
/obj/effect/spawner/lootdrop/crate_spawner{
	dir = 1
	},
/turf/open/floor/plating,
/area/template_noop)
"f" = (
/obj/structure/table_frame/wood{
	dir = 1
	},
/obj/item/stack/sheet/mineral/wood{
	dir = 1
	},
/turf/open/floor/plating{
	icon_state = "platingdmg1"
	},
/area/template_noop)
"g" = (
/obj/structure/table/wood{
	dir = 1
	},
/obj/item/reagent_containers/food/drinks/drinkingglass/shotglass{
	pixel_x = -8;
	pixel_y = -9;
	dir = 1
	},
/obj/item/reagent_containers/food/drinks/drinkingglass/shotglass{
	pixel_x = 5;
	pixel_y = -4;
	dir = 1
	},
/turf/open/floor/plasteel/cafeteria,
/area/template_noop)
"h" = (
/obj/item/trash/popcorn{
	dir = 1
	},
/turf/open/floor/plating,
/area/template_noop)
"i" = (
/obj/structure/mirror{
	pixel_y = -26;
	dir = 1
	},
/turf/open/floor/carpet,
/area/template_noop)
"j" = (
/obj/effect/landmark/blobstart{
	dir = 1
	},
/turf/open/floor/wood,
/area/template_noop)
"k" = (
/obj/structure/grille{
	dir = 1
	},
/turf/open/floor/plating,
/area/template_noop)
"l" = (
/turf/closed/wall,
/area/template_noop)
"m" = (
/turf/open/floor/plasteel/cafeteria,
/area/template_noop)
"n" = (
/obj/structure/table{
	dir = 1
	},
/obj/machinery/chem_dispenser/drinks/beer{
	dir = 1
	},
/turf/open/floor/plasteel/cafeteria,
/area/template_noop)
"o" = (
/obj/effect/decal/cleanable/oil{
	dir = 4
	},
/turf/open/floor/plating,
/area/template_noop)
"p" = (
/obj/machinery/light/small{
	dir = 2
	},
/turf/open/floor/wood,
/area/template_noop)
"q" = (
/obj/structure/chair/stool/bar{
	dir = 1
	},
/obj/effect/decal/cleanable/blood/old{
	dir = 4
	},
/turf/open/floor/plating,
/area/template_noop)
"r" = (
/obj/item/trash/can/food/peaches/maint{
	dir = 1
	},
/obj/machinery/light/small{
	dir = 8
	},
/turf/open/floor/carpet/red,
/area/template_noop)
"s" = (
/obj/effect/decal/cleanable/oil{
	icon_state = "floor5";
	dir = 4
	},
/obj/structure/grille/broken{
	dir = 1
	},
/turf/open/floor/plating,
/area/template_noop)
"t" = (
/obj/structure/closet/firecloset/full{
	dir = 1
	},
/turf/open/floor/plating,
/area/template_noop)
"u" = (
/obj/structure/closet{
	dir = 1
	},
/obj/item/storage/toolbox/mechanical{
	dir = 1
	},
/obj/effect/spawner/lootdrop/maintenance/three{
	dir = 1
	},
/obj/effect/spawner/lootdrop/gloves{
	dir = 1
	},
/turf/open/floor/carpet,
/area/template_noop)
"v" = (
/obj/structure/closet/crate/trashcart{
	dir = 1
	},
/obj/structure/window/reinforced/spawner/west,
/obj/structure/grille/broken{
	dir = 1
	},
/turf/open/floor/plating,
/area/template_noop)
"w" = (
/obj/machinery/light/small{
	dir = 8
	},
/turf/open/floor/plating{
	icon_state = "platingdmg1"
	},
/area/template_noop)
"x" = (
/obj/effect/decal/cleanable/blood/old{
	dir = 4
	},
/turf/open/floor/plating,
/area/template_noop)
"y" = (
/obj/machinery/light/small{
	dir = 2
	},
/turf/open/floor/plating{
	icon_state = "platingdmg1"
	},
/area/template_noop)
"z" = (
/obj/structure/chair/sofa{
	dir = 2
	},
/turf/open/floor/carpet/red,
/area/template_noop)
"A" = (
/obj/effect/spawner/lootdrop/grille_or_trash{
	dir = 1
	},
/turf/open/floor/plating,
/area/template_noop)
"B" = (
/obj/structure/rack{
	dir = 1
	},
/obj/item/storage/toolbox/mechanical{
	dir = 1
	},
/turf/open/floor/plating,
/area/template_noop)
"C" = (
/obj/machinery/light/small{
	dir = 4
	},
/turf/open/floor/plating,
/area/template_noop)
"D" = (
/obj/structure/chair/sofa/right{
	dir = 2
	},
/turf/open/floor/carpet/red,
/area/template_noop)
"E" = (
/obj/structure/rack{
	dir = 1
	},
/obj/effect/spawner/lootdrop/maintenance/eight{
	dir = 1
	},
/turf/open/floor/plating,
/area/template_noop)
"F" = (
/obj/structure/table{
	dir = 1
	},
/obj/machinery/chem_dispenser/drinks{
	dir = 1
	},
/obj/machinery/light/small{
	dir = 2
	},
/turf/open/floor/plasteel/cafeteria,
/area/template_noop)
"H" = (
/obj/machinery/vending/autodrobe{
	dir = 1
	},
/turf/open/floor/wood,
/area/template_noop)
"I" = (
/turf/open/floor/plating{
	icon_state = "platingdmg1"
	},
/area/template_noop)
"J" = (
/obj/structure/table/wood{
	dir = 1
	},
/obj/item/reagent_containers/food/drinks/drinkingglass/shotglass{
	pixel_x = 4;
	pixel_y = -4;
	dir = 1
	},
/turf/open/floor/plasteel/cafeteria,
/area/template_noop)
"K" = (
/obj/machinery/door/airlock/wood{
	dir = 1
	},
/turf/open/floor/plating,
/area/template_noop)
"L" = (
/turf/open/floor/wood,
/area/template_noop)
"M" = (
/obj/structure/table/wood{
	dir = 1
	},
/obj/structure/window/reinforced/spawner/west,
/obj/effect/spawner/lootdrop/gambling{
	dir = 1
	},
/turf/open/floor/plasteel/cafeteria,
/area/template_noop)
"N" = (
/obj/item/kirbyplants/random{
	dir = 1
	},
/turf/open/floor/wood,
/area/template_noop)
"O" = (
/obj/effect/decal/cleanable/insectguts{
	dir = 4
	},
/turf/open/floor/plating,
/area/template_noop)
"P" = (
/obj/structure/chair/stool/bar{
	dir = 1
	},
/turf/open/floor/plating,
/area/template_noop)
"Q" = (
/obj/structure/chair/sofa/left{
	dir = 2
	},
/turf/open/floor/carpet/red,
/area/template_noop)
"R" = (
/turf/open/floor/carpet/red,
/area/template_noop)
"S" = (
/obj/structure/reagent_dispensers/watertank{
	dir = 1
	},
/turf/open/floor/plating,
/area/template_noop)
"T" = (
/obj/structure/window/reinforced/tinted/frosted{
	dir = 4
	},
/obj/structure/table/wood{
	dir = 1
	},
/obj/effect/spawner/lootdrop/glowstick{
	dir = 1
	},
/turf/open/floor/carpet,
/area/template_noop)
"U" = (
/obj/effect/landmark/event_spawn{
	dir = 1
	},
/turf/open/floor/wood,
/area/template_noop)
"V" = (
/obj/effect/spawner/structure/window/reinforced{
	dir = 1
	},
/turf/open/floor/plating,
/area/template_noop)
"W" = (
/obj/structure/reagent_dispensers/fueltank{
	dir = 1
	},
/turf/open/floor/plating,
/area/template_noop)
"X" = (
/obj/structure/window/reinforced/tinted/frosted{
	dir = 4
	},
/obj/effect/landmark/start/randommaint/magician{
	dir = 1
	},
/obj/structure/chair/stool/bar{
	dir = 1
	},
/obj/machinery/light/small{
	dir = 2
	},
/obj/structure/sign/poster/contraband/syndicate_recruitment{
	pixel_x = 4;
	pixel_y = -33;
	dir = 1
	},
/turf/open/floor/carpet,
/area/template_noop)
"Y" = (
/turf/open/floor/monotile/steel,
/area/template_noop)
"Z" = (
/obj/structure/grille/broken{
	dir = 1
	},
/turf/open/floor/plating{
	icon_state = "platingdmg1"
	},
/area/template_noop)

(1,1,1) = {"
a
a
o
a
a
a
s
C
a
S"}(2,1,1) = {"
I
v
l
l
V
V
l
l
a
A"}(3,1,1) = {"
a
D
r
D
N
L
H
l
O
a"}(4,1,1) = {"
o
z
R
z
L
j
p
l
k
Z"}(5,1,1) = {"
a
Q
b
Q
L
U
L
V
E
y"}(6,1,1) = {"
h
Y
Y
Y
L
L
L
V
B
c"}(7,1,1) = {"
P
g
M
d
l
l
K
l
W
a"}(8,1,1) = {"
q
J
a
F
l
u
i
l
t
a"}(9,1,1) = {"
P
f
m
n
l
T
X
l
e
a"}(10,1,1) = {"
a
x
I
a
w
a
a
Z
a
a"}