//MAP CONVERTED BY dmm2tgm.py THIS HEADER COMMENT PREVENTS RECONVERSION, DO NOT REMOVE
"aa" = (
/turf/open/floor/iron/dark,
/area/template_noop)
"ab" = (
/obj/item/kirbyplants{
	icon_state = "plant-21"
	},
/turf/open/floor/iron/dark,
/area/template_noop)
"ac" = (
/obj/structure/table,
/obj/item/stack/sheet/iron/fifty,
/obj/item/stack/sheet/iron/fifty,
/obj/item/stack/sheet/glass/fifty,
/obj/machinery/light/small{
	dir = 1
	},
/turf/open/floor/iron/dark,
/area/template_noop)
"ad" = (
/obj/structure/table,
/obj/item/storage/box/lights/mixed,
/turf/open/floor/iron/dark,
/area/template_noop)
"ae" = (
/obj/machinery/vending/cigarette,
/turf/open/floor/iron/dark,
/area/template_noop)
"af" = (
/obj/structure/closet/boxinggloves,
/turf/open/floor/iron/dark,
/area/template_noop)
"ag" = (
/obj/structure/closet/masks,
/obj/item/food/deadmouse,
/turf/open/floor/iron/dark,
/area/template_noop)
"ah" = (
/obj/structure/window/reinforced/spawner/directional/east,
/obj/structure/window/reinforced/spawner/directional/north,
/obj/structure/window/reinforced/spawner/directional/west,
/mob/living/simple_animal/chicken{
	name = "Cletus"
	},
/turf/open/floor/engine,
/area/template_noop)
"ai" = (
/obj/effect/decal/cleanable/vomit/old,
/turf/open/floor/iron/dark,
/area/template_noop)
"aj" = (
/obj/machinery/door/window/eastright{
	base_state = "left";
	dir = 8;
	icon_state = "left";
	name = "Arena"
	},
/obj/structure/window/reinforced/spawner/directional/north,
/obj/structure/window/reinforced/spawner/directional/east,
/turf/open/floor/engine,
/area/template_noop)
"ak" = (
/obj/structure/window/reinforced/spawner/directional/east,
/obj/structure/window/reinforced/spawner/directional/west,
/turf/open/floor/engine,
/area/template_noop)
"al" = (
/obj/effect/spawner/random/maintenance,
/turf/open/floor/iron/dark,
/area/template_noop)
"as" = (
/obj/structure/window/reinforced/spawner/directional/west,
/obj/structure/window/reinforced/spawner/directional/east,
/turf/open/floor/engine,
/area/template_noop)
"at" = (
/obj/machinery/door/window/eastright{
	base_state = "left";
	icon_state = "left";
	name = "Arena"
	},
/obj/structure/window/reinforced/spawner/directional/south,
/obj/structure/window/reinforced/spawner/directional/west,
/turf/open/floor/engine,
/area/template_noop)
"au" = (
/obj/machinery/door/window/eastright{
	base_state = "left";
	dir = 8;
	icon_state = "left";
	name = "Arena"
	},
/obj/structure/window/reinforced/spawner/directional/north,
/obj/structure/chair/stool,
/turf/open/floor/engine,
/area/template_noop)
"av" = (
/obj/structure/window/reinforced/spawner/directional/north,
/mob/living/simple_animal/chicken{
	name = "Bloodthirsty Peckins"
	},
/turf/open/floor/engine,
/area/template_noop)
"aw" = (
/obj/structure/window/reinforced/spawner/directional/north,
/turf/open/floor/engine,
/area/template_noop)
"ax" = (
/obj/structure/window/reinforced/spawner/directional/east,
/obj/structure/window/reinforced/spawner/directional/north,
/turf/open/floor/engine,
/area/template_noop)
"az" = (
/obj/structure/window/reinforced/spawner/directional/south,
/obj/structure/window/reinforced/spawner/directional/west,
/obj/structure/window/reinforced/spawner/directional/east,
/mob/living/simple_animal/chicken{
	name = "Kentucky Fried Terror"
	},
/turf/open/floor/engine,
/area/template_noop)
"aA" = (
/obj/effect/decal/cleanable/oil{
	icon_state = "floor6"
	},
/obj/effect/decal/cleanable/robot_debris/old,
/turf/open/floor/iron/dark,
/area/template_noop)
"aB" = (
/obj/structure/window/reinforced/spawner/directional/west,
/turf/open/floor/engine,
/area/template_noop)
"aC" = (
/turf/open/floor/engine,
/area/template_noop)
"aD" = (
/obj/structure/window/reinforced/spawner/directional/east,
/turf/open/floor/engine,
/area/template_noop)
"aE" = (
/obj/effect/decal/cleanable/blood/old,
/turf/open/floor/engine,
/area/template_noop)
"aG" = (
/obj/effect/decal/cleanable/oil,
/turf/open/floor/iron/dark,
/area/template_noop)
"aH" = (
/obj/structure/table,
/obj/effect/spawner/random/maintenance/two,
/turf/open/floor/iron/dark,
/area/template_noop)
"aI" = (
/obj/item/stack/medical/bruise_pack,
/turf/open/floor/iron/dark,
/area/template_noop)
"aJ" = (
/obj/structure/window/reinforced/spawner/directional/south,
/obj/structure/window/reinforced/spawner/directional/west,
/turf/open/floor/engine,
/area/template_noop)
"aK" = (
/obj/structure/window/reinforced/spawner/directional/south,
/turf/open/floor/engine,
/area/template_noop)
"aL" = (
/obj/structure/window/reinforced/spawner/directional/south,
/mob/living/simple_animal/chicken{
	name = "Killer Cluck"
	},
/turf/open/floor/engine,
/area/template_noop)
"aM" = (
/obj/machinery/door/window/eastright{
	base_state = "left";
	icon_state = "left";
	name = "Arena"
	},
/obj/structure/window/reinforced/spawner/directional/south,
/obj/structure/chair/stool,
/turf/open/floor/engine,
/area/template_noop)
"aO" = (
/obj/structure/mopbucket,
/obj/item/mop,
/turf/open/floor/iron/dark,
/area/template_noop)
"aP" = (
/obj/structure/table,
/obj/item/storage/box/mousetraps,
/obj/effect/spawner/random/maintenance,
/obj/item/stack/sheet/mineral/copper{
	amount = 5
	},
/turf/open/floor/iron/dark,
/area/template_noop)
"aQ" = (
/obj/structure/reagent_dispensers/watertank,
/turf/open/floor/iron/dark,
/area/template_noop)
"aR" = (
/obj/structure/table,
/obj/item/stack/cable_coil,
/obj/item/extinguisher,
/turf/open/floor/iron/dark,
/area/template_noop)
"aS" = (
/obj/structure/table,
/obj/effect/spawner/random/maintenance,
/turf/open/floor/iron/dark,
/area/template_noop)
"aT" = (
/obj/structure/rack,
/obj/effect/spawner/random/maintenance,
/turf/open/floor/iron/dark,
/area/template_noop)
"aU" = (
/obj/machinery/portable_atmospherics/canister/air,
/turf/open/floor/iron/dark,
/area/template_noop)
"aV" = (
/obj/item/trash/chips,
/turf/open/floor/iron/dark,
/area/template_noop)
"aW" = (
/obj/structure/table,
/obj/item/paper,
/obj/item/pen,
/obj/item/stack/sheet/mineral/copper{
	amount = 5
	},
/turf/open/floor/iron/dark,
/area/template_noop)
"aX" = (
/obj/structure/chair/stool/directional/west,
/turf/open/floor/iron/dark,
/area/template_noop)
"aY" = (
/obj/effect/turf_decal/tile/neutral/fourcorners/contrasted,
/turf/open/floor/iron/dark,
/area/template_noop)
"aZ" = (
/obj/structure/chair/fancy/comfy{
	color = "#666666";
	dir = 1
	},
/obj/effect/turf_decal/tile/neutral/fourcorners/contrasted,
/turf/open/floor/iron/dark,
/area/template_noop)
"ip" = (
/obj/item/stack/spacecash/c10,
/obj/effect/turf_decal/tile/neutral/fourcorners/contrasted,
/turf/open/floor/iron/dark,
/area/template_noop)
"Hq" = (
/obj/item/trash/popcorn,
/obj/effect/turf_decal/tile/neutral/fourcorners/contrasted,
/turf/open/floor/iron/dark,
/area/template_noop)
"Im" = (
/obj/structure/chair/fancy/comfy{
	color = "#666666"
	},
/obj/effect/turf_decal/tile/neutral/fourcorners/contrasted,
/turf/open/floor/iron/dark,
/area/template_noop)
"RY" = (
/obj/structure/chair/fancy/comfy{
	color = "#666666"
	},
/obj/item/trash/pistachios,
/obj/effect/turf_decal/tile/neutral/fourcorners/contrasted,
/turf/open/floor/iron/dark,
/area/template_noop)
"VF" = (
/obj/structure/chair/fancy/comfy{
	color = "#666666"
	},
/obj/item/stack/spacecash/c100,
/obj/effect/turf_decal/tile/neutral/fourcorners/contrasted,
/turf/open/floor/iron/dark,
/area/template_noop)
"Wz" = (
/obj/structure/chair/fancy/comfy{
	color = "#666666"
	},
/obj/item/cigbutt,
/obj/effect/turf_decal/tile/neutral/fourcorners/contrasted,
/turf/open/floor/iron/dark,
/area/template_noop)
"YK" = (
/obj/item/stack/medical/gauze,
/obj/effect/turf_decal/tile/neutral/fourcorners/contrasted,
/turf/open/floor/iron/dark,
/area/template_noop)

(1,1,1) = {"
aa
ah
ak
at
aa
aa
aH
aH
aP
aR
"}
(2,1,1) = {"
ab
aa
al
aa
aA
aa
aI
aa
aa
aS
"}
(3,1,1) = {"
ac
aa
aY
aY
aY
aY
aY
aY
aa
aT
"}
(4,1,1) = {"
ad
aa
RY
au
aB
aB
aJ
aZ
aa
aU
"}
(5,1,1) = {"
aa
aa
VF
av
aC
aC
aK
aZ
aa
aa
"}
(6,1,1) = {"
aa
aa
Im
aw
aC
aE
aL
aZ
aa
aa
"}
(7,1,1) = {"
ae
ai
Wz
ax
aD
aD
aM
aZ
aa
aV
"}
(8,1,1) = {"
af
aa
Hq
YK
aY
ip
aY
aY
aa
aW
"}
(9,1,1) = {"
ag
aa
aa
aa
aa
aG
aa
aa
aa
aX
"}
(10,1,1) = {"
aa
aj
as
az
aa
aa
aa
aO
aQ
aa
"}
