//MAP CONVERTED BY dmm2tgm.py THIS HEADER COMMENT PREVENTS RECONVERSION, DO NOT REMOVE
"a" = (
/obj/effect/turf_decal/tile/green{
	dir = 4
	},
/turf/open/floor/plasteel,
/area/template_noop)
"b" = (
/obj/effect/turf_decal/tile/green{
	dir = 4
	},
/obj/effect/turf_decal/tile/green{
	dir = 1
	},
/turf/open/floor/plasteel,
/area/template_noop)
"c" = (
/obj/effect/turf_decal/tile/green{
	dir = 1
	},
/turf/open/floor/plasteel,
/area/template_noop)
"d" = (
/obj/effect/turf_decal/tile/green{
	dir = 2
	},
/obj/effect/turf_decal/tile/green{
	dir = 4
	},
/turf/open/floor/plasteel,
/area/template_noop)
"e" = (
/obj/structure/closet/crate{
	dir = 1
	},
/obj/item/clothing/under/shorts/blue{
	dir = 1
	},
/obj/item/clothing/under/shorts/green{
	dir = 1
	},
/obj/item/clothing/under/shorts/red{
	dir = 1
	},
/obj/item/clothing/shoes/sandal{
	dir = 1
	},
/obj/item/clothing/shoes/sandal{
	dir = 1
	},
/obj/item/clothing/shoes/sandal{
	dir = 1
	},
/obj/item/clothing/glasses/sunglasses/advanced{
	dir = 1
	},
/obj/item/clothing/glasses/sunglasses/advanced{
	dir = 1
	},
/obj/item/clothing/glasses/sunglasses/advanced{
	dir = 1
	},
/obj/item/storage/toolbox/mechanical{
	dir = 1
	},
/turf/open/floor/plating/beach/sand,
/area/template_noop)
"f" = (
/turf/open/floor/plating/beach/sand,
/area/template_noop)
"g" = (
/obj/structure/flora/ausbushes/sparsegrass{
	dir = 1
	},
/turf/open/floor/plating/beach/sand,
/area/template_noop)
"h" = (
/obj/effect/turf_decal/tile/green{
	dir = 8
	},
/obj/effect/turf_decal/tile/green{
	dir = 1
	},
/turf/open/floor/plasteel,
/area/template_noop)
"i" = (
/obj/effect/overlay/palmtree_r{
	dir = 1
	},
/turf/open/floor/plating/beach/sand,
/area/template_noop)
"j" = (
/obj/effect/overlay/coconut{
	dir = 1
	},
/turf/open/floor/plating/beach/sand,
/area/template_noop)
"k" = (
/obj/effect/overlay/palmtree_l{
	dir = 1
	},
/turf/open/floor/plating/beach/sand,
/area/template_noop)
"l" = (
/turf/open/floor/plating/beach/coastline_t,
/area/template_noop)
"m" = (
/turf/open/floor/plating/beach/coastline_b,
/area/template_noop)
"n" = (
/turf/open/floor/plating/beach/water,
/area/template_noop)
"o" = (
/obj/effect/turf_decal/tile/green{
	dir = 2
	},
/turf/open/floor/plasteel,
/area/template_noop)
"p" = (
/obj/effect/turf_decal/tile/green{
	dir = 8
	},
/obj/effect/turf_decal/tile/green{
	dir = 2
	},
/turf/open/floor/plasteel,
/area/template_noop)
"q" = (
/obj/effect/turf_decal/tile/green{
	dir = 8
	},
/turf/open/floor/plasteel,
/area/template_noop)
"r" = (
/obj/effect/turf_decal/tile/green{
	dir = 4
	},
/obj/effect/turf_decal/tile/green{
	dir = 1
	},
/obj/machinery/light{
	dir = 2
	},
/turf/open/floor/plasteel,
/area/template_noop)
"s" = (
/obj/effect/turf_decal/tile/green{
	dir = 2
	},
/obj/effect/turf_decal/tile/green{
	dir = 4
	},
/obj/machinery/light{
	dir = 8
	},
/turf/open/floor/plasteel,
/area/template_noop)
"t" = (
/obj/effect/turf_decal/tile/green{
	dir = 8
	},
/obj/effect/turf_decal/tile/green{
	dir = 1
	},
/obj/machinery/light{
	dir = 4
	},
/turf/open/floor/plasteel,
/area/template_noop)
"u" = (
/obj/item/toy/beach_ball{
	dir = 1
	},
/turf/open/floor/plating/beach/sand,
/area/template_noop)
"v" = (
/obj/effect/turf_decal/tile/green{
	dir = 8
	},
/obj/effect/turf_decal/tile/green{
	dir = 2
	},
/obj/machinery/light{
	dir = 1
	},
/turf/open/floor/plasteel,
/area/template_noop)
"w" = (
/mob/living/simple_animal/crab,
/turf/open/floor/plating/beach/sand,
/area/template_noop)
"x" = (
/obj/item/reagent_containers/spray/spraytan{
	dir = 1
	},
/turf/open/floor/plating/beach/sand,
/area/template_noop)
"y" = (
/obj/effect/landmark/blobstart{
	dir = 1
	},
/turf/open/floor/plating/beach/sand,
/area/template_noop)
"D" = (
/obj/structure/chair{
	dir = 1
	},
/obj/effect/landmark/start/randommaint/celebrity{
	dir = 1
	},
/turf/open/floor/plating/beach/sand,
/area/template_noop)
"J" = (
/obj/structure/closet/crate/freezer{
	name = "Beer Cooler";
	dir = 1
	},
/obj/item/reagent_containers/food/drinks/beer{
	dir = 1
	},
/obj/item/reagent_containers/food/drinks/beer{
	dir = 1
	},
/obj/item/reagent_containers/food/drinks/beer{
	dir = 1
	},
/obj/item/reagent_containers/food/drinks/beer{
	dir = 1
	},
/obj/item/reagent_containers/food/drinks/beer{
	dir = 1
	},
/obj/item/reagent_containers/food/drinks/beer{
	dir = 1
	},
/obj/item/reagent_containers/food/drinks/beer{
	dir = 1
	},
/obj/item/reagent_containers/food/drinks/beer{
	dir = 1
	},
/obj/item/reagent_containers/food/drinks/beer{
	dir = 1
	},
/obj/item/reagent_containers/food/drinks/beer{
	dir = 1
	},
/turf/open/floor/plating/beach/sand,
/area/template_noop)

(1,1,1) = {"
o
d
d
s
d
d
s
d
d
a"}(2,1,1) = {"
p
n
m
l
f
f
f
f
e
b"}(3,1,1) = {"
p
n
m
l
f
f
f
g
f
b"}(4,1,1) = {"
v
n
m
l
f
j
y
f
f
r"}(5,1,1) = {"
p
n
m
l
x
k
f
f
f
b"}(6,1,1) = {"
p
n
m
l
D
u
w
f
f
b"}(7,1,1) = {"
v
n
m
l
J
f
f
f
g
r"}(8,1,1) = {"
p
n
m
l
g
f
i
f
f
b"}(9,1,1) = {"
p
n
m
l
f
f
f
f
f
b"}(10,1,1) = {"
q
h
h
t
h
h
t
h
h
c"}