//MAP CONVERTED BY dmm2tgm.py THIS HEADER COMMENT PREVENTS RECONVERSION, DO NOT REMOVE
"a" = (
/turf/open/floor/plating,
/area/template_noop)
"b" = (
/obj/item/trash/boritos,
/turf/open/floor/carpet/red,
/area/template_noop)
"c" = (
/obj/item/stack/cable_coil/cut,
/turf/open/floor/plating,
/area/template_noop)
"d" = (
/obj/machinery/vending/boozeomat,
/obj/structure/window/reinforced/spawner/directional/west,
/turf/open/floor/plating,
/area/template_noop)
"e" = (
/obj/effect/spawner/random/structure/crate_abandoned,
/turf/open/floor/plating,
/area/template_noop)
"f" = (
/obj/structure/table_frame/wood,
/obj/item/stack/sheet/wood,
/turf/open/floor/plating{
	broken = 1
	},
/area/template_noop)
"g" = (
/obj/structure/table/wood,
/obj/item/reagent_containers/cup/glass/drinkingglass/shotglass{
	pixel_x = -8;
	pixel_y = 9
	},
/obj/item/reagent_containers/cup/glass/drinkingglass/shotglass{
	pixel_x = 5;
	pixel_y = 4
	},
/turf/open/floor/iron/cafeteria,
/area/template_noop)
"h" = (
/obj/item/trash/popcorn,
/turf/open/floor/plating,
/area/template_noop)
"i" = (
/obj/structure/mirror{
	pixel_y = 26
	},
/turf/open/floor/carpet,
/area/template_noop)
"j" = (
/obj/effect/landmark/blobstart,
/turf/open/floor/wood,
/area/template_noop)
"k" = (
/obj/structure/grille,
/turf/open/floor/plating,
/area/template_noop)
"l" = (
/turf/closed/wall,
/area/template_noop)
"m" = (
/turf/open/floor/iron/cafeteria,
/area/template_noop)
"n" = (
/obj/structure/table,
/obj/machinery/chem_dispenser/drinks/beer,
/turf/open/floor/iron/cafeteria,
/area/template_noop)
"o" = (
/obj/effect/decal/cleanable/oil,
/turf/open/floor/plating,
/area/template_noop)
"p" = (
/obj/machinery/light/small{
	dir = 1
	},
/turf/open/floor/wood,
/area/template_noop)
"q" = (
/obj/structure/chair/stool/bar,
/obj/effect/decal/cleanable/blood/old,
/turf/open/floor/plating,
/area/template_noop)
"r" = (
/obj/item/trash/canned/peaches/maint,
/obj/machinery/light/small{
	dir = 8
	},
/turf/open/floor/carpet/red,
/area/template_noop)
"s" = (
/obj/effect/decal/cleanable/oil{
	icon_state = "floor5"
	},
/obj/structure/grille/broken,
/turf/open/floor/plating,
/area/template_noop)
"t" = (
/obj/structure/closet/firecloset/full,
/turf/open/floor/plating,
/area/template_noop)
"u" = (
/obj/structure/closet,
/obj/item/storage/toolbox/mechanical,
/obj/effect/spawner/random/maintenance/three,
/obj/effect/spawner/random/clothing/gloves,
/turf/open/floor/carpet,
/area/template_noop)
"v" = (
/obj/structure/closet/crate/trashcart,
/obj/structure/window/reinforced/spawner/directional/west,
/obj/structure/grille/broken,
/turf/open/floor/plating,
/area/template_noop)
"w" = (
/obj/machinery/light/small{
	dir = 8
	},
/turf/open/floor/plating{
	broken = 1
	},
/area/template_noop)
"x" = (
/obj/effect/decal/cleanable/blood/old,
/turf/open/floor/plating,
/area/template_noop)
"y" = (
/obj/machinery/light/small{
	dir = 1
	},
/turf/open/floor/plating{
	broken = 1
	},
/area/template_noop)
"z" = (
/obj/structure/chair/fancy/sofa/old{
	dir = 1
	},
/turf/open/floor/carpet/red,
/area/template_noop)
"A" = (
/obj/effect/spawner/random/trash/grille_or_waste,
/turf/open/floor/plating,
/area/template_noop)
"B" = (
/obj/structure/rack,
/obj/item/storage/toolbox/mechanical,
/turf/open/floor/plating,
/area/template_noop)
"C" = (
/obj/machinery/light/small{
	dir = 4
	},
/turf/open/floor/plating,
/area/template_noop)
"D" = (
/obj/structure/chair/fancy/sofa/old/left{
	dir = 1
	},
/turf/open/floor/carpet/red,
/area/template_noop)
"E" = (
/obj/structure/rack,
/obj/effect/spawner/random/maintenance/eight,
/turf/open/floor/plating,
/area/template_noop)
"F" = (
/obj/structure/table,
/obj/machinery/chem_dispenser/drinks,
/obj/machinery/light/small{
	dir = 1
	},
/turf/open/floor/iron/cafeteria,
/area/template_noop)
"H" = (
/obj/machinery/vending/autodrobe,
/turf/open/floor/wood,
/area/template_noop)
"I" = (
/turf/open/floor/plating{
	broken = 1
	},
/area/template_noop)
"J" = (
/obj/structure/table/wood,
/obj/item/reagent_containers/cup/glass/drinkingglass/shotglass{
	pixel_x = 4;
	pixel_y = 4
	},
/turf/open/floor/iron/cafeteria,
/area/template_noop)
"K" = (
/obj/machinery/door/airlock/wood,
/turf/open/floor/plating,
/area/template_noop)
"L" = (
/turf/open/floor/wood,
/area/template_noop)
"M" = (
/obj/structure/table/wood,
/obj/structure/window/reinforced/spawner/directional/west,
/obj/effect/spawner/random/entertainment/gambling,
/turf/open/floor/iron/cafeteria,
/area/template_noop)
"N" = (
/obj/item/kirbyplants/random,
/turf/open/floor/wood,
/area/template_noop)
"O" = (
/obj/effect/decal/cleanable/insectguts,
/turf/open/floor/plating,
/area/template_noop)
"P" = (
/obj/structure/chair/stool/bar,
/turf/open/floor/plating,
/area/template_noop)
"Q" = (
/obj/structure/chair/fancy/sofa/old/right{
	dir = 1
	},
/turf/open/floor/carpet/red,
/area/template_noop)
"R" = (
/turf/open/floor/carpet/red,
/area/template_noop)
"S" = (
/obj/structure/reagent_dispensers/watertank,
/turf/open/floor/plating,
/area/template_noop)
"T" = (
/obj/structure/window/reinforced/tinted/frosted/spawner/directional/east,
/obj/structure/table/wood,
/obj/effect/spawner/random/decoration/glowstick,
/turf/open/floor/carpet,
/area/template_noop)
"U" = (
/obj/effect/landmark/event_spawn,
/turf/open/floor/wood,
/area/template_noop)
"V" = (
/obj/effect/spawner/structure/window/reinforced,
/turf/open/floor/plating,
/area/template_noop)
"W" = (
/obj/structure/reagent_dispensers/fueltank,
/turf/open/floor/plating,
/area/template_noop)
"X" = (
/obj/structure/window/reinforced/tinted/frosted/spawner/directional/east,
/obj/effect/landmark/start/randommaint/magician,
/obj/structure/chair/stool/bar,
/obj/machinery/light/small{
	dir = 1
	},
/obj/structure/sign/poster/contraband/syndicate_recruitment{
	pixel_x = 4;
	pixel_y = 33
	},
/turf/open/floor/carpet,
/area/template_noop)
"Y" = (
/turf/open/floor/monotile/steel,
/area/template_noop)
"Z" = (
/obj/structure/grille/broken,
/turf/open/floor/plating{
	broken = 1
	},
/area/template_noop)

(1,1,1) = {"
S
a
C
s
a
a
a
o
a
a
"}
(2,1,1) = {"
A
a
l
l
V
V
l
l
v
I
"}
(3,1,1) = {"
a
O
l
H
L
N
D
r
D
a
"}
(4,1,1) = {"
Z
k
l
p
j
L
z
R
z
o
"}
(5,1,1) = {"
y
E
V
L
U
L
Q
b
Q
a
"}
(6,1,1) = {"
c
B
V
L
L
L
Y
Y
Y
h
"}
(7,1,1) = {"
a
W
l
K
l
l
d
M
g
P
"}
(8,1,1) = {"
a
t
l
i
u
l
F
a
J
q
"}
(9,1,1) = {"
a
e
l
X
T
l
n
m
f
P
"}
(10,1,1) = {"
a
a
Z
a
a
w
a
I
x
a
"}
