//MAP CONVERTED BY dmm2tgm.py THIS HEADER COMMENT PREVENTS RECONVERSION, DO NOT REMOVE
"a" = (
/turf/closed/wall/mineral/titanium,
/area/shuttle/labor)
"b" = (
/obj/effect/spawner/structure/window/reinforced/shuttle,
/turf/open/floor/plating,
/area/shuttle/labor)
"c" = (
/obj/machinery/computer/shuttle_flight/labor{
	dir = 4
	},
/obj/structure/reagent_dispensers/peppertank{
	pixel_x = -31
	},
/obj/effect/turf_decal/siding/dark,
/turf/open/floor/mineral/plastitanium,
/area/shuttle/labor)
"d" = (
/obj/structure/chair/fancy/shuttle{
	dir = 1
	},
/obj/effect/turf_decal/siding/dark,
/turf/open/floor/mineral/plastitanium,
/area/shuttle/labor)
"e" = (
/obj/structure/table,
/obj/item/folder/red,
/obj/item/restraints/handcuffs,
/obj/machinery/recharger{
	pixel_y = 4
	},
/obj/item/gps/security,
/obj/effect/turf_decal/siding/dark,
/turf/open/floor/mineral/plastitanium,
/area/shuttle/labor)
"i" = (
/obj/machinery/door/airlock/titanium{
	name = "Labor Shuttle Airlock";
	req_access_txt = "2"
	},
/obj/structure/fans/tiny,
/obj/effect/turf_decal/stripes/closeup{
	dir = 1
	},
/turf/open/floor/mineral/plastitanium,
/area/shuttle/labor)
"j" = (
/obj/machinery/button/flasher{
	id = "gulagshuttleflasher";
	name = "Flash Control";
	req_access_txt = "1";
	pixel_x = -25
	},
/obj/machinery/light{
	dir = 8
	},
/obj/effect/turf_decal/tile/neutral/opposingcorners,
/obj/structure/window/reinforced/spawner/directional/south,
/turf/open/floor/mineral/plastitanium/red,
/area/shuttle/labor)
"k" = (
/obj/machinery/mineral/stacking_machine/laborstacker{
	input_dir = 2;
	output_dir = 1
	},
/obj/machinery/light{
	dir = 4
	},
/obj/effect/turf_decal/stripes/box,
/turf/open/floor/mineral/plastitanium,
/area/shuttle/labor)
"l" = (
/obj/effect/turf_decal/tile/neutral/opposingcorners,
/obj/machinery/door/window/southleft{
	name = "Gulag";
	req_one_access_txt = "63;42;38"
	},
/obj/structure/window/reinforced/spawner/directional/east,
/turf/open/floor/mineral/plastitanium/red,
/area/shuttle/labor)
"u" = (
/obj/machinery/door/airlock/titanium{
	id_tag = "prisonshuttle";
	name = "Labor Shuttle Airlock"
	},
/obj/docking_port/mobile{
	dir = 8;
	dwidth = 2;
	height = 5;
	id = "laborcamp";
	name = "labor camp shuttle";
	port_direction = 4;
	width = 9
	},
/obj/structure/fans/tiny,
/obj/effect/turf_decal/stripes/closeup{
	dir = 1
	},
/turf/open/floor/mineral/plastitanium,
/area/shuttle/labor)
"v" = (
/turf/closed/wall/mineral/titanium/nodiagonal,
/area/shuttle/labor)
"w" = (
/obj/effect/spawner/structure/window/reinforced/shuttle,
/obj/structure/shuttle/engine/heater,
/turf/open/floor/plating,
/area/shuttle/labor)
"x" = (
/turf/closed/wall/mineral/plastitanium,
/area/shuttle/labor)
"y" = (
/obj/structure/shuttle/engine/propulsion,
/obj/effect/turf_decal/stripes/line,
/turf/open/floor/plating/airless,
/area/shuttle/labor)
"B" = (
/obj/effect/turf_decal/tile/neutral/opposingcorners,
/turf/open/floor/mineral/plastitanium/red,
/area/shuttle/labor)
"C" = (
/obj/structure/chair/fancy/shuttle{
	dir = 4
	},
/obj/effect/turf_decal/tile/neutral/opposingcorners,
/turf/open/floor/mineral/plastitanium,
/area/shuttle/labor)
"D" = (
/obj/effect/turf_decal/tile/neutral/opposingcorners,
/turf/open/floor/mineral/plastitanium,
/area/shuttle/labor)
"F" = (
/obj/effect/turf_decal/tile/neutral/opposingcorners,
/obj/structure/chair/fancy/shuttle{
	dir = 4
	},
/turf/open/floor/mineral/plastitanium,
/area/shuttle/labor)
"J" = (
/obj/machinery/flasher{
	id = "gulagshuttleflasher";
	pixel_x = 25
	},
/obj/structure/chair/fancy/shuttle{
	dir = 8
	},
/obj/effect/turf_decal/tile/neutral/opposingcorners,
/turf/open/floor/mineral/plastitanium,
/area/shuttle/labor)
"L" = (
/obj/machinery/mineral/stacking_unit_console{
	machinedir = 2;
	pixel_x = 30;
	pixel_y = 30
	},
/obj/effect/turf_decal/tile/neutral/opposingcorners,
/turf/open/floor/mineral/plastitanium/red,
/area/shuttle/labor)
"M" = (
/obj/structure/closet/crate,
/obj/effect/turf_decal/tile/neutral/opposingcorners,
/obj/effect/turf_decal/bot,
/turf/open/floor/mineral/plastitanium,
/area/shuttle/labor)
"R" = (
/obj/machinery/mineral/labor_claim_console{
	machinedir = 1;
	pixel_x = 30
	},
/obj/effect/turf_decal/tile/neutral/opposingcorners,
/obj/effect/turf_decal/loading_area{
	dir = 1
	},
/turf/open/floor/mineral/plastitanium,
/area/shuttle/labor)

(1,1,1) = {"
a
a
b
a
b
a
b
v
x
"}
(2,1,1) = {"
b
c
B
j
F
C
M
w
y
"}
(3,1,1) = {"
b
d
B
l
D
D
D
w
y
"}
(4,1,1) = {"
b
e
L
k
R
J
D
w
y
"}
(5,1,1) = {"
a
a
i
a
a
a
u
v
x
"}
