//MAP CONVERTED BY dmm2tgm.py THIS HEADER COMMENT PREVENTS RECONVERSION, DO NOT REMOVE
"a" = (
/turf/closed/wall/mineral/titanium,
/area/shuttle/labor)
"b" = (
/obj/effect/spawner/structure/window/shuttle,
/turf/open/floor/plating,
/area/shuttle/labor)
"e" = (
/obj/structure/window/reinforced{
	dir = 1;
	layer = 2.9
	},
/obj/effect/turf_decal/stripes/line,
/obj/machinery/atmospherics/components/unary/shuttle/engine_heater{
	dir = 1
	},
/turf/open/floor/plating/airless,
/area/shuttle/labor)
"f" = (
/obj/structure/grille,
/obj/structure/cable/yellow{
	icon_state = "0-8"
	},
/obj/structure/window/shuttle,
/turf/open/floor/plating,
/area/shuttle/labor)
"g" = (
/turf/open/floor/mineral/plastitanium/red,
/area/shuttle/labor)
"i" = (
/obj/machinery/shuttle_weapon/laser,
/turf/closed/wall/mineral/titanium,
/area/shuttle/labor)
"j" = (
/obj/machinery/door/airlock/shuttle{
	name = "Labor Shuttle Airlock";
	req_access_txt = "2"
	},
/obj/effect/turf_decal/stripes/line{
	dir = 8
	},
/obj/effect/turf_decal/stripes/line{
	dir = 4
	},
/turf/open/floor/plating,
/area/shuttle/labor)
"k" = (
/obj/machinery/door/airlock/shuttle{
	name = "Labor Shuttle Airlock";
	req_access_txt = "2"
	},
/obj/effect/turf_decal/stripes/line,
/turf/open/floor/plasteel/white,
/area/shuttle/labor)
"l" = (
/turf/closed/wall/mineral/titanium/nodiagonal,
/area/shuttle/labor)
"n" = (
/obj/effect/turf_decal/stripes/line{
	dir = 9
	},
/turf/open/floor/plasteel,
/area/shuttle/labor)
"o" = (
/obj/structure/reagent_dispensers/peppertank{
	pixel_x = -31
	},
/obj/machinery/computer/shuttle_flight/labor,
/turf/open/floor/mineral/plastitanium/red,
/area/shuttle/labor)
"p" = (
/obj/machinery/mineral/stacking_unit_console{
	machinedir = 2;
	pixel_x = 30;
	pixel_y = 30
	},
/obj/machinery/atmospherics/pipe/simple/supplymain/hidden,
/turf/open/floor/mineral/plastitanium/red,
/area/shuttle/labor)
"q" = (
/obj/effect/turf_decal/stripes/line{
	dir = 10
	},
/obj/structure/chair/fancy/shuttle{
	dir = 4
	},
/turf/open/floor/plasteel,
/area/shuttle/labor)
"s" = (
/obj/machinery/flasher{
	id = "gulagshuttleflasher";
	pixel_x = 25
	},
/obj/effect/turf_decal/stripes/line{
	dir = 6
	},
/obj/structure/chair/fancy/shuttle{
	dir = 8
	},
/turf/open/floor/plasteel,
/area/shuttle/labor)
"u" = (
/obj/machinery/atmospherics/components/unary/portables_connector,
/obj/machinery/portable_atmospherics/canister/toxins,
/obj/item/wrench,
/turf/open/floor/mineral/plastitanium/red,
/area/shuttle/labor)
"w" = (
/obj/machinery/door/airlock/shuttle{
	id_tag = "prisonshuttle";
	name = "Labor Shuttle Airlock"
	},
/obj/docking_port/mobile{
	dir = 8;
	dwidth = 2;
	faction_type = /datum/faction/station;
	height = 5;
	id = "laborcamp";
	name = "labor camp shuttle";
	port_direction = 4;
	width = 9
	},
/obj/effect/turf_decal/stripes/line{
	dir = 8
	},
/obj/effect/turf_decal/stripes/line{
	dir = 4
	},
/turf/open/floor/plating,
/area/shuttle/labor)
"y" = (
/obj/effect/decal/cleanable/dirt,
/obj/effect/turf_decal/stripes/line{
	dir = 1
	},
/obj/machinery/light{
	dir = 1
	},
/obj/machinery/atmospherics/pipe/simple/supplymain/hidden{
	dir = 6
	},
/turf/open/floor/plasteel,
/area/shuttle/labor)
"z" = (
/obj/effect/turf_decal/bot,
/obj/machinery/atmospherics/pipe/simple/supplymain/hidden{
	dir = 10
	},
/turf/open/floor/plasteel,
/area/shuttle/labor)
"C" = (
/obj/machinery/atmospherics/components/unary/shuttle/engine_heater{
	dir = 1
	},
/turf/closed/wall/mineral/titanium,
/area/shuttle/labor)
"F" = (
/obj/machinery/button/flasher{
	id = "gulagshuttleflasher";
	name = "Flash Control";
	pixel_y = -26;
	req_access_txt = "1"
	},
/obj/machinery/light,
/obj/structure/chair/office{
	dir = 1
	},
/turf/open/floor/mineral/plastitanium/red,
/area/shuttle/labor)
"I" = (
/obj/machinery/mineral/labor_claim_console{
	machinedir = 1;
	pixel_x = 30
	},
/obj/effect/decal/cleanable/dirt,
/obj/effect/turf_decal/stripes/line{
	dir = 5
	},
/obj/machinery/atmospherics/pipe/simple/supplymain/hidden{
	dir = 9
	},
/turf/open/floor/plasteel,
/area/shuttle/labor)
"K" = (
/obj/machinery/mineral/stacking_machine/laborstacker{
	input_dir = 2;
	output_dir = 1
	},
/obj/effect/turf_decal/stripes/line,
/obj/machinery/atmospherics/pipe/simple/supplymain/hidden,
/turf/open/floor/plasteel/white,
/area/shuttle/labor)
"M" = (
/obj/effect/decal/cleanable/dirt,
/obj/effect/turf_decal/bot,
/obj/machinery/atmospherics/pipe/manifold4w/supplymain/hidden,
/turf/open/floor/plasteel,
/area/shuttle/labor)
"O" = (
/obj/item/clothing/suit/hazardvest{
	desc = "A high-visibility lifejacket complete with whistle and slot for oxygen tanks.";
	name = "emergency lifejacket"
	},
/obj/item/clothing/suit/hazardvest{
	desc = "A high-visibility lifejacket complete with whistle and slot for oxygen tanks.";
	name = "emergency lifejacket"
	},
/obj/item/clothing/suit/hazardvest{
	desc = "A high-visibility lifejacket complete with whistle and slot for oxygen tanks.";
	name = "emergency lifejacket"
	},
/obj/item/clothing/suit/hazardvest{
	desc = "A high-visibility lifejacket complete with whistle and slot for oxygen tanks.";
	name = "emergency lifejacket"
	},
/obj/item/clothing/suit/hazardvest{
	desc = "A high-visibility lifejacket complete with whistle and slot for oxygen tanks.";
	name = "emergency lifejacket"
	},
/obj/item/tank/internals/emergency_oxygen{
	pixel_x = 3
	},
/obj/item/tank/internals/emergency_oxygen{
	pixel_x = 3
	},
/obj/item/tank/internals/emergency_oxygen{
	pixel_x = 3
	},
/obj/item/tank/internals/emergency_oxygen{
	pixel_x = 3
	},
/obj/item/tank/internals/emergency_oxygen{
	pixel_x = 3
	},
/obj/item/clothing/mask/breath{
	pixel_x = -3;
	pixel_y = -3
	},
/obj/item/clothing/mask/breath{
	pixel_x = -3;
	pixel_y = -3
	},
/obj/item/clothing/mask/breath{
	pixel_x = -3;
	pixel_y = -3
	},
/obj/item/clothing/mask/breath{
	pixel_x = -3;
	pixel_y = -3
	},
/obj/item/clothing/mask/breath{
	pixel_x = -3;
	pixel_y = -3
	},
/obj/item/clothing/head/hardhat/orange{
	name = "protective hat";
	pixel_y = 9
	},
/obj/item/clothing/head/hardhat/orange{
	name = "protective hat";
	pixel_y = 9
	},
/obj/item/clothing/head/hardhat/orange{
	name = "protective hat";
	pixel_y = 9
	},
/obj/item/clothing/head/hardhat/orange{
	name = "protective hat";
	pixel_y = 9
	},
/obj/item/clothing/head/hardhat/orange{
	name = "protective hat";
	pixel_y = 9
	},
/obj/structure/closet/crate/internals,
/obj/effect/decal/cleanable/dirt,
/obj/effect/turf_decal/delivery,
/obj/machinery/atmospherics/pipe/simple/supplymain/hidden{
	dir = 6
	},
/turf/open/floor/plasteel,
/area/shuttle/labor)
"R" = (
/obj/machinery/computer/weapons,
/turf/open/floor/mineral/plastitanium/red,
/area/shuttle/labor)
"W" = (
/obj/effect/turf_decal/stripes/line,
/obj/machinery/atmospherics/pipe/simple/supplymain/hidden,
/turf/open/floor/plasteel,
/area/shuttle/labor)
"X" = (
/obj/effect/turf_decal/stripes/line,
/obj/machinery/shuttle/engine/plasma{
	dir = 1
	},
/turf/open/floor/plating/airless,
/area/shuttle/labor)

(1,1,1) = {"
i
a
f
a
a
f
a
a
a
"}
(2,1,1) = {"
b
o
g
k
n
q
O
C
X
"}
(3,1,1) = {"
b
R
F
l
y
W
M
e
X
"}
(4,1,1) = {"
b
u
p
K
I
s
z
C
X
"}
(5,1,1) = {"
i
a
j
a
a
a
w
a
a
"}
