//MAP CONVERTED BY dmm2tgm.py THIS HEADER COMMENT PREVENTS RECONVERSION, DO NOT REMOVE
"a" = (
/obj/machinery/mineral/stacking_machine/laborstacker{
	input_dir = 2;
	output_dir = 1
	},
/obj/effect/turf_decal/stripes/line{
	dir = 8
	},
/turf/open/floor/mineral/plastitanium/red,
/area/shuttle/labor)
"b" = (
/obj/machinery/mineral/labor_claim_console{
	machinedir = 1;
	pixel_x = 30
	},
/obj/effect/turf_decal/stripes/corner{
	dir = 1
	},
/turf/open/floor/mineral/plastitanium/red,
/area/shuttle/labor)
"f" = (
/obj/machinery/flasher{
	id = "gulagshuttleflasher";
	pixel_x = -24
	},
/obj/effect/turf_decal/stripes/line,
/obj/machinery/power/smes/engineering,
/obj/structure/cable/yellow{
	icon_state = "0-4"
	},
/turf/open/floor/mineral/plastitanium/red,
/area/shuttle/labor)
"g" = (
/obj/effect/turf_decal/bot,
/obj/machinery/computer/weapons,
/turf/open/floor/mineral/plastitanium,
/area/shuttle/labor)
"h" = (
/obj/structure/reagent_dispensers/peppertank{
	pixel_x = -31
	},
/obj/effect/turf_decal/stripes/line{
	dir = 1
	},
/obj/effect/turf_decal/stripes/corner,
/turf/open/floor/mineral/plastitanium/red,
/area/shuttle/labor)
"i" = (
/obj/effect/spawner/structure/window/shuttle,
/obj/structure/cable/yellow{
	icon_state = "1-8"
	},
/obj/structure/cable/yellow{
	icon_state = "1-4"
	},
/obj/structure/cable/yellow,
/obj/machinery/power/engine_capacitor_bank{
	dir = 1
	},
/turf/open/floor/plating/airless,
/area/shuttle/labor)
"p" = (
/obj/effect/turf_decal/stripes/line{
	dir = 1
	},
/obj/machinery/light{
	dir = 1
	},
/turf/open/floor/mineral/plastitanium/red,
/area/shuttle/labor)
"r" = (
/obj/effect/turf_decal/caution/stand_clear{
	dir = 8
	},
/turf/open/floor/mineral/plastitanium,
/area/shuttle/labor)
"t" = (
/obj/machinery/door/airlock/titanium{
	name = "Labor Shuttle Airlock";
	req_access_txt = "2"
	},
/turf/open/floor/mineral/titanium,
/area/shuttle/labor)
"x" = (
/obj/machinery/shuttle_weapon/laser,
/turf/closed/wall/mineral/titanium,
/area/shuttle/labor)
"y" = (
/turf/closed/wall/mineral/titanium,
/area/shuttle/labor)
"A" = (
/obj/machinery/mineral/stacking_unit_console{
	machinedir = 2;
	pixel_x = 30;
	pixel_y = -4
	},
/obj/effect/turf_decal/stripes/line{
	dir = 1
	},
/obj/effect/turf_decal/stripes/corner{
	dir = 8
	},
/turf/open/floor/mineral/plastitanium/red,
/area/shuttle/labor)
"B" = (
/obj/effect/spawner/structure/window/shuttle,
/turf/open/floor/plating,
/area/shuttle/labor)
"D" = (
/obj/effect/turf_decal/caution/stand_clear{
	dir = 8
	},
/obj/effect/turf_decal/stripes/corner{
	dir = 8
	},
/turf/open/floor/mineral/plastitanium/red,
/area/shuttle/labor)
"E" = (
/obj/machinery/door/airlock/titanium{
	id_tag = "prisonshuttle";
	name = "Labor Shuttle Airlock"
	},
/obj/docking_port/mobile{
	dir = 8;
	dwidth = 2;
	faction_type = /datum/faction/station;
	height = 5;
	id = "laborcamp";
	name = "labor camp shuttle";
	port_direction = 4;
	width = 8
	},
/turf/open/floor/mineral/titanium,
/area/shuttle/labor)
"F" = (
/obj/machinery/door/airlock/titanium{
	name = "Labor Shuttle Airlock";
	req_access_txt = "2"
	},
/obj/effect/turf_decal/stripes/line{
	dir = 4
	},
/turf/open/floor/mineral/plastitanium/red,
/area/shuttle/labor)
"H" = (
/turf/closed/wall/mineral/plastitanium,
/area/shuttle/labor)
"J" = (
/obj/structure/chair/fancy/shuttle{
	dir = 1
	},
/obj/effect/turf_decal/stripes/line,
/obj/structure/cable/yellow{
	icon_state = "2-8"
	},
/turf/open/floor/mineral/plastitanium/red,
/area/shuttle/labor)
"O" = (
/obj/machinery/shuttle/engine/ion/burst{
	dir = 1
	},
/turf/open/floor/plating/airless,
/area/shuttle/labor)
"Q" = (
/obj/machinery/button/flasher{
	id = "gulagshuttleflasher";
	name = "Flash Control";
	pixel_y = -26;
	req_access_txt = "1"
	},
/obj/effect/turf_decal/stripes/line{
	dir = 1
	},
/obj/effect/turf_decal/stripes/line,
/obj/machinery/light,
/obj/structure/chair/fancy/shuttle{
	dir = 1
	},
/turf/open/floor/mineral/plastitanium/red,
/area/shuttle/labor)
"R" = (
/obj/effect/spawner/structure/window/shuttle,
/obj/structure/cable/yellow{
	icon_state = "0-8"
	},
/obj/machinery/power/engine_capacitor_bank{
	dir = 1
	},
/turf/open/floor/plating/airless,
/area/shuttle/labor)
"S" = (
/obj/effect/turf_decal/stripes/corner{
	dir = 4
	},
/obj/machinery/power/terminal,
/turf/open/floor/mineral/plastitanium/red,
/area/shuttle/labor)
"U" = (
/turf/closed/wall/mineral/titanium/nodiagonal,
/area/shuttle/labor)
"V" = (
/obj/effect/spawner/structure/window/shuttle,
/obj/structure/cable/yellow{
	icon_state = "0-4"
	},
/obj/machinery/power/engine_capacitor_bank{
	dir = 1
	},
/turf/open/floor/plating/airless,
/area/shuttle/labor)
"W" = (
/obj/effect/turf_decal/delivery,
/obj/machinery/computer/shuttle_flight/labor,
/turf/open/floor/mineral/plastitanium,
/area/shuttle/labor)

(1,1,1) = {"
x
B
y
y
B
y
U
H
"}
(2,1,1) = {"
B
W
h
F
S
f
V
O
"}
(3,1,1) = {"
B
g
Q
y
p
J
i
O
"}
(4,1,1) = {"
B
r
A
a
b
D
R
O
"}
(5,1,1) = {"
x
t
y
y
y
E
U
H
"}
