//MAP CONVERTED BY dmm2tgm.py THIS HEADER COMMENT PREVENTS RECONVERSION, DO NOT REMOVE
"a" = (
/obj/structure/rack,
/obj/effect/turf_decal/delivery,
/obj/machinery/light{
	dir = 4
	},
/obj/effect/spawner/lootdrop/ruinloot/armory,
/turf/open/floor/iron,
/area/ruin/unpowered)
"b" = (
/obj/effect/turf_decal/stripes/line,
/obj/effect/turf_decal/stripes/line{
	dir = 1
	},
/obj/effect/abstract/doorway_marker,
/turf/open/floor/iron/dark,
/area/ruin/unpowered)
"d" = (
/obj/structure/rack,
/obj/item/storage/box/sec_barricades,
/obj/effect/turf_decal/delivery,
/obj/effect/spawner/lootdrop/ruinloot/security,
/turf/open/floor/iron,
/area/ruin/unpowered)
"e" = (
/obj/structure/sign/warning/securearea{
	pixel_x = -32
	},
/turf/template_noop,
/area/template_noop)
"f" = (
/obj/effect/spawner/structure/window/reinforced,
/turf/open/floor/plating,
/area/ruin/unpowered)
"j" = (
/obj/effect/turf_decal/stripes/line{
	dir = 10
	},
/obj/effect/turf_decal/stripes/corner{
	dir = 4
	},
/turf/open/floor/iron/dark,
/area/ruin/unpowered)
"k" = (
/obj/structure/rack,
/obj/effect/turf_decal/delivery,
/turf/open/floor/iron,
/area/ruin/unpowered)
"l" = (
/obj/effect/turf_decal/bot,
/obj/structure/closet/secure_closet,
/obj/effect/spawner/lootdrop/ruinloot/armory,
/turf/open/floor/iron,
/area/ruin/unpowered)
"m" = (
/obj/effect/turf_decal/stripes/line,
/obj/effect/turf_decal/stripes/line{
	dir = 1
	},
/turf/open/floor/iron/dark,
/area/ruin/unpowered)
"o" = (
/obj/effect/turf_decal/stripes/line{
	dir = 5
	},
/obj/effect/turf_decal/stripes/corner{
	dir = 8
	},
/turf/open/floor/iron/dark,
/area/ruin/unpowered)
"p" = (
/obj/structure/sign/warning/securearea{
	pixel_y = 32
	},
/turf/template_noop,
/area/template_noop)
"q" = (
/obj/vehicle/ridden/secway,
/obj/effect/turf_decal/bot,
/obj/effect/turf_decal/tile/red/fourcorners/contrasted,
/turf/open/floor/iron/dark,
/area/ruin/unpowered)
"r" = (
/obj/effect/turf_decal/delivery,
/obj/structure/sign/poster/official/ian{
	pixel_y = 32
	},
/obj/item/rack_parts,
/turf/open/floor/iron,
/area/ruin/unpowered)
"t" = (
/obj/structure/lattice,
/turf/template_noop,
/area/template_noop)
"u" = (
/obj/effect/turf_decal/stripes/line{
	dir = 4
	},
/obj/effect/turf_decal/stripes/line{
	dir = 8
	},
/turf/open/floor/iron/dark,
/area/ruin/unpowered)
"v" = (
/obj/effect/turf_decal/stripes/line{
	dir = 8
	},
/obj/effect/turf_decal/stripes/line{
	dir = 4
	},
/turf/open/floor/plating,
/area/ruin/unpowered)
"x" = (
/turf/template_noop,
/area/template_noop)
"z" = (
/obj/structure/closet/secure_closet{
	name = "contraband locker";
	req_access_txt = "3"
	},
/obj/effect/turf_decal/bot,
/obj/effect/spawner/lootdrop/ruinloot/armory,
/turf/open/floor/iron,
/area/ruin/unpowered)
"A" = (
/obj/effect/turf_decal/stripes/line{
	dir = 9
	},
/obj/effect/turf_decal/stripes/corner,
/turf/open/floor/iron/dark,
/area/ruin/unpowered)
"B" = (
/obj/structure/rack,
/obj/effect/turf_decal/delivery,
/obj/effect/spawner/lootdrop/ruinloot/armory,
/turf/open/floor/iron,
/area/ruin/unpowered)
"E" = (
/obj/effect/turf_decal/stripes/line{
	dir = 8
	},
/obj/effect/turf_decal/stripes/line{
	dir = 4
	},
/turf/open/floor/iron/dark,
/area/ruin/unpowered)
"G" = (
/obj/effect/turf_decal/box,
/obj/effect/turf_decal/tile/red/fourcorners/contrasted,
/turf/open/floor/iron/dark,
/area/ruin/unpowered)
"I" = (
/obj/structure/rack,
/obj/effect/turf_decal/delivery,
/obj/effect/spawner/lootdrop/ruinloot/security,
/turf/open/floor/iron,
/area/ruin/unpowered)
"J" = (
/obj/structure/rack,
/obj/effect/turf_decal/delivery,
/obj/effect/turf_decal/tile/red/fourcorners/contrasted,
/turf/open/floor/iron/dark,
/area/ruin/unpowered)
"K" = (
/obj/structure/sign/warning/securearea{
	pixel_x = 32
	},
/turf/template_noop,
/area/template_noop)
"L" = (
/obj/effect/turf_decal/stripes/line{
	dir = 6
	},
/obj/effect/turf_decal/stripes/corner{
	dir = 1
	},
/turf/open/floor/iron/dark,
/area/ruin/unpowered)
"M" = (
/turf/closed/wall/r_wall,
/area/ruin/unpowered)
"N" = (
/obj/effect/turf_decal/delivery,
/obj/machinery/light{
	dir = 8
	},
/obj/item/rack_parts,
/turf/open/floor/iron,
/area/ruin/unpowered)
"Q" = (
/obj/effect/turf_decal/stripes/line{
	dir = 1
	},
/obj/effect/turf_decal/stripes/line,
/turf/open/floor/iron/dark,
/area/ruin/unpowered)
"U" = (
/obj/structure/rack,
/obj/item/storage/box/teargas{
	pixel_x = 1;
	pixel_y = -2
	},
/obj/effect/turf_decal/delivery,
/turf/open/floor/iron,
/area/ruin/unpowered)
"W" = (
/obj/machinery/door/airlock/security{
	name = "Armory";
	req_access_txt = "3";
	security_level = 6
	},
/obj/effect/turf_decal/stripes/line,
/obj/effect/turf_decal/stripes/line{
	dir = 1
	},
/turf/open/floor/iron/dark,
/area/ruin/unpowered)
"X" = (
/obj/structure/rack,
/obj/effect/turf_decal/delivery,
/obj/effect/spawner/lootdrop/ruinloot/armory,
/obj/effect/turf_decal/tile/red/fourcorners/contrasted,
/turf/open/floor/iron/dark,
/area/ruin/unpowered)
"Y" = (
/obj/effect/turf_decal/bot,
/obj/effect/turf_decal/tile/red/fourcorners/contrasted,
/turf/open/floor/iron/dark,
/area/ruin/unpowered)

(1,1,1) = {"
M
M
M
M
M
M
M
M
M
M
M
M
M
"}
(2,1,1) = {"
M
x
x
e
x
t
x
t
x
x
e
x
M
"}
(3,1,1) = {"
M
x
x
x
M
M
M
M
M
x
x
x
M
"}
(4,1,1) = {"
M
x
x
M
M
B
N
U
M
M
t
t
M
"}
(5,1,1) = {"
M
t
t
M
d
A
E
E
j
M
p
x
M
"}
(6,1,1) = {"
M
x
x
M
z
Q
Y
X
m
M
f
f
M
"}
(7,1,1) = {"
M
x
x
M
r
Q
G
J
m
W
v
v
b
"}
(8,1,1) = {"
M
x
x
M
l
Q
q
J
m
M
f
f
M
"}
(9,1,1) = {"
M
t
t
M
B
o
u
u
L
M
p
x
M
"}
(10,1,1) = {"
M
x
x
M
M
k
a
I
M
M
t
t
M
"}
(11,1,1) = {"
M
x
x
x
M
M
M
M
M
x
x
x
M
"}
(12,1,1) = {"
M
x
x
K
x
t
x
t
x
x
K
x
M
"}
(13,1,1) = {"
M
M
M
M
M
M
M
M
M
M
M
M
M
"}
