//MAP CONVERTED BY dmm2tgm.py THIS HEADER COMMENT PREVENTS RECONVERSION, DO NOT REMOVE
"aa" = (
/obj/structure/closet/secure_closet/medical2{
	req_access = list(29)
	},
/obj/item/radio/intercom{
	pixel_y = 24
	},
/turf/open/floor/iron/white,
/area/ruin/unpowered)
"ab" = (
/obj/effect/turf_decal/delivery,
/obj/structure/rack,
/obj/item/storage/belt/utility,
/obj/item/book/manual/wiki/robotics_cyborgs{
	pixel_x = 2;
	pixel_y = 5
	},
/obj/machinery/light{
	dir = 1
	},
/turf/open/floor/iron,
/area/ruin/unpowered)
"ac" = (
/obj/effect/abstract/open_area_marker,
/turf/open/floor/iron,
/area/ruin/unpowered)
"ad" = (
/obj/machinery/door/window/eastleft{
	dir = 1;
	name = "Robotics Deliveries";
	req_access_txt = "29"
	},
/obj/effect/turf_decal/stripes/line{
	dir = 1
	},
/obj/effect/turf_decal/delivery,
/turf/open/floor/iron,
/area/ruin/unpowered)
"ae" = (
/obj/effect/spawner/lootdrop/ruinloot/science,
/turf/open/floor/iron,
/area/ruin/unpowered)
"af" = (
/obj/effect/turf_decal/stripes/line{
	dir = 1
	},
/turf/open/floor/iron/dark,
/area/ruin/unpowered)
"ag" = (
/obj/effect/turf_decal/delivery,
/obj/structure/table,
/obj/item/stack/sheet/iron/fifty,
/obj/item/stack/sheet/iron/fifty,
/obj/item/stack/sheet/iron/fifty,
/obj/item/stack/sheet/glass{
	amount = 40;
	pixel_x = 3;
	pixel_y = -4
	},
/obj/machinery/requests_console{
	pixel_y = 32
	},
/turf/open/floor/iron,
/area/ruin/unpowered)
"ah" = (
/obj/effect/turf_decal/stripes/line{
	dir = 8
	},
/turf/open/floor/iron/dark,
/area/ruin/unpowered)
"ai" = (
/obj/structure/window/reinforced/spawner/directional/west,
/obj/effect/turf_decal/stripes/line{
	dir = 10
	},
/obj/machinery/vending/wardrobe/robo_wardrobe{
	pixel_x = 3
	},
/turf/open/floor/iron/dark,
/area/ruin/unpowered)
"aj" = (
/obj/effect/turf_decal/stripes/line{
	dir = 4
	},
/obj/effect/turf_decal/stripes/line{
	dir = 8
	},
/obj/effect/mapping_helpers/airlock/abandoned,
/obj/machinery/door/airlock/hatch,
/turf/open/floor/plating,
/area/ruin/unpowered)
"ak" = (
/obj/effect/spawner/random/structure/crate_abandoned,
/turf/open/floor/plating,
/area/ruin/unpowered)
"al" = (
/obj/effect/spawner/lootdrop/glowstick/lit,
/turf/open/floor/plating,
/area/ruin/unpowered)
"am" = (
/obj/effect/turf_decal/stripes/line{
	dir = 10
	},
/turf/open/floor/iron/dark,
/area/ruin/unpowered)
"an" = (
/obj/machinery/rnd/production/circuit_imprinter/department/science,
/obj/effect/turf_decal/stripes/line{
	dir = 9
	},
/turf/open/floor/iron/dark,
/area/ruin/unpowered)
"ao" = (
/turf/open/floor/plating,
/area/ruin/unpowered)
"ap" = (
/obj/structure/table,
/obj/item/clothing/head/utility/welding{
	pixel_x = -3;
	pixel_y = 5
	},
/obj/item/clothing/glasses/welding,
/obj/effect/turf_decal/stripes/line{
	dir = 6
	},
/turf/open/floor/iron/dark,
/area/ruin/unpowered)
"aq" = (
/obj/structure/table,
/obj/item/stack/sheet/plasteel{
	amount = 10
	},
/obj/item/assembly/flash/handheld/weak,
/obj/item/assembly/flash/handheld/weak,
/obj/item/assembly/flash/handheld/weak,
/obj/item/assembly/flash/handheld/weak,
/obj/item/assembly/flash/handheld/weak,
/obj/item/assembly/flash/handheld/weak,
/obj/effect/turf_decal/stripes/line{
	dir = 4
	},
/obj/effect/spawner/lootdrop/ruinloot/science,
/obj/effect/spawner/lootdrop/ruinloot/science,
/turf/open/floor/iron,
/area/ruin/unpowered)
"ar" = (
/obj/effect/mapping_helpers/airlock/abandoned,
/obj/machinery/door/airlock/hatch,
/turf/open/floor/plating,
/area/ruin/unpowered)
"as" = (
/obj/structure/table,
/obj/item/circular_saw,
/obj/item/scalpel{
	pixel_y = 12
	},
/turf/open/floor/iron/white,
/area/ruin/unpowered)
"at" = (
/obj/structure/table,
/obj/item/clothing/gloves/color/latex,
/obj/item/surgical_drapes,
/obj/item/cautery,
/turf/open/floor/iron/white,
/area/ruin/unpowered)
"au" = (
/obj/structure/table,
/obj/item/stack/sheet/iron/fifty,
/obj/effect/turf_decal/stripes/line{
	dir = 4
	},
/obj/structure/extinguisher_cabinet{
	pixel_x = -25
	},
/obj/machinery/cell_charger,
/obj/item/stack/sheet/iron/fifty,
/obj/item/stack/sheet/iron/fifty,
/obj/item/stack/sheet/iron/fifty,
/obj/item/stack/sheet/iron/fifty,
/obj/effect/spawner/lootdrop/ruinloot/science,
/obj/effect/spawner/lootdrop/ruinloot/science,
/obj/effect/spawner/lootdrop/ruinloot/science,
/turf/open/floor/iron/dark,
/area/ruin/unpowered)
"av" = (
/obj/effect/turf_decal/bot,
/turf/open/floor/iron,
/area/ruin/unpowered)
"aw" = (
/obj/effect/spawner/lootdrop/glowstick/lit,
/turf/open/floor/iron,
/area/ruin/unpowered)
"ax" = (
/turf/open/floor/iron,
/area/ruin/unpowered)
"ay" = (
/obj/effect/turf_decal/bot,
/turf/open/floor/iron/dark,
/area/ruin/unpowered)
"az" = (
/obj/effect/spawner/structure/window/reinforced,
/turf/open/floor/plating,
/area/ruin/unpowered)
"aA" = (
/turf/closed/wall,
/area/ruin/unpowered)
"aB" = (
/obj/effect/spawner/random/decoration/glowstick/lit,
/turf/open/floor/plating,
/area/ruin/unpowered)
"aC" = (
/obj/effect/turf_decal/stripes/line{
	dir = 9
	},
/turf/open/floor/iron/dark,
/area/ruin/unpowered)
"aD" = (
/obj/effect/turf_decal/stripes/line{
	dir = 4
	},
/turf/open/floor/iron/dark,
/area/ruin/unpowered)
"aE" = (
/obj/machinery/aug_manipulator,
/obj/effect/turf_decal/stripes/line{
	dir = 5
	},
/obj/machinery/newscaster{
	pixel_x = -30
	},
/turf/open/floor/iron/dark,
/area/ruin/unpowered)
"aF" = (
/obj/structure/plasticflaps/opaque,
/turf/open/floor/plating,
/area/ruin/unpowered)
"aG" = (
/turf/template_noop,
/area/template_noop)
"aH" = (
/obj/machinery/modular_fabricator/exosuit_fab,
/obj/effect/turf_decal/bot,
/turf/open/floor/iron,
/area/ruin/unpowered)
"aI" = (
/obj/machinery/holopad,
/turf/open/floor/iron,
/area/ruin/unpowered)
"aJ" = (
/obj/effect/abstract/doorway_marker{
	dir = 8
	},
/turf/open/floor/iron,
/area/ruin/unpowered)
"aK" = (
/obj/effect/turf_decal/stripes/line{
	dir = 4
	},
/turf/open/floor/iron,
/area/ruin/unpowered)
"aL" = (
/obj/effect/turf_decal/stripes/line{
	dir = 10
	},
/obj/structure/rack,
/obj/item/storage/firstaid/regular{
	empty = 1;
	name = "First-Aid (empty)"
	},
/obj/item/storage/firstaid/regular{
	empty = 1;
	name = "First-Aid (empty)"
	},
/obj/item/storage/firstaid/regular{
	empty = 1;
	name = "First-Aid (empty)"
	},
/obj/item/healthanalyzer{
	pixel_x = 4;
	pixel_y = -4
	},
/obj/item/healthanalyzer{
	pixel_x = 4;
	pixel_y = -4
	},
/obj/item/healthanalyzer{
	pixel_x = 4;
	pixel_y = -4
	},
/turf/open/floor/iron/dark,
/area/ruin/unpowered)
"aM" = (
/obj/structure/rack,
/obj/structure/window/reinforced/spawner/directional/east,
/obj/effect/turf_decal/stripes/line{
	dir = 6
	},
/obj/machinery/light,
/obj/effect/spawner/lootdrop/ruinloot/science,
/turf/open/floor/iron/dark,
/area/ruin/unpowered)
"aN" = (
/obj/effect/abstract/doorway_marker{
	dir = 1
	},
/turf/open/floor/iron,
/area/ruin/unpowered)
"aO" = (
/turf/open/floor/iron/dark,
/area/ruin/unpowered)
"aP" = (
/obj/effect/turf_decal/stripes/line{
	dir = 6
	},
/turf/open/floor/iron/dark,
/area/ruin/unpowered)
"aQ" = (
/obj/structure/table,
/obj/item/stack/package_wrap,
/obj/item/stack/package_wrap,
/obj/item/reagent_containers/cup/beaker/large,
/obj/item/reagent_containers/cup/beaker/large,
/obj/effect/turf_decal/stripes/line{
	dir = 4
	},
/obj/effect/spawner/lootdrop/ruinloot/science,
/turf/open/floor/iron,
/area/ruin/unpowered)
"aR" = (
/obj/effect/spawner/lootdrop/crate_spawner,
/turf/open/floor/plating,
/area/ruin/unpowered)
"aS" = (
/obj/structure/table/optable{
	name = "Robotics Operating Table"
	},
/turf/open/floor/iron/white,
/area/ruin/unpowered)
"aT" = (
/obj/machinery/computer/rdconsole/robotics{
	dir = 1
	},
/obj/effect/turf_decal/stripes/line{
	dir = 5
	},
/turf/open/floor/iron/dark,
/area/ruin/unpowered)
"aU" = (
/obj/effect/spawner/random/decoration/glowstick/lit,
/turf/open/floor/iron,
/area/ruin/unpowered)
"aV" = (
/obj/structure/table,
/obj/item/mmi,
/obj/item/mmi,
/obj/item/mmi,
/turf/open/floor/iron/white,
/area/ruin/unpowered)
"aW" = (
/obj/structure/table,
/obj/item/retractor,
/obj/item/hemostat,
/obj/machinery/light{
	dir = 8
	},
/turf/open/floor/iron/white,
/area/ruin/unpowered)
"aX" = (
/obj/structure/curtain,
/obj/effect/turf_decal/stripes/line,
/obj/effect/turf_decal/stripes/line{
	dir = 1
	},
/obj/machinery/door/firedoor,
/turf/open/floor/iron/dark,
/area/ruin/unpowered)
"aY" = (
/obj/structure/bodycontainer/morgue,
/turf/open/floor/iron/white,
/area/ruin/unpowered)
"aZ" = (
/obj/machinery/computer/operating{
	dir = 1;
	name = "Robotics Operating Computer"
	},
/turf/open/floor/iron/white,
/area/ruin/unpowered)
"bm" = (
/obj/effect/turf_decal/stripes/line{
	dir = 5
	},
/obj/machinery/newscaster{
	pixel_x = -30
	},
/turf/open/floor/iron/dark,
/area/ruin/unpowered)
"nd" = (
/obj/structure/table,
/obj/item/stack/package_wrap,
/obj/item/stack/package_wrap,
/obj/item/reagent_containers/cup/beaker/large,
/obj/item/reagent_containers/cup/beaker/large,
/obj/effect/turf_decal/stripes/line{
	dir = 4
	},
/obj/effect/spawner/random/ruinloot/science,
/turf/open/floor/iron,
/area/ruin/unpowered)
"qJ" = (
/obj/structure/table,
/obj/item/stack/sheet/iron/fifty,
/obj/effect/turf_decal/stripes/line{
	dir = 4
	},
/obj/structure/extinguisher_cabinet{
	pixel_x = -25
	},
/obj/machinery/cell_charger,
/obj/item/stack/sheet/iron/fifty,
/obj/item/stack/sheet/iron/fifty,
/obj/item/stack/sheet/iron/fifty,
/obj/item/stack/sheet/iron/fifty,
/obj/effect/spawner/random/ruinloot/science,
/obj/effect/spawner/random/ruinloot/science,
/obj/effect/spawner/random/ruinloot/science,
/turf/open/floor/iron/dark,
/area/ruin/unpowered)
"se" = (
/obj/structure/rack,
/obj/structure/window/reinforced/spawner/directional/east,
/obj/effect/turf_decal/stripes/line{
	dir = 6
	},
/obj/machinery/light,
/obj/effect/spawner/random/ruinloot/science,
/turf/open/floor/iron/dark,
/area/ruin/unpowered)
"Bv" = (
/obj/structure/table,
/obj/item/stack/sheet/plasteel{
	amount = 10
	},
/obj/item/assembly/flash/handheld/weak,
/obj/item/assembly/flash/handheld/weak,
/obj/item/assembly/flash/handheld/weak,
/obj/item/assembly/flash/handheld/weak,
/obj/item/assembly/flash/handheld/weak,
/obj/item/assembly/flash/handheld/weak,
/obj/effect/turf_decal/stripes/line{
	dir = 4
	},
/obj/effect/spawner/random/ruinloot/science,
/obj/effect/spawner/random/ruinloot/science,
/turf/open/floor/iron,
/area/ruin/unpowered)
"CR" = (
/obj/effect/spawner/random/ruinloot/science,
/turf/open/floor/iron,
/area/ruin/unpowered)

(1,1,1) = {"
aA
aA
aJ
aA
aA
aA
aA
aA
aA
aA
aA
aA
aA
"}
(2,1,1) = {"
aA
ap
ax
bm
qJ
aA
aY
aW
as
aA
ax
aU
ax
"}
(3,1,1) = {"
aN
ax
aI
ax
ax
aX
ah
am
aZ
aA
ax
ax
ac
"}
(4,1,1) = {"
aA
ax
CR
ax
ax
aX
aD
aP
aS
aA
ax
ax
ax
"}
(5,1,1) = {"
aA
ax
ax
ax
an
aA
aa
at
aV
aA
aA
ar
aA
"}
(6,1,1) = {"
aA
nd
Bv
aK
aT
aA
aA
aA
aA
aA
ao
ak
aA
"}
(7,1,1) = {"
aA
ag
aC
ah
ah
ah
aL
aA
ao
ao
ao
ao
aA
"}
(8,1,1) = {"
aA
aH
af
ay
aO
ay
se
aA
ao
aA
aA
aA
aA
"}
(9,1,1) = {"
aA
ab
af
aO
aO
aO
ad
aF
ao
aA
ak
aA
aG
"}
(10,1,1) = {"
aA
av
af
ay
aO
ay
ai
aA
ao
ao
ao
aA
aG
"}
(11,1,1) = {"
aA
aj
aA
az
az
az
aA
aA
aB
ao
ao
aA
aG
"}
(12,1,1) = {"
aA
ao
ao
ao
ao
ao
ak
ao
ao
ao
ao
aA
aG
"}
(13,1,1) = {"
aA
aA
aA
aA
aA
aA
aA
aA
aA
aA
aA
aA
aG
"}
