//MAP CONVERTED BY dmm2tgm.py THIS HEADER COMMENT PREVENTS RECONVERSION, DO NOT REMOVE
"bO" = (
/obj/machinery/light/small{
	dir = 4
	},
/obj/structure/extinguisher_cabinet{
	pixel_x = 25
	},
/obj/structure/table,
/obj/item/paper_bin,
/obj/item/paper/fluff/ruins/listeningstation/reports/november,
/obj/item/pen,
/turf/open/floor/iron/dark,
/area/ruin/space/has_grav/listeningstation)
"cX" = (
/obj/effect/spawner/randomvend/snack{
	hacked = 1
	},
/obj/effect/decal/cleanable/dirt,
/obj/effect/decal/cleanable/dirt,
/obj/structure/sign/poster/contraband/random{
	pixel_x = 32
	},
/obj/effect/turf_decal/tile/red{
	dir = 1
	},
/turf/open/floor/iron,
/area/ruin/space/has_grav/listeningstation)
"dr" = (
/turf/template_noop,
/area/template_noop)
"ee" = (
/obj/machinery/atmospherics/pipe/smart/manifold/supply/hidden{
	dir = 1
	},
/obj/machinery/atmospherics/pipe/smart/simple/scrubbers/hidden{
	dir = 4;
	pixel_x = 5;
	pixel_y = 5
	},
/obj/effect/turf_decal/tile/red/half/contrasted{
	dir = 4
	},
/turf/open/floor/iron,
/area/ruin/space/has_grav/listeningstation)
"er" = (
/obj/structure/sink{
	dir = 4;
	pixel_x = 11
	},
/obj/machinery/iv_drip,
/obj/machinery/light/small,
/obj/machinery/airalarm/directional/north,
/obj/effect/mapping_helpers/airalarm/syndicate_access,
/obj/effect/decal/cleanable/dirt,
/obj/machinery/atmospherics/components/unary/vent_pump/on{
	dir = 1
	},
/turf/open/floor/iron/white/side{
	dir = 6
	},
/area/ruin/space/has_grav/listeningstation)
"eN" = (
/obj/effect/decal/cleanable/dirt,
/obj/machinery/atmospherics/components/unary/vent_pump/on{
	dir = 4
	},
/turf/open/floor/iron,
/area/ruin/space/has_grav/listeningstation)
"fG" = (
/obj/machinery/computer/camera_advanced/syndie{
	dir = 4
	},
/obj/effect/decal/cleanable/dirt,
/obj/machinery/newscaster{
	pixel_y = 32
	},
/obj/item/radio/intercom{
	freerange = 1;
	name = "Syndicate Radio Intercom";
	pixel_x = -30
	},
/turf/open/floor/iron/dark,
/area/ruin/space/has_grav/listeningstation)
"gd" = (
/obj/effect/decal/cleanable/dirt,
/obj/machinery/atmospherics/pipe/smart/manifold/supply/hidden{
	dir = 4
	},
/obj/machinery/atmospherics/pipe/smart/manifold/scrubbers/hidden{
	dir = 4;
	pixel_x = 5;
	pixel_y = 5
	},
/obj/effect/turf_decal/tile/red/half/contrasted{
	dir = 4
	},
/turf/open/floor/iron,
/area/ruin/space/has_grav/listeningstation)
"ic" = (
/obj/effect/turf_decal/stripes/line{
	dir = 8
	},
/obj/structure/tank_dispenser/oxygen{
	oxygentanks = 4
	},
/obj/effect/decal/cleanable/dirt,
/turf/open/floor/mineral/plastitanium,
/area/ruin/space/has_grav/listeningstation)
"jx" = (
/obj/machinery/atmospherics/pipe/smart/manifold4w/scrubbers/hidden/layer4,
/obj/machinery/atmospherics/pipe/smart/simple/supply/hidden,
/turf/open/floor/iron/white/corner,
/area/ruin/space/has_grav/listeningstation)
"kI" = (
/obj/structure/table,
/obj/machinery/computer/security/telescreen/entertainment{
	pixel_x = -30
	},
/obj/item/reagent_containers/cup/glass/bottle/beer{
	pixel_x = -4;
	pixel_y = 14
	},
/obj/item/reagent_containers/cup/glass/bottle/beer{
	pixel_x = 3;
	pixel_y = 11
	},
/obj/item/storage/fancy/cigarettes/cigpack_syndicate{
	pixel_x = -3
	},
/obj/item/lighter{
	pixel_x = 7;
	pixel_y = -3
	},
/obj/effect/decal/cleanable/dirt,
/obj/effect/spawner/lootdrop/ruinloot/security,
/obj/effect/spawner/lootdrop/ruinloot/security,
/obj/effect/turf_decal/tile/neutral/fourcorners/contrasted,
/turf/open/floor/iron/dark,
/area/ruin/space/has_grav/listeningstation)
"kX" = (
/obj/machinery/airalarm/directional/north,
/obj/effect/mapping_helpers/airalarm/syndicate_access,
/obj/effect/decal/cleanable/dirt,
/obj/machinery/atmospherics/pipe/smart/manifold/supply/hidden{
	dir = 1
	},
/obj/machinery/atmospherics/pipe/smart/simple/scrubbers/hidden{
	dir = 4;
	pixel_x = 5;
	pixel_y = 5
	},
/obj/effect/baseturf_helper/asteroid/airless,
/obj/effect/turf_decal/tile/red/half/contrasted{
	dir = 4
	},
/turf/open/floor/iron,
/area/ruin/space/has_grav/listeningstation)
"mh" = (
/obj/machinery/atmospherics/pipe/smart/manifold4w/scrubbers/hidden/layer4,
/obj/machinery/atmospherics/pipe/smart/simple/supply/hidden{
	dir = 6
	},
/obj/effect/turf_decal/tile/neutral/fourcorners/contrasted,
/turf/open/floor/iron/dark,
/area/ruin/space/has_grav/listeningstation)
"mp" = (
/obj/effect/decal/cleanable/dirt,
/obj/effect/abstract/doorway_marker{
	dir = 4
	},
/turf/open/floor/plating,
/area/ruin/space/has_grav/listeningstation)
"mw" = (
/obj/structure/rack{
	dir = 8
	},
/obj/item/multitool,
/obj/effect/decal/cleanable/dirt,
/turf/open/floor/iron/dark,
/area/ruin/space/has_grav/listeningstation)
"mM" = (
/obj/effect/decal/cleanable/dirt,
/obj/machinery/atmospherics/components/unary/vent_pump/on{
	dir = 1
	},
/obj/structure/extinguisher_cabinet{
	pixel_y = -29
	},
/turf/open/floor/iron,
/area/ruin/space/has_grav/listeningstation)
"oA" = (
/obj/effect/turf_decal/stripes/red/corner{
	dir = 8
	},
/obj/machinery/door/airlock{
	name = "Cabin"
	},
/obj/machinery/atmospherics/pipe/smart/simple/supply/hidden,
/obj/machinery/atmospherics/pipe/smart/simple/scrubbers/hidden{
	pixel_x = 5;
	pixel_y = 5
	},
/turf/open/floor/iron,
/area/ruin/space/has_grav/listeningstation)
"oR" = (
/obj/effect/turf_decal/stripes/red/corner,
/obj/machinery/light/small{
	dir = 4
	},
/obj/machinery/airalarm/directional/east,
/obj/effect/mapping_helpers/airalarm/syndicate_access,
/obj/effect/decal/cleanable/dirt,
/obj/machinery/atmospherics/pipe/smart/simple/supply/hidden,
/obj/machinery/atmospherics/pipe/smart/manifold/scrubbers/hidden{
	dir = 4;
	pixel_x = 5;
	pixel_y = 5
	},
/obj/machinery/computer/arcade/orion_trail{
	dir = 8
	},
/turf/open/floor/iron,
/area/ruin/space/has_grav/listeningstation)
"pa" = (
/obj/machinery/door/firedoor,
/obj/machinery/atmospherics/pipe/smart/simple/supply/hidden{
	dir = 4
	},
/obj/machinery/atmospherics/pipe/smart/simple/scrubbers/hidden{
	dir = 4;
	pixel_x = 5;
	pixel_y = 5
	},
/obj/machinery/door/airlock{
	name = "Personal Quarters"
	},
/turf/open/floor/iron,
/area/ruin/space/has_grav/listeningstation)
"pB" = (
/obj/machinery/power/terminal{
	dir = 1
	},
/obj/structure/cable{
	icon_state = "0-2"
	},
/obj/structure/reagent_dispensers/fueltank,
/obj/item/clothing/head/utility/welding,
/obj/item/weldingtool/largetank,
/obj/effect/decal/cleanable/dirt,
/obj/machinery/light/small{
	dir = 8
	},
/turf/open/floor/plating,
/area/ruin/space/has_grav/listeningstation)
"qg" = (
/obj/effect/decal/cleanable/dirt,
/obj/machinery/atmospherics/components/unary/vent_scrubber/on{
	dir = 4;
	pixel_x = 5;
	pixel_y = 5
	},
/obj/effect/turf_decal/tile/neutral/fourcorners/contrasted,
/turf/open/floor/iron/dark,
/area/ruin/space/has_grav/listeningstation)
"qm" = (
/obj/effect/decal/cleanable/dirt,
/obj/machinery/atmospherics/pipe/smart/simple/supply/hidden{
	dir = 9
	},
/obj/structure/closet/emcloset/anchored,
/obj/machinery/light/small,
/turf/open/floor/iron,
/area/ruin/space/has_grav/listeningstation)
"qz" = (
/obj/structure/table,
/obj/item/storage/toolbox/syndicate,
/obj/item/flashlight{
	pixel_y = -12
	},
/obj/effect/decal/cleanable/dirt,
/turf/open/floor/iron/dark,
/area/ruin/space/has_grav/listeningstation)
"qN" = (
/obj/structure/closet{
	icon_door = "black";
	name = "wardrobe"
	},
/obj/item/clothing/under/color/black{
	pixel_x = -3;
	pixel_y = 3
	},
/obj/item/clothing/under/color/black{
	pixel_x = 1;
	pixel_y = -1
	},
/obj/item/clothing/head/soft/black{
	pixel_x = -3;
	pixel_y = 3
	},
/obj/item/clothing/head/soft/black{
	pixel_x = 1;
	pixel_y = -1
	},
/obj/item/clothing/gloves/fingerless,
/obj/item/clothing/shoes/sneakers/black{
	pixel_x = -3;
	pixel_y = 3
	},
/obj/item/clothing/shoes/sneakers/black{
	pixel_x = 1;
	pixel_y = -1
	},
/obj/effect/decal/cleanable/dirt,
/obj/item/storage/photo_album,
/obj/machinery/light/small,
/turf/open/floor/carpet/grimy,
/area/ruin/space/has_grav/listeningstation)
"rx" = (
/obj/machinery/atmospherics/pipe/smart/manifold/supply/hidden,
/obj/machinery/atmospherics/pipe/smart/manifold/scrubbers/hidden{
	pixel_x = 5;
	pixel_y = 5
	},
/obj/effect/turf_decal/tile/red/half/contrasted{
	dir = 4
	},
/turf/open/floor/iron,
/area/ruin/space/has_grav/listeningstation)
"sk" = (
/obj/structure/table,
/obj/item/storage/firstaid/regular,
/obj/item/clothing/neck/stethoscope,
/obj/effect/decal/cleanable/dirt,
/obj/effect/spawner/lootdrop/ruinloot/medical,
/turf/open/floor/iron/white/side{
	dir = 10
	},
/area/ruin/space/has_grav/listeningstation)
"sQ" = (
/obj/structure/rack{
	dir = 8
	},
/obj/item/mining_scanner,
/obj/item/pickaxe,
/obj/effect/decal/cleanable/dirt,
/turf/open/floor/iron/dark,
/area/ruin/space/has_grav/listeningstation)
"sV" = (
/obj/machinery/washing_machine{
	pixel_x = 4
	},
/obj/structure/window/spawner/directional/west,
/obj/effect/decal/cleanable/dirt,
/obj/effect/decal/cleanable/dirt,
/obj/effect/turf_decal/tile/neutral/fourcorners/contrasted,
/turf/open/floor/iron/dark,
/area/ruin/space/has_grav/listeningstation)
"tf" = (
/obj/structure/sink{
	dir = 4;
	pixel_x = 11
	},
/obj/structure/toilet{
	pixel_y = 18
	},
/obj/structure/mirror{
	pixel_x = 28
	},
/obj/effect/decal/cleanable/dirt,
/turf/open/floor/iron/showroomfloor,
/area/ruin/space/has_grav/listeningstation)
"ti" = (
/obj/machinery/atmospherics/components/unary/vent_pump/on{
	dir = 1
	},
/obj/machinery/atmospherics/pipe/smart/simple/scrubbers/hidden{
	dir = 5;
	pixel_x = 5;
	pixel_y = 5
	},
/turf/open/floor/carpet/grimy,
/area/ruin/space/has_grav/listeningstation)
"ty" = (
/obj/effect/decal/cleanable/dirt,
/turf/open/floor/iron,
/area/ruin/space/has_grav/listeningstation)
"uw" = (
/obj/effect/decal/cleanable/dirt,
/obj/machinery/computer/records/medical/syndie{
	dir = 4;
	req_one_access = null
	},
/turf/open/floor/iron/dark,
/area/ruin/space/has_grav/listeningstation)
"ux" = (
/obj/structure/cable/yellow{
	icon_state = "0-8"
	},
/obj/machinery/atmospherics/pipe/smart/simple/supply/hidden,
/obj/machinery/power/apc/syndicate{
	dir = 4;
	name = "Syndicate Listening Post APC";
	pixel_x = 24
	},
/obj/effect/decal/cleanable/dirt,
/turf/open/floor/plating,
/area/ruin/space/has_grav/listeningstation)
"vx" = (
/obj/structure/curtain,
/obj/machinery/shower{
	pixel_y = 14
	},
/obj/machinery/light/small,
/obj/item/soap,
/obj/effect/decal/cleanable/dirt,
/turf/open/floor/iron/showroomfloor,
/area/ruin/space/has_grav/listeningstation)
"wf" = (
/obj/effect/mob_spawn/human/lavaland_syndicate/comms/space{
	assignedrole = "Space Syndicate";
	dir = 8
	},
/obj/machinery/atmospherics/components/unary/vent_scrubber/on{
	dir = 8;
	pixel_x = 5;
	pixel_y = 5
	},
/turf/open/floor/carpet/grimy,
/area/ruin/space/has_grav/listeningstation)
"xp" = (
/obj/machinery/atmospherics/pipe/smart/manifold/supply/hidden{
	dir = 1
	},
/obj/machinery/atmospherics/pipe/smart/simple/scrubbers/hidden{
	dir = 6;
	pixel_x = 5;
	pixel_y = 5
	},
/turf/open/floor/iron,
/area/ruin/space/has_grav/listeningstation)
"xC" = (
/obj/effect/spawner/randomvend/cola{
	hacked = 1
	},
/obj/effect/decal/cleanable/dirt,
/obj/effect/decal/cleanable/dirt,
/turf/open/floor/iron/white/corner{
	dir = 8
	},
/area/ruin/space/has_grav/listeningstation)
"xP" = (
/obj/structure/table/reinforced,
/obj/machinery/firealarm{
	pixel_y = 24
	},
/obj/effect/decal/cleanable/dirt,
/obj/machinery/computer/libraryconsole/bookmanagement,
/turf/open/floor/iron/dark,
/area/ruin/space/has_grav/listeningstation)
"yk" = (
/obj/structure/rack{
	dir = 8
	},
/obj/item/clothing/mask/gas{
	pixel_x = -3;
	pixel_y = 3
	},
/obj/effect/turf_decal/stripes/line,
/obj/item/clothing/mask/gas,
/turf/open/floor/mineral/plastitanium/red,
/area/ruin/space/has_grav/listeningstation)
"yz" = (
/obj/machinery/light/small{
	dir = 4
	},
/obj/effect/turf_decal/stripes/corner{
	dir = 4
	},
/obj/machinery/button/door{
	id = "syndie_listeningpost_external";
	name = "External Bolt Control";
	normaldoorcontrol = 1;
	pixel_x = 24;
	req_access_txt = "150";
	specialfunctions = 4
	},
/obj/machinery/atmospherics/pipe/smart/simple/supply/hidden,
/obj/machinery/atmospherics/components/unary/vent_scrubber/on{
	pixel_x = 5;
	pixel_y = 5
	},
/obj/effect/turf_decal/tile/neutral/fourcorners/contrasted,
/turf/open/floor/iron/dark,
/area/ruin/space/has_grav/listeningstation)
"yL" = (
/obj/effect/decal/cleanable/dirt,
/obj/machinery/atmospherics/components/unary/vent_pump/on,
/obj/effect/turf_decal/tile/neutral/fourcorners/contrasted,
/turf/open/floor/iron/dark,
/area/ruin/space/has_grav/listeningstation)
"yP" = (
/obj/machinery/atmospherics/pipe/smart/simple/supply/hidden,
/obj/machinery/atmospherics/pipe/smart/simple/scrubbers/hidden{
	dir = 10;
	pixel_x = 5;
	pixel_y = 5
	},
/obj/effect/turf_decal/tile/neutral/fourcorners/contrasted,
/turf/open/floor/iron/dark,
/area/ruin/space/has_grav/listeningstation)
"Au" = (
/obj/structure/filingcabinet,
/obj/item/paper/fluff/ruins/listeningstation/reports/april,
/obj/item/paper/fluff/ruins/listeningstation/reports/may,
/obj/item/paper/fluff/ruins/listeningstation/reports/june,
/obj/item/paper/fluff/ruins/listeningstation/reports/july,
/obj/item/paper/fluff/ruins/listeningstation/reports/august,
/obj/item/paper/fluff/ruins/listeningstation/reports/september,
/obj/item/paper/fluff/ruins/listeningstation/reports/october,
/obj/item/paper/fluff/ruins/listeningstation/receipt,
/obj/effect/decal/cleanable/dirt,
/obj/item/paper/fluff/ruins/listeningstation/odd_report,
/turf/open/floor/iron/dark,
/area/ruin/space/has_grav/listeningstation)
"Bn" = (
/obj/machinery/atmospherics/pipe/smart/simple/supply/hidden,
/obj/effect/decal/cleanable/dirt,
/obj/structure/closet/crate,
/obj/item/stack/sheet/iron/twenty,
/obj/item/stack/sheet/glass{
	amount = 10
	},
/obj/item/stack/rods/ten,
/obj/effect/turf_decal/stripes/line,
/obj/effect/decal/cleanable/dirt,
/obj/item/storage/box/lights/bulbs,
/obj/item/stack/sheet/mineral/plasma{
	amount = 30
	},
/obj/item/stock_parts/cell/high/plus,
/turf/open/floor/plating,
/area/ruin/space/has_grav/listeningstation)
"BT" = (
/obj/structure/table,
/obj/machinery/cell_charger,
/obj/item/stock_parts/cell/high/plus,
/obj/item/stack/cable_coil{
	pixel_x = 3;
	pixel_y = -7
	},
/obj/effect/decal/cleanable/dirt,
/obj/effect/decal/cleanable/dirt,
/obj/machinery/airalarm/directional/east,
/obj/effect/mapping_helpers/airalarm/syndicate_access,
/obj/effect/spawner/lootdrop/ruinloot/important,
/turf/open/floor/iron/dark,
/area/ruin/space/has_grav/listeningstation)
"Df" = (
/obj/structure/table,
/obj/machinery/firealarm{
	dir = 8;
	pixel_x = -26
	},
/obj/machinery/microwave,
/obj/effect/turf_decal/tile/neutral/fourcorners/contrasted,
/turf/open/floor/iron/dark,
/area/ruin/space/has_grav/listeningstation)
"DE" = (
/turf/closed/wall,
/area/ruin/space/has_grav/listeningstation)
"Ed" = (
/obj/effect/decal/cleanable/dirt,
/obj/machinery/atmospherics/pipe/smart/simple/supply/hidden{
	dir = 4
	},
/obj/machinery/atmospherics/pipe/smart/simple/scrubbers/hidden{
	dir = 4;
	pixel_x = 5;
	pixel_y = 5
	},
/obj/effect/turf_decal/tile/red{
	dir = 4
	},
/turf/open/floor/iron,
/area/ruin/space/has_grav/listeningstation)
"Ex" = (
/obj/effect/turf_decal/stripes/line{
	dir = 4
	},
/obj/effect/decal/cleanable/dirt,
/obj/machinery/atmospherics/components/unary/vent_pump/on,
/obj/effect/turf_decal/tile/neutral/fourcorners/contrasted,
/turf/open/floor/iron/dark,
/area/ruin/space/has_grav/listeningstation)
"ES" = (
/turf/closed/wall/r_wall,
/area/ruin/space/has_grav/listeningstation)
"ET" = (
/obj/structure/cable,
/obj/machinery/power/port_gen/pacman{
	anchored = 1
	},
/obj/effect/turf_decal/bot,
/obj/effect/decal/cleanable/dirt,
/obj/effect/decal/cleanable/dirt,
/obj/item/wrench,
/turf/open/floor/plating,
/area/ruin/space/has_grav/listeningstation)
"EY" = (
/obj/item/bombcore/badmin{
	anchored = 1;
	invisibility = 100
	},
/turf/closed/wall,
/area/ruin/space/has_grav/listeningstation)
"Fs" = (
/obj/effect/decal/cleanable/dirt,
/obj/machinery/atmospherics/pipe/smart/simple/supply/hidden,
/obj/machinery/atmospherics/pipe/smart/manifold4w/scrubbers/hidden/layer4,
/obj/effect/turf_decal/tile/neutral/fourcorners/contrasted,
/turf/open/floor/iron/dark,
/area/ruin/space/has_grav/listeningstation)
"FB" = (
/obj/effect/decal/cleanable/dirt,
/obj/effect/decal/cleanable/dirt,
/obj/structure/closet/crate/bin,
/obj/structure/extinguisher_cabinet{
	pixel_x = -27;
	pixel_y = 1
	},
/obj/effect/spawner/lootdrop/ruinloot/important,
/obj/effect/turf_decal/tile/neutral/fourcorners/contrasted,
/turf/open/floor/iron/dark,
/area/ruin/space/has_grav/listeningstation)
"FH" = (
/obj/structure/table/wood,
/obj/item/ammo_box/magazine/m10mm,
/obj/item/paper/fluff/ruins/listeningstation/briefing,
/turf/open/floor/carpet/grimy,
/area/ruin/space/has_grav/listeningstation)
"FP" = (
/obj/structure/bookcase/random,
/turf/open/floor/carpet/grimy,
/area/ruin/space/has_grav/listeningstation)
"Kg" = (
/obj/structure/closet/crate/freezer,
/obj/item/reagent_containers/blood/OMinus{
	pixel_x = -3;
	pixel_y = 3
	},
/obj/item/reagent_containers/blood/OMinus,
/obj/effect/decal/cleanable/dirt,
/obj/machinery/atmospherics/components/unary/vent_scrubber/on{
	dir = 4;
	pixel_x = 5;
	pixel_y = 5
	},
/turf/open/floor/iron/white/side{
	dir = 9
	},
/area/ruin/space/has_grav/listeningstation)
"Kn" = (
/obj/structure/chair/office{
	dir = 8
	},
/obj/effect/turf_decal/tile/neutral/fourcorners/contrasted,
/turf/open/floor/iron/dark,
/area/ruin/space/has_grav/listeningstation)
"Kv" = (
/obj/machinery/light/small{
	dir = 1
	},
/obj/machinery/firealarm{
	pixel_y = 24
	},
/obj/machinery/atmospherics/pipe/smart/manifold/supply/hidden{
	dir = 1
	},
/obj/machinery/atmospherics/pipe/smart/manifold/scrubbers/hidden{
	dir = 1;
	pixel_x = 5;
	pixel_y = 5
	},
/obj/effect/turf_decal/tile/red/half/contrasted{
	dir = 4
	},
/turf/open/floor/iron,
/area/ruin/space/has_grav/listeningstation)
"KU" = (
/obj/structure/table,
/obj/machinery/light/small{
	brightness = 3;
	dir = 8
	},
/obj/item/storage/box/donkpockets{
	pixel_x = -2;
	pixel_y = 6
	},
/obj/item/storage/box/donkpockets{
	pixel_y = 3
	},
/obj/item/storage/box/donkpockets{
	pixel_x = 2
	},
/obj/item/food/chocolatebar,
/obj/effect/decal/cleanable/dirt,
/obj/effect/decal/cleanable/dirt,
/obj/structure/sign/poster/contraband/random{
	pixel_x = -32
	},
/obj/effect/turf_decal/tile/neutral/fourcorners/contrasted,
/turf/open/floor/iron/dark,
/area/ruin/space/has_grav/listeningstation)
"Lj" = (
/obj/structure/chair/stool,
/obj/machinery/atmospherics/components/unary/vent_scrubber/on{
	dir = 4;
	pixel_x = 5;
	pixel_y = 5
	},
/turf/open/floor/iron,
/area/ruin/space/has_grav/listeningstation)
"LZ" = (
/obj/machinery/door/airlock/external{
	id_tag = "syndie_listeningpost_external";
	req_access_txt = "150"
	},
/turf/open/floor/plating,
/area/ruin/space/has_grav/listeningstation)
"Of" = (
/obj/structure/cable/yellow{
	icon_state = "0-4"
	},
/obj/machinery/power/smes{
	charge = 5e+006
	},
/obj/effect/turf_decal/stripes/line{
	dir = 6
	},
/obj/effect/decal/cleanable/dirt,
/obj/effect/decal/cleanable/dirt,
/obj/effect/decal/cleanable/dirt,
/turf/open/floor/plating,
/area/ruin/space/has_grav/listeningstation)
"Pg" = (
/obj/machinery/syndicatebomb/self_destruct{
	anchored = 1
	},
/obj/machinery/door/window/brigdoor{
	dir = 8;
	req_access_txt = "150"
	},
/obj/structure/sign/warning/explosives/alt{
	pixel_x = 32
	},
/turf/open/floor/circuit/red,
/area/ruin/space/has_grav/listeningstation)
"QE" = (
/obj/machinery/atmospherics/pipe/smart/simple/supply/hidden,
/obj/machinery/atmospherics/pipe/smart/simple/scrubbers/hidden{
	dir = 9;
	pixel_x = 5;
	pixel_y = 5
	},
/turf/open/floor/iron/white/side{
	dir = 5
	},
/area/ruin/space/has_grav/listeningstation)
"QT" = (
/obj/machinery/door/firedoor,
/obj/effect/decal/cleanable/dirt,
/obj/machinery/atmospherics/pipe/smart/simple/supply/hidden,
/obj/machinery/atmospherics/pipe/smart/simple/scrubbers/hidden{
	pixel_x = 5;
	pixel_y = 5
	},
/obj/machinery/door/airlock/hatch{
	name = "Telecommunications";
	req_access_txt = "150"
	},
/obj/effect/turf_decal/tile/neutral/fourcorners/contrasted,
/turf/open/floor/iron/dark,
/area/ruin/space/has_grav/listeningstation)
"Tg" = (
/obj/effect/decal/cleanable/dirt,
/obj/effect/decal/cleanable/dirt,
/obj/structure/closet/secure_closet/medical1{
	req_access = null;
	req_access_txt = "150"
	},
/obj/effect/spawner/lootdrop/ruinloot/medical,
/turf/open/floor/iron/white,
/area/ruin/space/has_grav/listeningstation)
"TD" = (
/obj/machinery/door/airlock/maintenance,
/obj/machinery/atmospherics/pipe/smart/simple/supply/hidden,
/turf/open/floor/plating,
/area/ruin/space/has_grav/listeningstation)
"TQ" = (
/obj/structure/sign/departments/medbay/alt,
/turf/closed/wall,
/area/ruin/space/has_grav/listeningstation)
"Vh" = (
/obj/machinery/atmospherics/components/tank/air{
	dir = 1
	},
/obj/effect/turf_decal/bot,
/obj/effect/decal/cleanable/dirt,
/obj/effect/decal/cleanable/dirt,
/turf/open/floor/plating,
/area/ruin/space/has_grav/listeningstation)
"Vw" = (
/obj/effect/turf_decal/stripes/red/line{
	dir = 4
	},
/obj/effect/turf_decal/caution/red{
	dir = 8
	},
/obj/machinery/atmospherics/pipe/smart/manifold4w/scrubbers/hidden/layer4,
/obj/machinery/atmospherics/pipe/smart/simple/supply/hidden{
	dir = 9
	},
/turf/open/floor/iron,
/area/ruin/space/has_grav/listeningstation)
"Vy" = (
/obj/machinery/door/firedoor,
/obj/effect/decal/cleanable/dirt,
/obj/machinery/atmospherics/pipe/smart/simple/supply/hidden,
/obj/machinery/atmospherics/pipe/smart/simple/scrubbers/hidden{
	pixel_x = 5;
	pixel_y = 5
	},
/obj/machinery/door/airlock/medical/glass{
	name = "Medbay"
	},
/turf/open/floor/iron/white,
/area/ruin/space/has_grav/listeningstation)
"Wd" = (
/obj/machinery/telecomms/relay/preset/ruskie{
	use_power = 0
	},
/obj/effect/decal/cleanable/dirt,
/turf/open/floor/iron/dark,
/area/ruin/space/has_grav/listeningstation)
"XB" = (
/obj/machinery/atmospherics/pipe/smart/simple/supply/hidden,
/obj/machinery/atmospherics/pipe/smart/simple/scrubbers/hidden{
	pixel_x = 5;
	pixel_y = 5
	},
/obj/effect/turf_decal/tile/neutral/fourcorners/contrasted,
/turf/open/floor/iron/dark,
/area/ruin/space/has_grav/listeningstation)
"XH" = (
/obj/machinery/door/firedoor,
/obj/machinery/atmospherics/pipe/smart/simple/supply/hidden,
/obj/machinery/atmospherics/pipe/smart/simple/scrubbers/hidden{
	pixel_x = 5;
	pixel_y = 5
	},
/obj/machinery/door/airlock/hatch{
	name = "E.V.A. Equipment";
	req_access_txt = "150"
	},
/obj/effect/turf_decal/tile/neutral/fourcorners/contrasted,
/turf/open/floor/iron/dark,
/area/ruin/space/has_grav/listeningstation)
"Yu" = (
/obj/effect/decal/cleanable/dirt,
/obj/effect/decal/cleanable/dirt,
/obj/machinery/atmospherics/pipe/smart/simple/supply/hidden{
	dir = 6
	},
/turf/open/floor/iron,
/area/ruin/space/has_grav/listeningstation)
"YS" = (
/obj/machinery/computer/message_monitor,
/obj/machinery/airalarm/directional/north,
/obj/effect/mapping_helpers/airalarm/syndicate_access,
/obj/effect/decal/cleanable/dirt,
/obj/effect/decal/cleanable/dirt,
/obj/item/paper/monitorkey,
/turf/open/floor/iron/dark,
/area/ruin/space/has_grav/listeningstation)
"Zn" = (
/obj/machinery/door/airlock{
	name = "Toilet"
	},
/turf/open/floor/iron/showroomfloor,
/area/ruin/space/has_grav/listeningstation)
"Zp" = (
/obj/machinery/atmospherics/components/unary/vent_scrubber/on{
	dir = 1;
	pixel_x = 5;
	pixel_y = 5
	},
/turf/open/floor/iron/white/side,
/area/ruin/space/has_grav/listeningstation)

(1,1,1) = {"
dr
dr
ES
ES
ES
ES
ES
ES
ES
ES
ES
ES
dr
"}
(2,1,1) = {"
dr
dr
ES
vx
DE
FB
Df
kI
KU
DE
FP
ES
ES
"}
(3,1,1) = {"
dr
dr
ES
tf
Zn
ty
eN
Lj
mh
oA
ti
qN
ES
"}
(4,1,1) = {"
dr
ES
ES
DE
DE
sV
xp
oR
Vw
DE
wf
FH
ES
"}
(5,1,1) = {"
ES
ES
fG
uw
DE
DE
pa
DE
Pg
DE
DE
DE
ES
"}
(6,1,1) = {"
ES
YS
Kn
qg
Au
DE
Ed
DE
DE
Of
pB
ET
ES
"}
(7,1,1) = {"
ES
xP
yL
yP
XB
QT
rx
Yu
TD
ux
Bn
Vh
ES
"}
(8,1,1) = {"
ES
ES
Wd
bO
mw
DE
kX
qm
DE
DE
DE
ES
ES
"}
(9,1,1) = {"
dr
ES
DE
DE
DE
EY
ee
mM
TQ
Kg
sk
ES
dr
"}
(10,1,1) = {"
ES
ES
qz
BT
sQ
DE
Kv
jx
Vy
QE
er
ES
dr
"}
(11,1,1) = {"
ES
yk
Ex
yz
Fs
XH
gd
Zp
DE
Tg
ES
ES
dr
"}
(12,1,1) = {"
ES
ES
LZ
ES
ic
DE
cX
xC
ES
ES
ES
dr
dr
"}
(13,1,1) = {"
dr
ES
mp
ES
ES
ES
ES
ES
ES
dr
dr
dr
dr
"}
