//MAP CONVERTED BY dmm2tgm.py THIS HEADER COMMENT PREVENTS RECONVERSION, DO NOT REMOVE
"d" = (
/obj/effect/turf_decal/delivery,
/obj/structure/closet/crate,
/obj/item/stack/sheet/plasteel/twenty,
/turf/open/floor/iron,
/area/ruin/unpowered)
"e" = (
/obj/effect/turf_decal/delivery,
/obj/structure/closet/crate/medical,
/obj/item/storage/firstaid/regular{
	empty = 1;
	name = "First-Aid (empty)"
	},
/obj/item/storage/firstaid/o2,
/turf/open/floor/iron,
/area/ruin/unpowered)
"g" = (
/turf/open/floor/iron,
/area/ruin/unpowered)
"l" = (
/obj/effect/turf_decal/delivery,
/obj/structure/closet/crate/engineering,
/obj/item/multitool,
/turf/open/floor/iron,
/area/ruin/unpowered)
"m" = (
/obj/effect/turf_decal/delivery,
/obj/structure/closet/crate,
/obj/item/stack/sheet/iron/fifty,
/obj/item/stack/sheet/iron/fifty,
/obj/effect/spawner/random/ruinloot/basic,
/turf/open/floor/iron,
/area/ruin/unpowered)
"o" = (
/obj/effect/turf_decal/delivery,
/obj/structure/closet/crate,
/obj/item/modular_computer/tablet/pda/preset/clear,
/obj/effect/spawner/random/ruinloot/important,
/turf/open/floor/iron,
/area/ruin/unpowered)
"p" = (
/obj/effect/turf_decal/delivery,
/obj/structure/closet/crate,
/obj/item/storage/pill_bottle/stimulant,
/obj/effect/spawner/random/ruinloot/basic,
/turf/open/floor/iron,
/area/ruin/unpowered)
"q" = (
/obj/effect/abstract/open_area_marker,
/turf/open/floor/iron,
/area/ruin/unpowered)
"s" = (
/obj/effect/turf_decal/delivery,
/obj/structure/closet/crate/medical,
/obj/item/storage/firstaid/regular{
	empty = 1;
	name = "First-Aid (empty)"
	},
/obj/effect/spawner/random/ruinloot/medical,
/turf/open/floor/iron,
/area/ruin/unpowered)
"u" = (
/obj/effect/turf_decal/delivery,
/obj/structure/closet/crate,
/obj/item/stack/sheet/cardboard/fifty,
/obj/effect/spawner/random/ruinloot/basic,
/turf/open/floor/iron,
/area/ruin/unpowered)
"x" = (
/obj/effect/turf_decal/delivery,
/obj/structure/closet/crate/engineering,
/obj/item/storage/toolbox/mechanical,
/turf/open/floor/iron,
/area/ruin/unpowered)
"D" = (
/obj/effect/turf_decal/delivery,
/obj/structure/closet/crate,
/obj/item/paicard,
/turf/open/floor/iron,
/area/ruin/unpowered)
"E" = (
/obj/effect/turf_decal/delivery,
/obj/structure/closet/crate/medical,
/obj/item/storage/firstaid/brute,
/obj/item/storage/firstaid/fire,
/obj/effect/spawner/random/ruinloot/science,
/turf/open/floor/iron,
/area/ruin/unpowered)
"G" = (
/obj/effect/abstract/open_area_marker{
	dir = 1
	},
/turf/open/floor/iron,
/area/ruin/unpowered)
"M" = (
/obj/effect/turf_decal/delivery,
/obj/structure/closet/crate/internals,
/obj/item/storage/firstaid/toxin,
/obj/item/tank/internals/emergency_oxygen/engi,
/obj/item/tank/internals/emergency_oxygen/engi,
/turf/open/floor/iron,
/area/ruin/unpowered)
"O" = (
/obj/effect/turf_decal/delivery,
/obj/machinery/suit_storage_unit/standard_unit,
/turf/open/floor/iron,
/area/ruin/unpowered)
"U" = (
/turf/closed/wall,
/area/ruin/unpowered)
"Y" = (
/obj/effect/turf_decal/delivery,
/obj/structure/closet/crate/secure/loot,
/turf/open/floor/iron,
/area/ruin/unpowered)
"Z" = (
/obj/effect/turf_decal/delivery,
/obj/structure/closet/crate,
/obj/item/target/alien,
/obj/item/target/alien,
/obj/item/target/clown,
/obj/item/target/syndicate,
/turf/open/floor/iron,
/area/ruin/unpowered)

(1,1,1) = {"
U
U
U
U
U
U
U
U
U
"}
(2,1,1) = {"
U
g
g
p
Y
Y
g
M
U
"}
(3,1,1) = {"
U
O
g
g
g
g
g
u
U
"}
(4,1,1) = {"
U
O
g
g
g
g
g
g
U
"}
(5,1,1) = {"
U
g
g
U
s
g
d
l
U
"}
(6,1,1) = {"
g
g
g
U
x
g
g
g
g
"}
(7,1,1) = {"
G
g
g
U
g
g
g
g
q
"}
(8,1,1) = {"
g
g
g
U
Z
E
g
g
g
"}
(9,1,1) = {"
U
g
g
U
g
g
g
g
U
"}
(10,1,1) = {"
U
g
g
g
g
g
g
g
U
"}
(11,1,1) = {"
U
g
g
g
g
g
g
g
U
"}
(12,1,1) = {"
U
Y
Y
D
g
m
e
o
U
"}
(13,1,1) = {"
U
U
U
U
U
U
U
U
U
"}
