//MAP CONVERTED BY dmm2tgm.py THIS HEADER COMMENT PREVENTS RECONVERSION, DO NOT REMOVE
"aa" = (
/obj/effect/turf_decal/tile/purple,
/obj/effect/turf_decal/tile/purple{
	dir = 4
	},
/obj/effect/turf_decal/tile/purple{
	dir = 1
	},
/obj/machinery/vending/wardrobe/science_wardrobe,
/turf/open/floor/plasteel/white,
/area/ruin/unpowered)
"ab" = (
/obj/effect/turf_decal/tile/purple,
/obj/effect/turf_decal/tile/purple{
	dir = 8
	},
/turf/open/floor/plasteel/white,
/area/ruin/unpowered)
"ac" = (
/obj/effect/turf_decal/stripes/line{
	dir = 8
	},
/obj/structure/table,
/obj/machinery/cell_charger,
/obj/item/stock_parts/cell/high{
	charge = 100;
	maxcharge = 15000
	},
/obj/effect/turf_decal/tile/purple{
	dir = 1
	},
/obj/effect/turf_decal/tile/purple,
/turf/open/floor/plasteel,
/area/ruin/unpowered)
"ad" = (
/obj/effect/spawner/structure/window,
/turf/open/floor/plating,
/area/ruin/unpowered)
"ae" = (
/obj/effect/abstract/open_area_marker,
/turf/open/floor/plasteel,
/area/ruin/unpowered)
"af" = (
/obj/effect/abstract/doorway_marker{
	dir = 8
	},
/turf/open/floor/plasteel/white,
/area/ruin/unpowered)
"ag" = (
/obj/effect/turf_decal/stripes/line{
	dir = 8
	},
/obj/structure/table,
/obj/item/disk/tech_disk{
	pixel_x = -2;
	pixel_y = -3
	},
/obj/item/disk/tech_disk{
	pixel_x = -2;
	pixel_y = -3
	},
/obj/item/disk/design_disk,
/obj/machinery/light{
	dir = 4
	},
/obj/effect/turf_decal/tile/purple{
	dir = 1
	},
/obj/effect/turf_decal/tile/purple,
/obj/effect/spawner/lootdrop/ruinloot/science,
/obj/effect/spawner/lootdrop/ruinloot/science,
/turf/open/floor/plasteel,
/area/ruin/unpowered)
"ah" = (
/obj/effect/turf_decal/stripes/line{
	dir = 8
	},
/obj/effect/turf_decal/tile/purple,
/obj/effect/turf_decal/tile/purple{
	dir = 1
	},
/turf/open/floor/plasteel,
/area/ruin/unpowered)
"ai" = (
/obj/item/kirbyplants/random,
/obj/machinery/light,
/obj/effect/turf_decal/tile/purple/half/contrasted{
	dir = 8
	},
/turf/open/floor/plasteel/white,
/area/ruin/unpowered)
"aj" = (
/obj/effect/turf_decal/tile/purple/anticorner/contrasted{
	dir = 8
	},
/turf/open/floor/plasteel/white,
/area/ruin/unpowered)
"ak" = (
/obj/effect/turf_decal/stripes/line{
	dir = 6
	},
/obj/structure/table,
/obj/structure/window/reinforced{
	dir = 1
	},
/obj/item/clothing/glasses/science,
/obj/effect/turf_decal/tile/purple{
	dir = 1
	},
/obj/effect/turf_decal/tile/purple,
/obj/effect/spawner/lootdrop/ruinloot/science,
/turf/open/floor/plasteel,
/area/ruin/unpowered)
"al" = (
/obj/effect/turf_decal/tile/purple{
	dir = 1
	},
/obj/effect/turf_decal/tile/purple{
	dir = 8
	},
/turf/open/floor/plasteel/white,
/area/ruin/unpowered)
"am" = (
/obj/effect/turf_decal/tile/purple{
	dir = 1
	},
/obj/effect/turf_decal/tile/purple{
	dir = 4
	},
/obj/effect/turf_decal/tile/purple,
/turf/open/floor/plasteel/white,
/area/ruin/unpowered)
"an" = (
/obj/effect/turf_decal/tile/purple/fourcorners/contrasted,
/turf/open/floor/plasteel/white,
/area/ruin/unpowered)
"ao" = (
/obj/effect/turf_decal/tile/purple,
/turf/open/floor/plasteel/white,
/area/ruin/unpowered)
"ap" = (
/turf/open/floor/plasteel,
/area/ruin/unpowered)
"aq" = (
/obj/effect/turf_decal/tile/purple{
	dir = 1
	},
/obj/effect/turf_decal/tile/purple{
	dir = 8
	},
/obj/effect/turf_decal/tile/purple{
	dir = 4
	},
/turf/open/floor/plasteel/white,
/area/ruin/unpowered)
"ar" = (
/obj/machinery/door/airlock/science,
/turf/open/floor/plasteel/white,
/area/ruin/unpowered)
"as" = (
/obj/effect/turf_decal/tile/purple,
/obj/effect/spawner/lootdrop/ruinloot/science,
/turf/open/floor/plasteel/white,
/area/ruin/unpowered)
"at" = (
/obj/effect/turf_decal/stripes/line{
	dir = 10
	},
/obj/machinery/computer/cargo/request{
	dir = 8
	},
/obj/effect/turf_decal/tile/purple{
	dir = 1
	},
/obj/effect/turf_decal/tile/purple,
/turf/open/floor/plasteel,
/area/ruin/unpowered)
"au" = (
/turf/closed/wall,
/area/ruin/unpowered)
"av" = (
/obj/effect/turf_decal/stripes/line{
	dir = 9
	},
/obj/machinery/rnd/production/protolathe/department/science,
/obj/effect/turf_decal/tile/purple,
/obj/effect/turf_decal/tile/purple{
	dir = 1
	},
/turf/open/floor/plasteel,
/area/ruin/unpowered)
"aw" = (
/obj/machinery/door/window/eastleft{
	name = "Research and Development Deliveries";
	req_one_access_txt = "7;29"
	},
/obj/effect/turf_decal/delivery,
/turf/open/floor/plasteel,
/area/ruin/unpowered)
"ax" = (
/obj/effect/turf_decal/stripes/line{
	dir = 8
	},
/obj/effect/turf_decal/tile/purple{
	dir = 1
	},
/obj/effect/turf_decal/tile/purple{
	dir = 8
	},
/turf/open/floor/plasteel/white,
/area/ruin/unpowered)
"ay" = (
/obj/item/kirbyplants/random,
/obj/effect/turf_decal/tile/purple,
/obj/effect/turf_decal/tile/purple{
	dir = 1
	},
/obj/effect/turf_decal/tile/purple{
	dir = 8
	},
/obj/effect/turf_decal/tile/purple,
/obj/effect/turf_decal/tile/purple{
	dir = 8
	},
/turf/open/floor/plasteel/white,
/area/ruin/unpowered)
"az" = (
/obj/effect/turf_decal/tile/purple{
	dir = 8
	},
/obj/effect/turf_decal/tile/purple,
/obj/effect/turf_decal/tile/purple{
	dir = 4
	},
/turf/open/floor/plasteel/white,
/area/ruin/unpowered)
"aA" = (
/obj/effect/turf_decal/tile/purple{
	dir = 4
	},
/turf/open/floor/plasteel/white,
/area/ruin/unpowered)
"aB" = (
/obj/effect/turf_decal/stripes/line{
	dir = 8
	},
/obj/machinery/rnd/destructive_analyzer,
/obj/effect/turf_decal/tile/purple,
/obj/effect/turf_decal/tile/purple{
	dir = 1
	},
/turf/open/floor/plasteel,
/area/ruin/unpowered)
"aC" = (
/obj/structure/table,
/obj/item/stack/sheet/iron/fifty,
/obj/effect/turf_decal/stripes/end,
/obj/item/clothing/glasses/welding,
/turf/open/floor/plasteel,
/area/ruin/unpowered)
"aD" = (
/obj/effect/spawner/lootdrop/ruinloot/science,
/turf/open/floor/plasteel/white,
/area/ruin/unpowered)
"aE" = (
/obj/effect/turf_decal/stripes/line{
	dir = 8
	},
/obj/structure/table,
/obj/item/folder/white{
	pixel_x = 4;
	pixel_y = 4
	},
/obj/item/folder/white{
	pixel_x = 4;
	pixel_y = 4
	},
/obj/item/crowbar,
/obj/effect/turf_decal/tile/purple{
	dir = 1
	},
/obj/effect/turf_decal/tile/purple,
/obj/effect/spawner/lootdrop/ruinloot/science,
/obj/effect/spawner/lootdrop/ruinloot/science,
/turf/open/floor/plasteel,
/area/ruin/unpowered)
"aF" = (
/obj/effect/turf_decal/tile/purple{
	dir = 1
	},
/obj/effect/turf_decal/tile/purple,
/obj/effect/turf_decal/tile/purple{
	dir = 4
	},
/turf/open/floor/plasteel/white,
/area/ruin/unpowered)
"aG" = (
/obj/effect/turf_decal/stripes/line{
	dir = 5
	},
/obj/machinery/rnd/production/circuit_imprinter/department/science,
/obj/effect/turf_decal/tile/purple,
/obj/effect/turf_decal/tile/purple{
	dir = 1
	},
/turf/open/floor/plasteel,
/area/ruin/unpowered)
"aH" = (
/obj/structure/chair/stool,
/obj/effect/turf_decal/tile/purple{
	dir = 1
	},
/obj/effect/turf_decal/tile/purple{
	dir = 8
	},
/turf/open/floor/plasteel/white,
/area/ruin/unpowered)
"aI" = (
/obj/effect/turf_decal/tile/purple,
/obj/effect/turf_decal/tile/purple{
	dir = 8
	},
/obj/effect/turf_decal/tile/purple{
	dir = 1
	},
/turf/open/floor/plasteel/white,
/area/ruin/unpowered)
"aJ" = (
/obj/effect/turf_decal/tile/purple,
/obj/effect/turf_decal/tile/purple{
	dir = 8
	},
/obj/effect/turf_decal/tile/purple{
	dir = 4
	},
/turf/open/floor/plasteel/white,
/area/ruin/unpowered)
"aK" = (
/obj/effect/turf_decal/tile/purple,
/obj/effect/turf_decal/tile/purple{
	dir = 1
	},
/obj/effect/turf_decal/tile/purple{
	dir = 8
	},
/obj/effect/turf_decal/tile/purple{
	dir = 4
	},
/turf/open/floor/plasteel/white,
/area/ruin/unpowered)
"aL" = (
/obj/effect/turf_decal/tile/purple{
	dir = 1
	},
/obj/effect/turf_decal/tile/purple{
	dir = 4
	},
/turf/open/floor/plasteel/white,
/area/ruin/unpowered)
"aM" = (
/obj/effect/abstract/open_area_marker{
	dir = 1
	},
/turf/open/floor/plasteel,
/area/ruin/unpowered)
"aN" = (
/obj/effect/turf_decal/stripes/line{
	dir = 5
	},
/obj/structure/table,
/obj/effect/turf_decal/tile/purple,
/obj/effect/turf_decal/tile/purple{
	dir = 1
	},
/obj/item/hand_labeler,
/obj/effect/spawner/lootdrop/ruinloot/science,
/turf/open/floor/plasteel,
/area/ruin/unpowered)
"aO" = (
/turf/open/floor/plasteel/white,
/area/ruin/unpowered)
"aP" = (
/obj/effect/spawner/lootdrop/ruinloot/important,
/turf/open/floor/plasteel/white,
/area/ruin/unpowered)
"aQ" = (
/obj/effect/turf_decal/stripes/line{
	dir = 4
	},
/obj/structure/table,
/obj/structure/window/reinforced,
/obj/effect/turf_decal/tile/purple,
/obj/effect/turf_decal/tile/purple{
	dir = 1
	},
/obj/item/circuitboard/computer/nanite_chamber_control,
/obj/item/circuitboard/computer/nanite_cloud_controller,
/obj/item/circuitboard/machine/nanite_chamber,
/obj/item/circuitboard/machine/nanite_program_hub,
/obj/effect/spawner/lootdrop/ruinloot/science,
/obj/effect/spawner/lootdrop/ruinloot/science,
/turf/open/floor/plasteel,
/area/ruin/unpowered)
"aR" = (
/obj/effect/turf_decal/tile/purple{
	dir = 8
	},
/obj/effect/turf_decal/tile/purple{
	dir = 4
	},
/obj/effect/turf_decal/tile/purple{
	dir = 1
	},
/obj/effect/turf_decal/tile/purple,
/turf/open/floor/plasteel/white,
/area/ruin/unpowered)
"aS" = (
/obj/effect/turf_decal/stripes/line{
	dir = 4
	},
/obj/effect/turf_decal/tile/purple,
/obj/effect/turf_decal/tile/purple{
	dir = 1
	},
/turf/open/floor/plasteel,
/area/ruin/unpowered)
"aT" = (
/obj/effect/turf_decal/stripes/corner{
	dir = 1
	},
/obj/effect/turf_decal/tile/purple{
	dir = 1
	},
/obj/effect/turf_decal/tile/purple{
	dir = 8
	},
/turf/open/floor/plasteel/white,
/area/ruin/unpowered)
"aU" = (
/obj/effect/turf_decal/stripes/corner{
	dir = 8
	},
/obj/structure/chair/stool,
/obj/effect/turf_decal/tile/purple{
	dir = 1
	},
/obj/effect/turf_decal/tile/purple{
	dir = 8
	},
/turf/open/floor/plasteel/white,
/area/ruin/unpowered)
"aV" = (
/obj/structure/table/reinforced,
/obj/item/paper_bin,
/obj/item/pen,
/obj/machinery/door/firedoor,
/turf/open/floor/plasteel/white,
/area/ruin/unpowered)
"aW" = (
/obj/effect/turf_decal/tile/purple{
	dir = 1
	},
/obj/effect/turf_decal/tile/purple{
	dir = 4
	},
/obj/effect/turf_decal/tile/purple{
	dir = 8
	},
/obj/effect/turf_decal/tile/purple,
/turf/open/floor/plasteel/white,
/area/ruin/unpowered)
"aX" = (
/obj/item/kirbyplants/random,
/obj/machinery/light,
/obj/effect/turf_decal/tile/purple,
/obj/effect/turf_decal/tile/purple{
	dir = 8
	},
/turf/open/floor/plasteel/white,
/area/ruin/unpowered)
"aY" = (
/obj/effect/turf_decal/stripes/line{
	dir = 4
	},
/obj/machinery/computer/rdconsole/core{
	dir = 1
	},
/obj/effect/turf_decal/tile/purple,
/obj/effect/turf_decal/tile/purple{
	dir = 1
	},
/turf/open/floor/plasteel,
/area/ruin/unpowered)
"aZ" = (
/obj/effect/turf_decal/tile/purple,
/obj/effect/turf_decal/tile/purple{
	dir = 4
	},
/turf/open/floor/plasteel/white,
/area/ruin/unpowered)
"bh" = (
/obj/effect/turf_decal/stripes/line{
	dir = 8
	},
/obj/effect/turf_decal/tile/purple/opposingcorners,
/turf/open/floor/plasteel,
/area/ruin/unpowered)
"cy" = (
/obj/effect/turf_decal/stripes/line{
	dir = 8
	},
/obj/effect/turf_decal/tile/purple/half/contrasted{
	dir = 1
	},
/turf/open/floor/plasteel/white,
/area/ruin/unpowered)
"ec" = (
/obj/effect/turf_decal/tile/purple/anticorner/contrasted{
	dir = 4
	},
/turf/open/floor/plasteel/white,
/area/ruin/unpowered)
"gk" = (
/obj/machinery/vending/wardrobe/science_wardrobe,
/obj/effect/turf_decal/tile/purple/anticorner/contrasted{
	dir = 4
	},
/turf/open/floor/plasteel/white,
/area/ruin/unpowered)
"is" = (
/obj/effect/turf_decal/stripes/line{
	dir = 5
	},
/obj/structure/table,
/obj/item/hand_labeler,
/obj/effect/spawner/lootdrop/ruinloot/science,
/obj/effect/turf_decal/tile/purple/opposingcorners,
/turf/open/floor/plasteel,
/area/ruin/unpowered)
"nb" = (
/obj/effect/turf_decal/tile/purple/half/contrasted{
	dir = 8
	},
/turf/open/floor/plasteel/white,
/area/ruin/unpowered)
"nq" = (
/obj/effect/turf_decal/tile/purple/anticorner/contrasted{
	dir = 1
	},
/turf/open/floor/plasteel/white,
/area/ruin/unpowered)
"nZ" = (
/obj/effect/turf_decal/stripes/line{
	dir = 8
	},
/obj/structure/table,
/obj/item/disk/tech_disk{
	pixel_x = -2;
	pixel_y = -3
	},
/obj/item/disk/tech_disk{
	pixel_x = -2;
	pixel_y = -3
	},
/obj/item/disk/design_disk,
/obj/machinery/light{
	dir = 4
	},
/obj/effect/spawner/lootdrop/ruinloot/science,
/obj/effect/spawner/lootdrop/ruinloot/science,
/obj/effect/turf_decal/tile/purple/opposingcorners,
/turf/open/floor/plasteel,
/area/ruin/unpowered)
"qh" = (
/obj/effect/turf_decal/stripes/line{
	dir = 10
	},
/obj/machinery/computer/cargo/request{
	dir = 8
	},
/obj/effect/turf_decal/tile/purple/opposingcorners,
/turf/open/floor/plasteel,
/area/ruin/unpowered)
"ry" = (
/obj/effect/turf_decal/stripes/line{
	dir = 4
	},
/obj/machinery/computer/rdconsole/core{
	dir = 1
	},
/obj/effect/turf_decal/tile/purple/opposingcorners,
/turf/open/floor/plasteel,
/area/ruin/unpowered)
"tG" = (
/obj/effect/turf_decal/stripes/line{
	dir = 6
	},
/obj/structure/table,
/obj/structure/window/reinforced{
	dir = 1
	},
/obj/item/clothing/glasses/science,
/obj/effect/spawner/lootdrop/ruinloot/science,
/obj/effect/turf_decal/tile/purple/opposingcorners,
/turf/open/floor/plasteel,
/area/ruin/unpowered)
"yc" = (
/obj/effect/turf_decal/stripes/corner{
	dir = 1
	},
/obj/effect/turf_decal/tile/purple/half/contrasted{
	dir = 1
	},
/turf/open/floor/plasteel/white,
/area/ruin/unpowered)
"Ar" = (
/obj/effect/turf_decal/stripes/line{
	dir = 8
	},
/obj/structure/table,
/obj/item/folder/white{
	pixel_x = 4;
	pixel_y = 4
	},
/obj/item/folder/white{
	pixel_x = 4;
	pixel_y = 4
	},
/obj/item/crowbar,
/obj/effect/spawner/lootdrop/ruinloot/science,
/obj/effect/spawner/lootdrop/ruinloot/science,
/obj/effect/turf_decal/tile/purple/opposingcorners,
/turf/open/floor/plasteel,
/area/ruin/unpowered)
"Cb" = (
/obj/effect/turf_decal/stripes/line{
	dir = 8
	},
/obj/structure/table,
/obj/machinery/cell_charger,
/obj/item/stock_parts/cell/high{
	charge = 100;
	maxcharge = 15000
	},
/obj/effect/turf_decal/tile/purple/opposingcorners,
/turf/open/floor/plasteel,
/area/ruin/unpowered)
"DS" = (
/obj/effect/turf_decal/stripes/line{
	dir = 9
	},
/obj/machinery/rnd/production/protolathe/department/science,
/obj/effect/turf_decal/tile/purple/opposingcorners,
/turf/open/floor/plasteel,
/area/ruin/unpowered)
"FM" = (
/obj/effect/turf_decal/stripes/line{
	dir = 5
	},
/obj/machinery/rnd/production/circuit_imprinter/department/science,
/obj/effect/turf_decal/tile/purple/opposingcorners,
/turf/open/floor/plasteel,
/area/ruin/unpowered)
"IM" = (
/obj/effect/turf_decal/tile/purple/anticorner/contrasted,
/turf/open/floor/plasteel/white,
/area/ruin/unpowered)
"KA" = (
/obj/effect/turf_decal/tile/purple/half/contrasted,
/turf/open/floor/plasteel/white,
/area/ruin/unpowered)
"Ni" = (
/obj/effect/turf_decal/stripes/line{
	dir = 4
	},
/obj/effect/turf_decal/tile/purple/opposingcorners,
/turf/open/floor/plasteel,
/area/ruin/unpowered)
"NW" = (
/obj/item/kirbyplants/random,
/obj/effect/turf_decal/tile/purple/anticorner/contrasted{
	dir = 8
	},
/turf/open/floor/plasteel/white,
/area/ruin/unpowered)
"Pp" = (
/obj/effect/turf_decal/stripes/line{
	dir = 4
	},
/obj/structure/table,
/obj/structure/window/reinforced,
/obj/item/circuitboard/computer/nanite_chamber_control,
/obj/item/circuitboard/computer/nanite_cloud_controller,
/obj/item/circuitboard/machine/nanite_chamber,
/obj/item/circuitboard/machine/nanite_program_hub,
/obj/effect/spawner/lootdrop/ruinloot/science,
/obj/effect/spawner/lootdrop/ruinloot/science,
/obj/effect/turf_decal/tile/purple/opposingcorners,
/turf/open/floor/plasteel,
/area/ruin/unpowered)
"PS" = (
/obj/effect/turf_decal/tile/purple/half/contrasted{
	dir = 1
	},
/turf/open/floor/plasteel/white,
/area/ruin/unpowered)
"QC" = (
/obj/effect/turf_decal/stripes/line{
	dir = 8
	},
/obj/machinery/rnd/destructive_analyzer,
/obj/effect/turf_decal/tile/purple/opposingcorners,
/turf/open/floor/plasteel,
/area/ruin/unpowered)
"RM" = (
/obj/effect/spawner/lootdrop/ruinloot/science,
/obj/effect/turf_decal/tile/purple,
/turf/open/floor/plasteel/white,
/area/ruin/unpowered)
"TH" = (
/obj/structure/chair/stool,
/obj/effect/turf_decal/tile/purple/half/contrasted{
	dir = 1
	},
/turf/open/floor/plasteel/white,
/area/ruin/unpowered)
"WT" = (
/obj/effect/turf_decal/stripes/corner{
	dir = 8
	},
/obj/structure/chair/stool,
/obj/effect/turf_decal/tile/purple/half/contrasted{
	dir = 1
	},
/turf/open/floor/plasteel/white,
/area/ruin/unpowered)
"XC" = (
/obj/effect/turf_decal/tile/purple/half/contrasted{
	dir = 4
	},
/turf/open/floor/plasteel/white,
/area/ruin/unpowered)

(1,1,1) = {"
au
au
au
au
au
au
af
au
au
"}
(2,1,1) = {"
au
an
is
Pp
aw
tG
aO
an
au
"}
(3,1,1) = {"
au
nq
TH
WT
cy
yc
aO
aj
au
"}
(4,1,1) = {"
au
XC
aP
aO
ao
RM
ao
ai
au
"}
(5,1,1) = {"
au
ec
aA
aO
nb
DS
bh
QC
au
"}
(6,1,1) = {"
au
aC
XC
aD
nb
FM
Ni
ry
au
"}
(7,1,1) = {"
au
an
ec
KA
IM
nq
PS
NW
au
"}
(8,1,1) = {"
au
Ar
Cb
nZ
qh
gk
KA
IM
au
"}
(9,1,1) = {"
au
au
ad
ad
ad
au
aV
ar
au
"}
(10,1,1) = {"
ap
ap
ap
ap
ap
ap
ap
ap
ap
"}
(11,1,1) = {"
aM
ap
ap
ap
ap
ap
ap
ap
ae
"}
(12,1,1) = {"
ap
ap
ap
ap
ap
ap
ap
ap
ap
"}
(13,1,1) = {"
au
au
au
au
au
au
au
au
au
"}
