//MAP CONVERTED BY dmm2tgm.py THIS HEADER COMMENT PREVENTS RECONVERSION, DO NOT REMOVE
"a" = (
/obj/effect/turf_decal/stripes/line{
	dir = 8
	},
/obj/machinery/rnd/destructive_analyzer,
/obj/effect/turf_decal/tile/purple,
/obj/effect/turf_decal/tile/purple{
	dir = 1
	},
/turf/open/floor/plasteel,
/area/ruin/unpowered)
"b" = (
/obj/effect/turf_decal/tile/purple{
	dir = 8
	},
/obj/effect/turf_decal/tile/purple{
	dir = 4
	},
/obj/effect/turf_decal/tile/purple{
	dir = 1
	},
/obj/effect/turf_decal/tile/purple,
/turf/open/floor/plasteel/white,
/area/ruin/unpowered)
"c" = (
/obj/effect/turf_decal/stripes/line{
	dir = 4
	},
/obj/machinery/computer/rdconsole/core{
	dir = 1
	},
/obj/effect/turf_decal/tile/purple,
/obj/effect/turf_decal/tile/purple{
	dir = 1
	},
/turf/open/floor/plasteel,
/area/ruin/unpowered)
"d" = (
/obj/effect/turf_decal/stripes/line{
	dir = 4
	},
/obj/effect/turf_decal/tile/purple,
/obj/effect/turf_decal/tile/purple{
	dir = 1
	},
/turf/open/floor/plasteel,
/area/ruin/unpowered)
"e" = (
/turf/open/floor/plasteel,
/area/ruin/unpowered)
"f" = (
/obj/effect/turf_decal/tile/purple{
	dir = 1
	},
/obj/effect/turf_decal/tile/purple{
	dir = 4
	},
/turf/open/floor/plasteel/white,
/area/ruin/unpowered)
"g" = (
/obj/effect/turf_decal/tile/purple{
	dir = 1
	},
/obj/effect/turf_decal/tile/purple{
	dir = 4
	},
/obj/effect/turf_decal/tile/purple,
/turf/open/floor/plasteel/white,
/area/ruin/unpowered)
"h" = (
/obj/effect/spawner/structure/window,
/turf/open/floor/plating,
/area/ruin/unpowered)
"i" = (
/obj/effect/turf_decal/tile/purple,
/turf/open/floor/plasteel/white,
/area/ruin/unpowered)
"j" = (
/obj/structure/table/reinforced,
/obj/item/paper_bin,
/obj/item/pen,
/turf/open/floor/plasteel/white,
/area/ruin/unpowered)
"k" = (
/obj/effect/turf_decal/tile/purple,
/obj/effect/turf_decal/tile/purple{
	dir = 8
	},
/obj/effect/turf_decal/tile/purple{
	dir = 1
	},
/turf/open/floor/plasteel/white,
/area/ruin/unpowered)
"l" = (
/turf/closed/wall,
/area/ruin/unpowered)
"m" = (
/obj/effect/turf_decal/tile/purple,
/obj/effect/turf_decal/tile/purple{
	dir = 8
	},
/turf/open/floor/plasteel/white,
/area/ruin/unpowered)
"n" = (
/obj/item/twohanded/required/kirbyplants/random,
/obj/machinery/light,
/obj/effect/turf_decal/tile/purple,
/obj/effect/turf_decal/tile/purple{
	dir = 8
	},
/turf/open/floor/plasteel/white,
/area/ruin/unpowered)
"o" = (
/obj/effect/turf_decal/stripes/line{
	dir = 8
	},
/obj/effect/turf_decal/tile/purple{
	dir = 1
	},
/obj/effect/turf_decal/tile/purple{
	dir = 8
	},
/turf/open/floor/plasteel/white,
/area/ruin/unpowered)
"p" = (
/obj/effect/turf_decal/tile/purple{
	dir = 1
	},
/obj/effect/turf_decal/tile/purple{
	dir = 8
	},
/obj/effect/turf_decal/tile/purple{
	dir = 4
	},
/turf/open/floor/plasteel/white,
/area/ruin/unpowered)
"q" = (
/obj/effect/turf_decal/stripes/line{
	dir = 9
	},
/obj/machinery/rnd/production/protolathe/department/science,
/obj/effect/turf_decal/tile/purple,
/obj/effect/turf_decal/tile/purple{
	dir = 1
	},
/turf/open/floor/plasteel,
/area/ruin/unpowered)
"r" = (
/obj/effect/turf_decal/tile/purple,
/obj/effect/turf_decal/tile/purple{
	dir = 4
	},
/obj/effect/turf_decal/tile/purple{
	dir = 1
	},
/obj/machinery/vending/wardrobe/science_wardrobe,
/turf/open/floor/plasteel/white,
/area/ruin/unpowered)
"s" = (
/obj/effect/turf_decal/stripes/corner{
	dir = 1
	},
/obj/effect/turf_decal/tile/purple{
	dir = 1
	},
/obj/effect/turf_decal/tile/purple{
	dir = 8
	},
/turf/open/floor/plasteel/white,
/area/ruin/unpowered)
"t" = (
/turf/open/floor/plasteel/white,
/area/ruin/unpowered)
"u" = (
/obj/effect/turf_decal/stripes/line{
	dir = 8
	},
/obj/structure/table,
/obj/item/folder/white{
	pixel_x = 4;
	pixel_y = 4
	},
/obj/item/folder/white{
	pixel_x = 4;
	pixel_y = 4
	},
/obj/item/crowbar,
/obj/effect/turf_decal/tile/purple{
	dir = 1
	},
/obj/effect/turf_decal/tile/purple,
/obj/effect/spawner/lootdrop/ruinloot/science,
/obj/effect/spawner/lootdrop/ruinloot/science,
/turf/open/floor/plasteel,
/area/ruin/unpowered)
"v" = (
/obj/effect/turf_decal/tile/purple{
	dir = 1
	},
/obj/effect/turf_decal/tile/purple,
/obj/effect/turf_decal/tile/purple{
	dir = 4
	},
/turf/open/floor/plasteel/white,
/area/ruin/unpowered)
"w" = (
/obj/effect/turf_decal/tile/purple{
	dir = 4
	},
/turf/open/floor/plasteel/white,
/area/ruin/unpowered)
"x" = (
/obj/effect/turf_decal/tile/purple,
/obj/effect/spawner/lootdrop/ruinloot/science,
/turf/open/floor/plasteel/white,
/area/ruin/unpowered)
"z" = (
/obj/machinery/door/airlock/science,
/turf/open/floor/plasteel/white,
/area/ruin/unpowered)
"A" = (
/obj/effect/turf_decal/stripes/line{
	dir = 8
	},
/obj/effect/turf_decal/tile/purple,
/obj/effect/turf_decal/tile/purple{
	dir = 1
	},
/turf/open/floor/plasteel,
/area/ruin/unpowered)
"B" = (
/obj/effect/turf_decal/stripes/line{
	dir = 6
	},
/obj/structure/table,
/obj/structure/window/reinforced{
	dir = 1
	},
/obj/item/clothing/glasses/science,
/obj/effect/turf_decal/tile/purple{
	dir = 1
	},
/obj/effect/turf_decal/tile/purple,
/obj/effect/spawner/lootdrop/ruinloot/science,
/turf/open/floor/plasteel,
/area/ruin/unpowered)
"C" = (
/obj/effect/abstract/open_area_marker,
/turf/open/floor/plasteel,
/area/ruin/unpowered)
"D" = (
/obj/effect/turf_decal/tile/purple,
/obj/effect/turf_decal/tile/purple{
	dir = 1
	},
/obj/effect/turf_decal/tile/purple{
	dir = 8
	},
/obj/effect/turf_decal/tile/purple{
	dir = 4
	},
/turf/open/floor/plasteel/white,
/area/ruin/unpowered)
"E" = (
/obj/machinery/door/window/eastleft{
	name = "Research and Development Deliveries";
	req_one_access_txt = "7;29"
	},
/obj/effect/turf_decal/delivery,
/turf/open/floor/plasteel,
/area/ruin/unpowered)
"F" = (
/obj/effect/turf_decal/tile/purple,
/obj/effect/turf_decal/tile/purple{
	dir = 4
	},
/turf/open/floor/plasteel/white,
/area/ruin/unpowered)
"G" = (
/obj/structure/table,
/obj/item/stack/sheet/iron/fifty,
/obj/effect/turf_decal/stripes/end,
/obj/item/clothing/glasses/welding,
/turf/open/floor/plasteel,
/area/ruin/unpowered)
"H" = (
/obj/effect/turf_decal/stripes/line{
	dir = 5
	},
/obj/machinery/rnd/production/circuit_imprinter/department/science,
/obj/effect/turf_decal/tile/purple,
/obj/effect/turf_decal/tile/purple{
	dir = 1
	},
/turf/open/floor/plasteel,
/area/ruin/unpowered)
"I" = (
/obj/effect/turf_decal/stripes/line{
	dir = 4
	},
/obj/structure/table,
/obj/structure/window/reinforced,
/obj/effect/turf_decal/tile/purple,
/obj/effect/turf_decal/tile/purple{
	dir = 1
	},
/obj/item/circuitboard/computer/nanite_chamber_control,
/obj/item/circuitboard/computer/nanite_cloud_controller,
/obj/item/circuitboard/machine/nanite_chamber,
/obj/item/circuitboard/machine/nanite_program_hub,
/obj/effect/spawner/lootdrop/ruinloot/science,
/obj/effect/spawner/lootdrop/ruinloot/science,
/turf/open/floor/plasteel,
/area/ruin/unpowered)
"J" = (
/obj/effect/abstract/doorway_marker{
	dir = 8
	},
/turf/open/floor/plasteel/white,
/area/ruin/unpowered)
"K" = (
/obj/effect/turf_decal/tile/purple{
	dir = 1
	},
/obj/effect/turf_decal/tile/purple{
	dir = 8
	},
/turf/open/floor/plasteel/white,
/area/ruin/unpowered)
"L" = (
/obj/effect/turf_decal/stripes/corner{
	dir = 8
	},
/obj/structure/chair/stool,
/obj/effect/turf_decal/tile/purple{
	dir = 1
	},
/obj/effect/turf_decal/tile/purple{
	dir = 8
	},
/turf/open/floor/plasteel/white,
/area/ruin/unpowered)
"M" = (
/obj/item/twohanded/required/kirbyplants/random,
/obj/effect/turf_decal/tile/purple,
/obj/effect/turf_decal/tile/purple{
	dir = 1
	},
/obj/effect/turf_decal/tile/purple{
	dir = 8
	},
/obj/machinery/camera/autoname{
	dir = 1
	},
/obj/effect/turf_decal/tile/purple,
/obj/effect/turf_decal/tile/purple{
	dir = 8
	},
/turf/open/floor/plasteel/white,
/area/ruin/unpowered)
"N" = (
/obj/effect/turf_decal/stripes/line{
	dir = 5
	},
/obj/structure/table,
/obj/effect/turf_decal/tile/purple,
/obj/effect/turf_decal/tile/purple{
	dir = 1
	},
/obj/item/hand_labeler,
/obj/effect/spawner/lootdrop/ruinloot/science,
/turf/open/floor/plasteel,
/area/ruin/unpowered)
"O" = (
/obj/structure/chair/stool,
/obj/effect/turf_decal/tile/purple{
	dir = 1
	},
/obj/effect/turf_decal/tile/purple{
	dir = 8
	},
/turf/open/floor/plasteel/white,
/area/ruin/unpowered)
"P" = (
/obj/effect/turf_decal/stripes/line{
	dir = 8
	},
/obj/structure/table,
/obj/item/disk/tech_disk{
	pixel_x = -2;
	pixel_y = -3
	},
/obj/item/disk/tech_disk{
	pixel_x = -2;
	pixel_y = -3
	},
/obj/item/disk/design_disk,
/obj/machinery/light{
	dir = 4
	},
/obj/effect/turf_decal/tile/purple{
	dir = 1
	},
/obj/effect/turf_decal/tile/purple,
/obj/effect/spawner/lootdrop/ruinloot/science,
/obj/effect/spawner/lootdrop/ruinloot/science,
/turf/open/floor/plasteel,
/area/ruin/unpowered)
"R" = (
/obj/effect/turf_decal/tile/purple{
	dir = 1
	},
/obj/effect/turf_decal/tile/purple{
	dir = 4
	},
/obj/effect/turf_decal/tile/purple{
	dir = 8
	},
/obj/effect/turf_decal/tile/purple,
/turf/open/floor/plasteel/white,
/area/ruin/unpowered)
"S" = (
/obj/effect/turf_decal/tile/purple,
/obj/effect/turf_decal/tile/purple{
	dir = 8
	},
/obj/effect/turf_decal/tile/purple{
	dir = 4
	},
/turf/open/floor/plasteel/white,
/area/ruin/unpowered)
"T" = (
/obj/effect/turf_decal/tile/purple{
	dir = 8
	},
/obj/effect/turf_decal/tile/purple,
/obj/effect/turf_decal/tile/purple{
	dir = 4
	},
/turf/open/floor/plasteel/white,
/area/ruin/unpowered)
"U" = (
/obj/effect/turf_decal/stripes/line{
	dir = 8
	},
/obj/structure/table,
/obj/machinery/cell_charger,
/obj/item/stock_parts/cell/high{
	charge = 100;
	maxcharge = 15000
	},
/obj/effect/turf_decal/tile/purple{
	dir = 1
	},
/obj/effect/turf_decal/tile/purple,
/turf/open/floor/plasteel,
/area/ruin/unpowered)
"V" = (
/obj/effect/abstract/open_area_marker{
	dir = 4
	},
/turf/open/floor/plasteel,
/area/ruin/unpowered)
"W" = (
/obj/effect/turf_decal/stripes/line{
	dir = 10
	},
/obj/machinery/computer/cargo/request{
	dir = 8
	},
/obj/effect/turf_decal/tile/purple{
	dir = 1
	},
/obj/effect/turf_decal/tile/purple,
/turf/open/floor/plasteel,
/area/ruin/unpowered)
"X" = (
/obj/effect/spawner/lootdrop/ruinloot/important,
/turf/open/floor/plasteel/white,
/area/ruin/unpowered)
"Y" = (
/obj/effect/spawner/lootdrop/ruinloot/science,
/turf/open/floor/plasteel/white,
/area/ruin/unpowered)
"Z" = (
/obj/effect/abstract/open_area_marker{
	dir = 1
	},
/turf/open/floor/plasteel,
/area/ruin/unpowered)

(1,1,1) = {"
l
l
l
l
l
l
J
l
l
"}
(2,1,1) = {"
l
b
N
I
E
B
t
D
l
"}
(3,1,1) = {"
l
p
O
L
o
s
t
k
l
"}
(4,1,1) = {"
l
f
X
t
i
x
i
n
l
"}
(5,1,1) = {"
l
g
w
t
m
q
A
a
l
"}
(6,1,1) = {"
l
G
f
Y
m
H
d
c
l
"}
(7,1,1) = {"
l
R
v
F
T
p
K
M
l
"}
(8,1,1) = {"
l
u
U
P
W
r
F
S
l
"}
(9,1,1) = {"
l
l
h
h
h
l
j
z
l
"}
(10,1,1) = {"
e
e
e
e
e
e
e
e
e
"}
(11,1,1) = {"
Z
e
e
e
e
e
e
e
C
"}
(12,1,1) = {"
e
e
e
e
e
e
e
e
e
"}
(13,1,1) = {"
l
l
l
e
V
e
l
l
l
"}
