//MAP CONVERTED BY dmm2tgm.py THIS HEADER COMMENT PREVENTS RECONVERSION, DO NOT REMOVE
"aa" = (
/turf/open/floor/iron,
/area/ruin/unpowered)
"ab" = (
/obj/effect/turf_decal/stripes/line,
/obj/structure/window/reinforced/spawner/directional/south,
/obj/effect/turf_decal/tile/blue,
/turf/open/floor/iron/white,
/area/ruin/unpowered)
"ac" = (
/obj/effect/abstract/open_area_marker,
/turf/open/floor/iron,
/area/ruin/unpowered)
"ad" = (
/obj/effect/turf_decal/tile/blue/half/contrasted{
	dir = 8
	},
/turf/open/floor/iron/white,
/area/ruin/unpowered)
"ae" = (
/obj/effect/turf_decal/tile/blue{
	dir = 1
	},
/turf/open/floor/iron/white,
/area/ruin/unpowered)
"af" = (
/obj/effect/turf_decal/tile/blue{
	dir = 8
	},
/turf/open/floor/iron/white,
/area/ruin/unpowered)
"ah" = (
/obj/machinery/atmospherics/pipe/smart/manifold/general/visible,
/obj/effect/turf_decal/tile/blue{
	dir = 8
	},
/turf/open/floor/iron/white,
/area/ruin/unpowered)
"ai" = (
/obj/machinery/portable_atmospherics/canister/oxygen,
/obj/effect/turf_decal/delivery,
/obj/machinery/atmospherics/components/unary/portables_connector/visible,
/obj/effect/turf_decal/tile/blue/fourcorners/contrasted,
/turf/open/floor/iron/white,
/area/ruin/unpowered)
"ak" = (
/turf/open/floor/iron/white,
/area/ruin/unpowered)
"al" = (
/obj/effect/turf_decal/stripes/corner{
	dir = 8
	},
/obj/effect/turf_decal/tile/blue/half/contrasted{
	dir = 8
	},
/turf/open/floor/iron/white,
/area/ruin/unpowered)
"am" = (
/obj/effect/turf_decal/tile/blue/half/contrasted{
	dir = 4
	},
/turf/open/floor/iron/white,
/area/ruin/unpowered)
"an" = (
/obj/machinery/atmospherics/pipe/smart/simple/general/visible{
	dir = 5
	},
/turf/open/floor/iron/white,
/area/ruin/unpowered)
"ao" = (
/obj/effect/turf_decal/stripes/corner{
	dir = 1
	},
/turf/open/floor/iron,
/area/ruin/unpowered)
"aq" = (
/obj/effect/abstract/doorway_marker{
	dir = 1
	},
/turf/open/floor/iron,
/area/ruin/unpowered)
"av" = (
/obj/effect/turf_decal/stripes/line{
	dir = 8
	},
/obj/structure/window/reinforced/spawner/directional/west,
/obj/effect/turf_decal/tile/blue/opposingcorners,
/turf/open/floor/iron/white,
/area/ruin/unpowered)
"aw" = (
/obj/effect/turf_decal/tile/blue{
	dir = 4
	},
/turf/open/floor/iron/white,
/area/ruin/unpowered)
"ay" = (
/obj/effect/turf_decal/stripes/corner{
	dir = 4
	},
/turf/open/floor/iron,
/area/ruin/unpowered)
"aC" = (
/obj/structure/closet/crate/freezer/blood,
/obj/effect/turf_decal/tile/blue/half/contrasted,
/turf/open/floor/iron/white,
/area/ruin/unpowered)
"aD" = (
/obj/effect/turf_decal/stripes/corner{
	dir = 8
	},
/obj/effect/turf_decal/tile/blue{
	dir = 8
	},
/turf/open/floor/iron/white,
/area/ruin/unpowered)
"aF" = (
/obj/structure/table/glass,
/obj/effect/spawner/random/ruinloot/medical,
/obj/effect/turf_decal/tile/blue/fourcorners/contrasted,
/turf/open/floor/iron/white,
/area/ruin/unpowered)
"aG" = (
/obj/machinery/sleeper{
	dir = 8
	},
/obj/effect/turf_decal/tile/blue/half/contrasted,
/turf/open/floor/iron/white,
/area/ruin/unpowered)
"aH" = (
/obj/effect/turf_decal/stripes/corner,
/obj/effect/turf_decal/tile/blue/half/contrasted{
	dir = 8
	},
/turf/open/floor/iron/white,
/area/ruin/unpowered)
"aJ" = (
/obj/structure/table/glass,
/obj/item/reagent_containers/cup/beaker/cryoxadone{
	pixel_x = 9;
	pixel_y = 11
	},
/obj/item/reagent_containers/cup/beaker/cryoxadone{
	pixel_x = 6;
	pixel_y = 5
	},
/obj/item/wrench/medical{
	pixel_y = 2
	},
/obj/effect/turf_decal/bot,
/obj/effect/spawner/random/ruinloot/medical,
/obj/effect/turf_decal/tile/blue/half/contrasted{
	dir = 4
	},
/turf/open/floor/iron/white,
/area/ruin/unpowered)
"aL" = (
/obj/machinery/atmospherics/pipe/smart/simple/general/visible{
	dir = 9
	},
/turf/open/floor/iron/white,
/area/ruin/unpowered)
"aN" = (
/obj/machinery/cryo_cell,
/obj/effect/turf_decal/delivery,
/obj/effect/turf_decal/tile/blue/fourcorners/contrasted,
/turf/open/floor/iron/white,
/area/ruin/unpowered)
"aO" = (
/obj/effect/abstract/open_area_marker{
	dir = 8
	},
/turf/open/floor/iron,
/area/ruin/unpowered)
"aP" = (
/obj/effect/turf_decal/stripes/line{
	dir = 8
	},
/obj/structure/window/reinforced/spawner/directional/west,
/obj/effect/turf_decal/tile/blue{
	dir = 1
	},
/turf/open/floor/iron/white,
/area/ruin/unpowered)
"aQ" = (
/obj/machinery/atmospherics/pipe/smart/simple/general/visible{
	dir = 4
	},
/obj/effect/turf_decal/tile/blue{
	dir = 8
	},
/turf/open/floor/iron/white,
/area/ruin/unpowered)
"aR" = (
/obj/structure/table/glass,
/obj/item/reagent_containers/cup/bottle/charcoal,
/obj/effect/spawner/random/ruinloot/medical,
/obj/effect/turf_decal/tile/blue/fourcorners/contrasted,
/turf/open/floor/iron/white,
/area/ruin/unpowered)
"aS" = (
/turf/closed/wall,
/area/ruin/unpowered)
"aT" = (
/obj/effect/turf_decal/tile/blue,
/turf/open/floor/iron/white,
/area/ruin/unpowered)
"aV" = (
/obj/effect/spawner/random/ruinloot/medical,
/obj/structure/table/glass,
/obj/effect/turf_decal/tile/blue{
	dir = 1
	},
/turf/open/floor/iron/white,
/area/ruin/unpowered)
"aW" = (
/obj/effect/turf_decal/stripes/line,
/obj/structure/window/reinforced/spawner/directional/south,
/obj/effect/turf_decal/tile/blue/opposingcorners,
/turf/open/floor/iron/white,
/area/ruin/unpowered)
"hM" = (
/obj/effect/turf_decal/tile/blue/opposingcorners,
/turf/open/floor/iron/white,
/area/ruin/unpowered)
"BN" = (
/obj/machinery/atmospherics/components/unary/thermomachine/freezer,
/obj/effect/turf_decal/delivery,
/obj/effect/turf_decal/tile/blue/fourcorners/contrasted,
/turf/open/floor/iron/white,
/area/ruin/unpowered)

(1,1,1) = {"
aS
aS
aS
aS
aS
aa
aO
aa
aS
"}
(2,1,1) = {"
aS
am
aV
aV
aW
aa
aa
aa
aS
"}
(3,1,1) = {"
aS
aN
an
aw
ab
aa
aa
aa
aS
"}
(4,1,1) = {"
aS
aJ
aQ
aw
ab
aa
aa
aa
aS
"}
(5,1,1) = {"
aS
aN
ah
aw
ab
ay
aa
aa
aS
"}
(6,1,1) = {"
aS
am
aQ
aw
al
ao
aa
aa
aa
"}
(7,1,1) = {"
aS
ai
ah
aw
ad
aa
aa
aa
ac
"}
(8,1,1) = {"
aS
ai
ah
ak
aH
ay
aa
aa
aa
"}
(9,1,1) = {"
aS
BN
aL
ak
aD
aP
aP
av
aS
"}
(10,1,1) = {"
aS
ae
ak
aw
aw
aw
aw
aT
aS
"}
(11,1,1) = {"
aq
ae
af
af
af
af
ak
aT
aS
"}
(12,1,1) = {"
aS
hM
aT
aG
aF
aG
aR
aC
aS
"}
(13,1,1) = {"
aS
aS
aS
aS
aS
aS
aS
aS
aS
"}
