//MAP CONVERTED BY dmm2tgm.py THIS HEADER COMMENT PREVENTS RECONVERSION, DO NOT REMOVE
"a" = (
/obj/effect/abstract/open_area_marker{
	dir = 8
	},
/turf/open/floor/plasteel,
/area/ruin/unpowered)
"b" = (
/obj/machinery/door/poddoor/shutters/preopen{
	dir = 1
	},
/obj/effect/turf_decal/stripes/line{
	dir = 2
	},
/turf/open/floor/plasteel/dark,
/area/ruin/unpowered)
"c" = (
/obj/structure/shuttle/engine/heater{
	dir = 4
	},
/obj/structure/window/reinforced/tinted{
	dir = 8
	},
/turf/open/floor/plating,
/area/ruin/unpowered)
"f" = (
/obj/structure/shuttle/engine/propulsion/burst/right{
	dir = 4
	},
/turf/closed/wall/mineral/plastitanium,
/area/ruin/unpowered)
"g" = (
/obj/machinery/computer{
	dir = 4
	},
/turf/open/floor/mineral/titanium,
/area/ruin/unpowered)
"h" = (
/turf/open/floor/plasteel,
/area/ruin/unpowered)
"i" = (
/obj/effect/turf_decal/stripes/corner{
	dir = 2
	},
/turf/open/floor/plasteel,
/area/ruin/unpowered)
"l" = (
/obj/effect/turf_decal/delivery{
	dir = 4
	},
/obj/effect/spawner/lootdrop/crate_spawner{
	dir = 1
	},
/turf/open/floor/plasteel/dark,
/area/ruin/unpowered)
"n" = (
/obj/effect/turf_decal/bot{
	dir = 4
	},
/turf/open/floor/plasteel,
/area/ruin/unpowered)
"r" = (
/obj/structure/rack{
	dir = 1
	},
/turf/open/floor/mineral/titanium,
/area/ruin/unpowered)
"s" = (
/obj/effect/spawner/lootdrop/crate_spawner{
	dir = 1
	},
/turf/open/floor/mineral/titanium,
/area/ruin/unpowered)
"t" = (
/obj/effect/spawner/structure/window/shuttle{
	dir = 1
	},
/turf/open/floor/plating,
/area/ruin/unpowered)
"u" = (
/obj/effect/turf_decal/tile/brown{
	dir = 1
	},
/obj/effect/turf_decal/tile/brown{
	dir = 8
	},
/obj/effect/turf_decal/tile/brown{
	dir = 2
	},
/turf/open/floor/plasteel/dark,
/area/ruin/unpowered)
"v" = (
/obj/structure/shuttle/engine/propulsion/burst/left{
	dir = 4
	},
/turf/closed/wall/mineral/plastitanium,
/area/ruin/unpowered)
"w" = (
/obj/effect/spawner/lootdrop/crate_spawner{
	dir = 1
	},
/turf/open/floor/plasteel/dark,
/area/ruin/unpowered)
"y" = (
/obj/effect/turf_decal/delivery{
	dir = 4
	},
/obj/effect/spawner/lootdrop/glowstick/lit{
	dir = 1
	},
/turf/open/floor/plasteel,
/area/ruin/unpowered)
"B" = (
/turf/closed/wall/mineral/plastitanium,
/area/ruin/unpowered)
"C" = (
/obj/effect/turf_decal/stripes/line{
	dir = 2
	},
/turf/open/floor/plasteel,
/area/ruin/unpowered)
"D" = (
/obj/effect/turf_decal/delivery{
	dir = 4
	},
/turf/open/floor/plasteel/dark,
/area/ruin/unpowered)
"E" = (
/turf/open/floor/mineral/titanium,
/area/ruin/unpowered)
"F" = (
/obj/effect/turf_decal/tile/brown{
	dir = 2
	},
/obj/effect/turf_decal/tile/brown{
	dir = 4
	},
/turf/open/floor/plasteel/dark,
/area/ruin/unpowered)
"G" = (
/obj/effect/turf_decal/delivery{
	dir = 4
	},
/obj/effect/spawner/lootdrop/crate_spawner{
	dir = 1
	},
/turf/open/floor/plasteel,
/area/ruin/unpowered)
"H" = (
/obj/effect/turf_decal/bot{
	dir = 4
	},
/obj/effect/spawner/lootdrop/crate_spawner{
	dir = 1
	},
/turf/open/floor/plasteel,
/area/ruin/unpowered)
"I" = (
/obj/machinery/door/airlock/mining{
	dir = 1
	},
/turf/open/floor/plasteel,
/area/ruin/unpowered)
"J" = (
/obj/effect/turf_decal/delivery{
	dir = 4
	},
/turf/open/floor/plasteel,
/area/ruin/unpowered)
"K" = (
/obj/effect/turf_decal/tile/brown{
	dir = 2
	},
/obj/effect/turf_decal/tile/brown{
	dir = 8
	},
/turf/open/floor/plasteel/dark,
/area/ruin/unpowered)
"M" = (
/turf/closed/wall,
/area/ruin/unpowered)
"N" = (
/obj/effect/turf_decal/tile/brown{
	dir = 2
	},
/obj/effect/turf_decal/tile/brown{
	dir = 8
	},
/obj/effect/turf_decal/tile/brown{
	dir = 4
	},
/turf/open/floor/plasteel/dark,
/area/ruin/unpowered)
"P" = (
/obj/structure/chair/comfy/shuttle{
	dir = 8
	},
/turf/open/floor/mineral/titanium,
/area/ruin/unpowered)
"Q" = (
/obj/effect/turf_decal/stripes/line{
	dir = 4
	},
/turf/open/floor/plasteel,
/area/ruin/unpowered)
"S" = (
/turf/open/floor/engine,
/area/ruin/unpowered)
"T" = (
/obj/structure/shuttle/engine/propulsion/burst/cargo{
	dir = 4
	},
/turf/open/floor/plating,
/area/ruin/unpowered)
"V" = (
/turf/open/floor/plasteel/dark,
/area/ruin/unpowered)
"W" = (
/obj/effect/turf_decal/tile/brown{
	dir = 1
	},
/obj/effect/turf_decal/tile/brown{
	dir = 8
	},
/turf/open/floor/plasteel/dark,
/area/ruin/unpowered)
"X" = (
/obj/machinery/door/poddoor/shutters/preopen{
	dir = 1
	},
/obj/effect/turf_decal/stripes/line{
	dir = 1
	},
/turf/open/floor/mineral/titanium,
/area/ruin/unpowered)
"Y" = (
/turf/closed/wall/mineral/titanium,
/area/ruin/unpowered)

(1,1,1) = {"
M
M
M
M
M
M
M
M
M
h
a
h
M"}(2,1,1) = {"
M
h
h
h
h
h
h
h
h
h
h
h
M"}(3,1,1) = {"
M
h
H
J
J
h
h
h
h
h
h
h
M"}(4,1,1) = {"
M
h
h
h
h
h
h
h
h
h
h
h
M"}(5,1,1) = {"
M
h
n
y
G
h
h
h
h
h
h
h
M"}(6,1,1) = {"
M
h
h
h
h
h
h
h
h
h
h
h
M"}(7,1,1) = {"
M
h
n
G
J
i
Q
Q
Q
Q
Q
Q
M"}(8,1,1) = {"
M
h
h
h
h
C
S
S
S
S
S
S
M"}(9,1,1) = {"
M
h
h
h
h
C
S
Y
t
t
Y
S
M"}(10,1,1) = {"
M
M
M
I
M
M
Y
Y
g
g
Y
Y
M"}(11,1,1) = {"
M
W
W
W
u
M
Y
r
P
P
s
Y
M"}(12,1,1) = {"
M
V
l
l
K
b
X
E
E
E
E
Y
M"}(13,1,1) = {"
M
V
V
V
K
b
X
E
E
s
E
Y
M"}(14,1,1) = {"
M
V
V
w
K
b
X
E
E
E
s
Y
M"}(15,1,1) = {"
M
V
l
D
K
M
B
B
c
c
B
B
M"}(16,1,1) = {"
M
F
F
F
N
M
S
v
T
T
f
S
M"}(17,1,1) = {"
M
M
M
M
M
M
M
M
M
M
M
M
M"}