//MAP CONVERTED BY dmm2tgm.py THIS HEADER COMMENT PREVENTS RECONVERSION, DO NOT REMOVE
"b" = (
/obj/effect/abstract/doorway_marker,
/turf/open/floor/plasteel,
/area/ruin/unpowered)
"l" = (
/obj/structure/mopbucket,
/obj/item/mop/cyborg,
/obj/effect/turf_decal/delivery,
/turf/open/floor/plasteel,
/area/ruin/unpowered)
"n" = (
/obj/effect/turf_decal/tile/green,
/obj/effect/turf_decal/tile/green{
	dir = 4
	},
/obj/effect/turf_decal/tile/green{
	dir = 8
	},
/turf/open/floor/plasteel,
/area/ruin/unpowered)
"x" = (
/obj/effect/turf_decal/tile/green{
	dir = 8
	},
/obj/effect/turf_decal/tile/green{
	dir = 1
	},
/obj/effect/turf_decal/tile/green,
/obj/structure/reagent_dispensers/watertank,
/obj/item/reagent_containers/glass/bucket,
/turf/open/floor/plasteel,
/area/ruin/unpowered)
"y" = (
/obj/structure/rack,
/obj/effect/turf_decal/delivery,
/obj/item/soap/nanotrasen,
/turf/open/floor/plasteel,
/area/ruin/unpowered)
"E" = (
/obj/effect/turf_decal/tile/green{
	dir = 8
	},
/obj/effect/turf_decal/tile/green{
	dir = 4
	},
/obj/effect/turf_decal/tile/green{
	dir = 1
	},
/turf/open/floor/plasteel,
/area/ruin/unpowered)
"M" = (
/turf/closed/wall,
/area/ruin/unpowered)
"P" = (
/obj/effect/turf_decal/tile/green{
	dir = 1
	},
/obj/effect/turf_decal/tile/green,
/obj/effect/turf_decal/tile/green{
	dir = 4
	},
/obj/structure/sink{
	dir = 4;
	pixel_x = 12
	},
/turf/open/floor/plasteel,
/area/ruin/unpowered)
"V" = (
/obj/effect/turf_decal/tile/green{
	dir = 1
	},
/obj/effect/turf_decal/tile/green{
	dir = 4
	},
/obj/structure/sign/poster/contraband/lusty_xenomorph{
	pixel_y = 32
	},
/turf/open/floor/plasteel,
/area/ruin/unpowered)
"W" = (
/turf/open/floor/plasteel,
/area/ruin/unpowered)

(1,1,1) = {"
M
M
M
M
M
"}
(2,1,1) = {"
M
y
E
x
M
"}
(3,1,1) = {"
M
V
W
W
b
"}
(4,1,1) = {"
M
l
P
n
M
"}
(5,1,1) = {"
M
M
M
M
M
"}
