//MAP CONVERTED BY dmm2tgm.py THIS HEADER COMMENT PREVENTS RECONVERSION, DO NOT REMOVE
"c" = (
/obj/structure/urinal{
	pixel_y = 32
	},
/turf/open/floor/plasteel/showroomfloor,
/area/ruin/unpowered)
"g" = (
/obj/structure/sink{
	dir = 8;
	pixel_x = -14
	},
/obj/structure/mirror{
	pixel_x = -28
	},
/obj/effect/turf_decal/trimline/green/filled/arrow_cw,
/turf/open/floor/plasteel/showroomfloor,
/area/ruin/unpowered)
"l" = (
/obj/structure/sign/poster/random{
	pixel_y = 32
	},
/obj/effect/turf_decal/trimline/green/filled/shrink_ccw{
	dir = 1
	},
/turf/open/floor/plasteel/showroomfloor,
/area/ruin/unpowered)
"o" = (
/obj/machinery/shower{
	dir = 8
	},
/obj/machinery/door/window/westright,
/obj/structure/window/reinforced/tinted,
/turf/open/floor/plasteel/showroomfloor,
/area/ruin/unpowered)
"p" = (
/turf/open/floor/plasteel/showroomfloor,
/area/ruin/unpowered)
"q" = (
/turf/closed/wall,
/area/ruin/unpowered)
"x" = (
/obj/effect/turf_decal/tile/green/tile_full,
/turf/open/floor/plasteel/showroomfloor,
/area/ruin/unpowered)
"K" = (
/obj/effect/abstract/doorway_marker{
	dir = 8
	},
/turf/open/floor/plasteel,
/area/ruin/unpowered)
"M" = (
/obj/effect/turf_decal/trimline/green/filled/shrink_ccw,
/turf/open/floor/plasteel/showroomfloor,
/area/ruin/unpowered)
"X" = (
/obj/structure/toilet{
	dir = 8
	},
/obj/structure/window/reinforced/tinted{
	dir = 1
	},
/obj/machinery/door/window/westleft,
/turf/open/floor/plasteel/showroomfloor,
/area/ruin/unpowered)
"Y" = (
/obj/structure/urinal{
	pixel_y = 32
	},
/obj/structure/window/reinforced/tinted,
/obj/effect/turf_decal/trimline/green/filled/arrow_cw{
	dir = 1
	},
/turf/open/floor/plasteel/showroomfloor,
/area/ruin/unpowered)

(1,1,1) = {"
q
q
K
q
q
"}
(2,1,1) = {"
q
c
p
g
q
"}
(3,1,1) = {"
q
l
x
M
q
"}
(4,1,1) = {"
q
Y
o
X
q
"}
(5,1,1) = {"
q
q
q
q
q
"}
