//MAP CONVERTED BY dmm2tgm.py THIS HEADER COMMENT PREVENTS RECONVERSION, DO NOT REMOVE
"a" = (
/obj/machinery/gateway{
	dir = 4
	},
/obj/effect/turf_decal/bot_white{
	dir = 4
	},
/obj/effect/turf_decal/tile/neutral{
	dir = 8
	},
/obj/effect/turf_decal/tile/neutral{
	dir = 4
	},
/obj/effect/turf_decal/tile/neutral{
	dir = 2
	},
/obj/effect/turf_decal/tile/neutral{
	dir = 1
	},
/turf/open/floor/plasteel/dark,
/area/ruin/unpowered)
"b" = (
/obj/machinery/gateway{
	dir = 6
	},
/obj/effect/turf_decal/bot_white/left{
	dir = 4
	},
/obj/effect/turf_decal/tile/neutral{
	dir = 8
	},
/obj/effect/turf_decal/tile/neutral{
	dir = 4
	},
/obj/effect/turf_decal/tile/neutral{
	dir = 2
	},
/obj/effect/turf_decal/tile/neutral{
	dir = 1
	},
/turf/open/floor/plasteel/dark,
/area/ruin/unpowered)
"d" = (
/obj/effect/abstract/open_area_marker{
	dir = 1
	},
/turf/open/floor/plasteel,
/area/ruin/unpowered)
"f" = (
/obj/machinery/gateway{
	dir = 1
	},
/obj/effect/turf_decal/bot_white{
	dir = 4
	},
/obj/effect/turf_decal/tile/neutral{
	dir = 8
	},
/obj/effect/turf_decal/tile/neutral{
	dir = 4
	},
/obj/effect/turf_decal/tile/neutral{
	dir = 2
	},
/obj/effect/turf_decal/tile/neutral{
	dir = 1
	},
/turf/open/floor/plasteel/dark,
/area/ruin/unpowered)
"h" = (
/turf/closed/wall/r_wall,
/area/ruin/unpowered)
"p" = (
/obj/machinery/gateway{
	dir = 10
	},
/obj/effect/turf_decal/bot_white/right{
	dir = 4
	},
/obj/effect/turf_decal/tile/neutral{
	dir = 8
	},
/obj/effect/turf_decal/tile/neutral{
	dir = 4
	},
/obj/effect/turf_decal/tile/neutral{
	dir = 2
	},
/obj/effect/turf_decal/tile/neutral{
	dir = 1
	},
/turf/open/floor/plasteel/dark,
/area/ruin/unpowered)
"s" = (
/obj/machinery/gateway{
	dir = 5
	},
/obj/effect/turf_decal/bot_white/right{
	dir = 4
	},
/obj/effect/turf_decal/tile/neutral{
	dir = 8
	},
/obj/effect/turf_decal/tile/neutral{
	dir = 4
	},
/obj/effect/turf_decal/tile/neutral{
	dir = 2
	},
/obj/effect/turf_decal/tile/neutral{
	dir = 1
	},
/turf/open/floor/plasteel/dark,
/area/ruin/unpowered)
"x" = (
/obj/effect/turf_decal/tile/neutral{
	dir = 8
	},
/obj/effect/turf_decal/tile/neutral{
	dir = 4
	},
/obj/effect/turf_decal/tile/neutral{
	dir = 2
	},
/obj/effect/turf_decal/tile/neutral{
	dir = 1
	},
/turf/open/floor/plasteel/dark,
/area/ruin/unpowered)
"C" = (
/obj/machinery/door/poddoor/shutters{
	id = "gateshutter";
	name = "Gateway Access Shutter";
	dir = 1
	},
/obj/effect/turf_decal/delivery{
	dir = 4
	},
/obj/machinery/door/firedoor/border_only{
	dir = 1
	},
/obj/machinery/door/firedoor/border_only{
	dir = 2
	},
/turf/open/floor/plasteel,
/area/ruin/unpowered)
"H" = (
/obj/machinery/gateway{
	dir = 2
	},
/obj/machinery/status_display/evac{
	pixel_y = -32;
	dir = 1
	},
/obj/effect/turf_decal/bot_white{
	dir = 4
	},
/obj/effect/turf_decal/tile/neutral{
	dir = 8
	},
/obj/effect/turf_decal/tile/neutral{
	dir = 4
	},
/obj/effect/turf_decal/tile/neutral{
	dir = 2
	},
/obj/effect/turf_decal/tile/neutral{
	dir = 1
	},
/turf/open/floor/plasteel/dark,
/area/ruin/unpowered)
"K" = (
/obj/machinery/gateway{
	dir = 8
	},
/obj/effect/turf_decal/bot_white{
	dir = 4
	},
/obj/effect/turf_decal/tile/neutral{
	dir = 8
	},
/obj/effect/turf_decal/tile/neutral{
	dir = 4
	},
/obj/effect/turf_decal/tile/neutral{
	dir = 2
	},
/obj/effect/turf_decal/tile/neutral{
	dir = 1
	},
/turf/open/floor/plasteel/dark,
/area/ruin/unpowered)
"M" = (
/obj/effect/turf_decal/stripes/line{
	dir = 1
	},
/turf/open/floor/plasteel,
/area/ruin/unpowered)
"S" = (
/obj/machinery/gateway/centeraway{
	dir = 1
	},
/turf/open/floor/plasteel/dark,
/area/ruin/unpowered)
"T" = (
/obj/machinery/gateway{
	dir = 9
	},
/obj/effect/turf_decal/bot_white/left{
	dir = 4
	},
/obj/effect/turf_decal/tile/neutral{
	dir = 8
	},
/obj/effect/turf_decal/tile/neutral{
	dir = 4
	},
/obj/effect/turf_decal/tile/neutral{
	dir = 2
	},
/obj/effect/turf_decal/tile/neutral{
	dir = 1
	},
/turf/open/floor/plasteel/dark,
/area/ruin/unpowered)
"V" = (
/turf/open/floor/plasteel,
/area/ruin/unpowered)

(1,1,1) = {"
h
h
h
h
h
h
h
h
h"}(2,1,1) = {"
V
V
C
M
x
T
K
p
h"}(3,1,1) = {"
d
V
C
M
x
f
S
H
h"}(4,1,1) = {"
V
V
C
M
x
s
a
b
h"}(5,1,1) = {"
h
h
h
h
h
h
h
h
h"}