//MAP CONVERTED BY dmm2tgm.py THIS HEADER COMMENT PREVENTS RECONVERSION, DO NOT REMOVE
"d" = (
/obj/effect/abstract/open_area_marker,
/turf/open/floor/plasteel,
/area/ruin/unpowered)
"h" = (
/turf/closed/wall/r_wall,
/area/ruin/unpowered)
"j" = (
/obj/machinery/gateway{
	dir = 4
	},
/obj/effect/turf_decal/bot_white,
/obj/effect/turf_decal/tile/neutral/fourcorners/contrasted,
/turf/open/floor/plasteel/dark,
/area/ruin/unpowered)
"k" = (
/obj/machinery/gateway{
	dir = 8
	},
/obj/effect/turf_decal/bot_white,
/obj/effect/turf_decal/tile/neutral/fourcorners/contrasted,
/turf/open/floor/plasteel/dark,
/area/ruin/unpowered)
"l" = (
/obj/machinery/gateway,
/obj/effect/turf_decal/bot_white,
/obj/effect/turf_decal/tile/neutral/fourcorners/contrasted,
/turf/open/floor/plasteel/dark,
/area/ruin/unpowered)
"t" = (
/obj/machinery/gateway{
	dir = 6
	},
/obj/effect/turf_decal/bot_white/right,
/obj/effect/turf_decal/tile/neutral/fourcorners/contrasted,
/turf/open/floor/plasteel/dark,
/area/ruin/unpowered)
"B" = (
/obj/machinery/gateway{
	dir = 9
	},
/obj/effect/turf_decal/bot_white/right,
/obj/effect/turf_decal/tile/neutral/fourcorners/contrasted,
/turf/open/floor/plasteel/dark,
/area/ruin/unpowered)
"C" = (
/obj/machinery/door/poddoor/shutters{
	id = "gateshutter";
	name = "Gateway Access Shutter"
	},
/obj/effect/turf_decal/delivery,
/obj/machinery/door/firedoor/border_only,
/turf/open/floor/plasteel,
/area/ruin/unpowered)
"G" = (
/obj/effect/turf_decal/tile/neutral/fourcorners/contrasted,
/turf/open/floor/plasteel/dark,
/area/ruin/unpowered)
"L" = (
/obj/machinery/gateway{
	dir = 5
	},
/obj/effect/turf_decal/bot_white/left,
/obj/effect/turf_decal/tile/neutral/fourcorners/contrasted,
/turf/open/floor/plasteel/dark,
/area/ruin/unpowered)
"M" = (
/obj/effect/turf_decal/stripes/line,
/turf/open/floor/plasteel,
/area/ruin/unpowered)
"S" = (
/obj/machinery/gateway/centeraway,
/turf/open/floor/plasteel/dark,
/area/ruin/unpowered)
"V" = (
/turf/open/floor/plasteel,
/area/ruin/unpowered)
"W" = (
/obj/machinery/gateway{
	dir = 10
	},
/obj/effect/turf_decal/bot_white/left,
/obj/effect/turf_decal/tile/neutral/fourcorners/contrasted,
/turf/open/floor/plasteel/dark,
/area/ruin/unpowered)
"Y" = (
/obj/machinery/gateway{
	dir = 1
	},
/obj/machinery/status_display/evac{
	pixel_y = 32
	},
/obj/effect/turf_decal/bot_white,
/obj/effect/turf_decal/tile/neutral/fourcorners/contrasted,
/turf/open/floor/plasteel/dark,
/area/ruin/unpowered)

(1,1,1) = {"
h
h
h
h
h
h
h
h
h
"}
(2,1,1) = {"
h
B
k
W
G
M
C
V
V
"}
(3,1,1) = {"
h
Y
S
l
G
M
C
V
d
"}
(4,1,1) = {"
h
L
j
t
G
M
C
V
V
"}
(5,1,1) = {"
h
h
h
h
h
h
h
h
h
"}
