//MAP CONVERTED BY dmm2tgm.py THIS HEADER COMMENT PREVENTS RECONVERSION, DO NOT REMOVE
"a" = (
/obj/machinery/vending/wardrobe/medi_wardrobe,
/obj/effect/turf_decal/tile/blue{
	dir = 8
	},
/obj/effect/turf_decal/tile/blue{
	dir = 1
	},
/obj/effect/turf_decal/tile/blue{
	dir = 4
	},
/obj/effect/turf_decal/tile/blue,
/turf/open/floor/plasteel/white,
/area/space)
"b" = (
/obj/effect/turf_decal/tile/blue,
/obj/effect/turf_decal/tile/blue{
	dir = 1
	},
/turf/open/floor/plasteel/white,
/area/space)
"d" = (
/obj/effect/spawner/structure/window,
/turf/open/floor/plating,
/area/space)
"e" = (
/obj/effect/abstract/open_area_marker{
	dir = 8
	},
/turf/open/floor/plasteel/white,
/area/space)
"g" = (
/obj/effect/abstract/open_area_marker{
	dir = 4
	},
/turf/open/floor/plasteel/white,
/area/space)
"h" = (
/obj/structure/frame/machine,
/obj/effect/turf_decal/tile/blue{
	dir = 8
	},
/obj/effect/turf_decal/tile/blue{
	dir = 1
	},
/obj/effect/turf_decal/tile/blue{
	dir = 4
	},
/obj/effect/turf_decal/tile/blue,
/turf/open/floor/plasteel/white,
/area/space)
"i" = (
/obj/structure/window/reinforced,
/obj/structure/frame/computer{
	dir = 4
	},
/obj/effect/turf_decal/tile/blue{
	dir = 8
	},
/obj/effect/turf_decal/tile/blue{
	dir = 1
	},
/obj/effect/turf_decal/tile/blue{
	dir = 4
	},
/obj/effect/turf_decal/tile/blue,
/turf/open/floor/plasteel/white,
/area/space)
"n" = (
/obj/structure/table/glass,
/obj/machinery/door/window{
	dir = 4
	},
/obj/effect/spawner/lootdrop/ruinloot/medical,
/obj/effect/spawner/lootdrop/ruinloot/medical,
/turf/open/floor/plasteel/white,
/area/space)
"s" = (
/obj/structure/table/glass,
/obj/structure/window/reinforced{
	dir = 8
	},
/obj/effect/spawner/lootdrop/ruinloot/medical,
/turf/open/floor/plasteel/white,
/area/space)
"t" = (
/turf/closed/wall,
/area/space)
"u" = (
/obj/effect/turf_decal/tile/blue{
	dir = 1
	},
/turf/open/floor/plasteel/white,
/area/space)
"y" = (
/obj/effect/abstract/doorway_marker,
/turf/open/floor/plasteel/white,
/area/space)
"z" = (
/obj/structure/window/reinforced{
	dir = 1
	},
/obj/effect/turf_decal/tile/blue{
	dir = 1
	},
/obj/effect/turf_decal/tile/blue{
	dir = 4
	},
/obj/effect/turf_decal/tile/blue,
/obj/effect/turf_decal/tile/blue{
	dir = 8
	},
/turf/open/floor/plasteel/white,
/area/space)
"A" = (
/obj/machinery/door/airlock/medical/glass,
/turf/open/floor/plasteel/white,
/area/space)
"G" = (
/obj/effect/turf_decal/tile/blue,
/turf/open/floor/plasteel/white,
/area/space)
"J" = (
/obj/structure/window/reinforced,
/obj/structure/closet/secure_closet/medical3,
/obj/effect/turf_decal/tile/blue{
	dir = 8
	},
/obj/effect/turf_decal/tile/blue{
	dir = 1
	},
/obj/effect/turf_decal/tile/blue{
	dir = 4
	},
/obj/effect/turf_decal/tile/blue,
/turf/open/floor/plasteel/white,
/area/space)
"K" = (
/obj/structure/table/glass,
/obj/structure/window/reinforced{
	dir = 4
	},
/obj/effect/spawner/lootdrop/ruinloot/medical,
/turf/open/floor/plasteel/white,
/area/space)
"P" = (
/obj/effect/turf_decal/tile/blue{
	dir = 8
	},
/turf/open/floor/plasteel/white,
/area/space)
"Q" = (
/obj/effect/turf_decal/tile/blue{
	dir = 1
	},
/turf/closed/wall,
/area/space)
"R" = (
/obj/machinery/vending/medical,
/obj/effect/turf_decal/tile/blue{
	dir = 8
	},
/obj/effect/turf_decal/tile/blue{
	dir = 8
	},
/obj/effect/turf_decal/tile/blue{
	dir = 1
	},
/obj/effect/turf_decal/tile/blue{
	dir = 4
	},
/obj/effect/turf_decal/tile/blue,
/turf/open/floor/plasteel/white,
/area/space)
"V" = (
/obj/structure/closet/secure_closet/medical3,
/obj/effect/turf_decal/tile/blue{
	dir = 8
	},
/obj/effect/turf_decal/tile/blue{
	dir = 1
	},
/obj/effect/turf_decal/tile/blue{
	dir = 4
	},
/obj/effect/turf_decal/tile/blue,
/turf/open/floor/plasteel/white,
/area/space)
"X" = (
/turf/open/floor/plasteel/white,
/area/space)
"Y" = (
/obj/structure/table/glass,
/obj/machinery/door/window{
	dir = 8
	},
/obj/item/storage/firstaid,
/turf/open/floor/plasteel/white,
/area/space)
"Z" = (
/obj/effect/turf_decal/tile/blue{
	dir = 8
	},
/obj/effect/turf_decal/tile/blue,
/turf/open/floor/plasteel/white,
/area/space)

(1,1,1) = {"
t
X
e
X
t
t
t
t
t
t
t
Q
t
"}
(2,1,1) = {"
t
X
X
G
t
a
R
i
K
n
K
z
t
"}
(3,1,1) = {"
t
X
X
Z
d
u
u
u
u
u
u
b
y
"}
(4,1,1) = {"
t
X
X
Z
A
u
X
X
X
X
X
G
t
"}
(5,1,1) = {"
t
X
X
Z
d
u
X
d
t
d
X
G
t
"}
(6,1,1) = {"
t
X
X
Z
A
u
X
X
X
X
X
G
t
"}
(7,1,1) = {"
t
X
X
Z
d
b
G
G
G
G
G
G
t
"}
(8,1,1) = {"
t
X
X
P
t
h
V
J
s
Y
s
z
t
"}
(9,1,1) = {"
t
X
g
X
t
t
t
t
t
t
t
t
t
"}
