//MAP CONVERTED BY dmm2tgm.py THIS HEADER COMMENT PREVENTS RECONVERSION, DO NOT REMOVE
"a" = (
/turf/closed/wall,
/area/ruin/unpowered)
"c" = (
/obj/effect/turf_decal/tile/neutral/tile_full,
/obj/effect/turf_decal/bot_white/right,
/obj/structure/frame/machine,
/turf/open/floor/plasteel/dark/airless,
/area/ruin/unpowered)
"d" = (
/obj/structure/closet/crate/goldcrate,
/obj/effect/turf_decal/tile/neutral/tile_full,
/obj/effect/turf_decal/bot_white/right,
/obj/effect/spawner/lootdrop/ruinloot/important,
/turf/open/floor/plasteel/dark/airless,
/area/ruin/unpowered)
"f" = (
/obj/structure/closet/crate/silvercrate,
/obj/effect/turf_decal/tile/neutral/tile_full,
/obj/effect/turf_decal/bot_white/left,
/turf/open/floor/plasteel/dark/airless,
/area/ruin/unpowered)
"g" = (
/obj/effect/turf_decal/stripes/line{
	dir = 1
	},
/turf/open/floor/plasteel,
/area/ruin/unpowered)
"h" = (
/obj/effect/abstract/doorway_marker,
/turf/open/floor/plasteel,
/area/ruin/unpowered)
"i" = (
/turf/closed/wall/r_wall,
/area/ruin/unpowered)
"k" = (
/obj/effect/turf_decal/tile/neutral/tile_full,
/turf/open/floor/plasteel/dark,
/area/ruin/unpowered)
"l" = (
/obj/effect/turf_decal/tile/neutral/tile_full,
/obj/effect/turf_decal/bot_white/right,
/obj/item/circuitboard/machine/ore_silo,
/turf/open/floor/plasteel/dark/airless,
/area/ruin/unpowered)
"o" = (
/turf/open/floor/plasteel,
/area/ruin/unpowered)
"r" = (
/obj/structure/frame/machine,
/obj/item/stamp/clown{
	pixel_y = 5
	},
/obj/effect/turf_decal/tile/neutral/tile_full,
/turf/open/floor/plasteel/dark,
/area/ruin/unpowered)
"t" = (
/obj/item/weldingtool/mini,
/turf/open/floor/plating/airless{
	icon_state = "panelscorched"
	},
/area/ruin/unpowered)
"u" = (
/obj/effect/turf_decal/stripes/corner{
	dir = 1
	},
/turf/open/floor/plasteel,
/area/ruin/unpowered)
"w" = (
/obj/effect/spawner/structure/window/reinforced,
/turf/open/floor/plating,
/area/ruin/unpowered)
"z" = (
/turf/template_noop/open,
/area/template_noop)
"B" = (
/obj/effect/turf_decal/tile/neutral/tile_side{
	dir = 8
	},
/turf/open/floor/plasteel/dark/airless,
/area/ruin/unpowered)
"C" = (
/obj/machinery/door/firedoor,
/obj/effect/turf_decal/tile/neutral/tile_full,
/turf/open/floor/plasteel/dark,
/area/ruin/unpowered)
"D" = (
/obj/effect/abstract/open_area_marker{
	dir = 8
	},
/turf/open/floor/plasteel,
/area/ruin/unpowered)
"G" = (
/obj/structure/safe,
/obj/effect/turf_decal/tile/neutral/tile_full,
/obj/effect/turf_decal/bot_white/left,
/obj/item/ammo_box/a357,
/obj/item/paper{
	info = "IOU - One Very Cool Revolver (Thanks HOP)"
	},
/obj/item/reagent_containers/food/drinks/bottle/vodka/badminka,
/turf/open/floor/plasteel/dark/airless,
/area/ruin/unpowered)
"I" = (
/obj/effect/turf_decal/tile/neutral{
	dir = 8
	},
/obj/effect/decal/cleanable/blood,
/obj/effect/mob_spawn/human/corpse/cargo_tech,
/obj/item/gun/ballistic/revolver/russian,
/turf/open/floor/plasteel/dark/airless,
/area/ruin/unpowered)
"J" = (
/obj/effect/turf_decal/tile/neutral,
/obj/item/stack/cable_coil/random/five,
/turf/open/floor/plasteel/dark/airless,
/area/ruin/unpowered)
"M" = (
/obj/effect/turf_decal/tile/neutral/tile_full,
/obj/effect/turf_decal/bot_white/left,
/turf/open/floor/plasteel/dark/airless,
/area/ruin/unpowered)
"O" = (
/obj/structure/sign/poster/random{
	pixel_y = -32
	},
/turf/open/floor/plasteel,
/area/ruin/unpowered)
"P" = (
/obj/machinery/door/airlock/vault{
	req_access_txt = "53"
	},
/obj/effect/mapping_helpers/airlock/locked,
/obj/effect/turf_decal/tile/neutral/tile_full,
/turf/open/floor/plasteel/dark,
/area/ruin/unpowered)
"S" = (
/obj/structure/frame/computer,
/obj/effect/turf_decal/tile/neutral/tile_full,
/obj/effect/turf_decal/bot_white/right,
/turf/open/floor/plasteel/dark/airless,
/area/ruin/unpowered)
"U" = (
/obj/effect/turf_decal/tile/neutral/tile_marquee,
/turf/open/floor/plasteel,
/area/ruin/unpowered)
"V" = (
/obj/effect/abstract/open_area_marker{
	dir = 4
	},
/turf/open/floor/plasteel,
/area/ruin/unpowered)
"X" = (
/turf/open/floor/circuit/airless,
/area/ruin/unpowered)
"Y" = (
/obj/structure/filingcabinet,
/obj/item/folder,
/obj/effect/turf_decal/tile/neutral/tile_full,
/obj/effect/turf_decal/bot_white/left,
/turf/open/floor/plasteel/dark/airless,
/area/ruin/unpowered)
"Z" = (
/obj/effect/turf_decal/stripes/corner{
	dir = 4
	},
/turf/open/floor/plasteel,
/area/ruin/unpowered)

(1,1,1) = {"
z
z
z
z
z
z
z
z
a
Z
D
o
a
"}
(2,1,1) = {"
z
i
i
t
i
i
i
z
w
g
U
o
a
"}
(3,1,1) = {"
z
i
S
l
d
c
i
z
w
g
U
o
h
"}
(4,1,1) = {"
z
i
X
X
X
J
i
w
w
g
U
o
a
"}
(5,1,1) = {"
z
i
X
r
X
B
P
k
C
g
U
o
a
"}
(6,1,1) = {"
z
i
X
X
X
I
i
w
w
g
U
o
a
"}
(7,1,1) = {"
z
i
Y
M
f
G
i
z
w
g
U
O
a
"}
(8,1,1) = {"
z
i
i
i
i
i
i
z
w
g
U
o
a
"}
(9,1,1) = {"
z
z
z
z
z
z
z
z
a
u
V
o
a
"}
