//MAP CONVERTED BY dmm2tgm.py THIS HEADER COMMENT PREVENTS RECONVERSION, DO NOT REMOVE
"a" = (
/obj/machinery/door/airlock/medical/glass{
	dir = 1
	},
/turf/open/floor/plasteel/white,
/area/ruin/unpowered)
"c" = (
/turf/closed/wall,
/area/ruin/unpowered)
"f" = (
/obj/effect/turf_decal/tile/blue{
	dir = 1
	},
/turf/open/floor/plasteel/white,
/area/ruin/unpowered)
"i" = (
/obj/structure/window/reinforced{
	dir = 1
	},
/obj/structure/frame/computer{
	dir = 4
	},
/obj/effect/turf_decal/tile/blue{
	dir = 1
	},
/obj/effect/turf_decal/tile/blue{
	dir = 8
	},
/obj/effect/turf_decal/tile/blue{
	dir = 2
	},
/obj/effect/turf_decal/tile/blue{
	dir = 4
	},
/turf/open/floor/plasteel/white,
/area/ruin/unpowered)
"k" = (
/obj/structure/closet/secure_closet/medical3{
	dir = 1
	},
/obj/effect/turf_decal/tile/blue{
	dir = 1
	},
/obj/effect/turf_decal/tile/blue{
	dir = 8
	},
/obj/effect/turf_decal/tile/blue{
	dir = 2
	},
/obj/effect/turf_decal/tile/blue{
	dir = 4
	},
/turf/open/floor/plasteel/white,
/area/ruin/unpowered)
"p" = (
/obj/structure/table/glass{
	dir = 1
	},
/obj/machinery/door/window{
	dir = 8
	},
/obj/item/storage/firstaid{
	dir = 1
	},
/turf/open/floor/plasteel/white,
/area/ruin/unpowered)
"t" = (
/obj/effect/turf_decal/tile/blue{
	dir = 8
	},
/turf/open/floor/plasteel/white,
/area/ruin/unpowered)
"v" = (
/obj/structure/table/glass{
	dir = 1
	},
/obj/machinery/door/window{
	dir = 4
	},
/obj/effect/spawner/lootdrop/ruinloot/medical{
	dir = 1
	},
/obj/effect/spawner/lootdrop/ruinloot/medical{
	dir = 1
	},
/turf/open/floor/plasteel/white,
/area/ruin/unpowered)
"x" = (
/obj/machinery/vending/wardrobe/medi_wardrobe{
	dir = 1
	},
/obj/effect/turf_decal/tile/blue{
	dir = 1
	},
/obj/effect/turf_decal/tile/blue{
	dir = 8
	},
/obj/effect/turf_decal/tile/blue{
	dir = 2
	},
/obj/effect/turf_decal/tile/blue{
	dir = 4
	},
/turf/open/floor/plasteel/white,
/area/ruin/unpowered)
"A" = (
/obj/structure/frame/machine{
	dir = 1
	},
/obj/effect/turf_decal/tile/blue{
	dir = 1
	},
/obj/effect/turf_decal/tile/blue{
	dir = 8
	},
/obj/effect/turf_decal/tile/blue{
	dir = 2
	},
/obj/effect/turf_decal/tile/blue{
	dir = 4
	},
/turf/open/floor/plasteel/white,
/area/ruin/unpowered)
"B" = (
/obj/machinery/vending/medical{
	dir = 1
	},
/obj/effect/turf_decal/tile/blue{
	dir = 1
	},
/obj/effect/turf_decal/tile/blue{
	dir = 1
	},
/obj/effect/turf_decal/tile/blue{
	dir = 8
	},
/obj/effect/turf_decal/tile/blue{
	dir = 2
	},
/obj/effect/turf_decal/tile/blue{
	dir = 4
	},
/turf/open/floor/plasteel/white,
/area/ruin/unpowered)
"E" = (
/obj/effect/turf_decal/tile/blue{
	dir = 1
	},
/obj/effect/turf_decal/tile/blue{
	dir = 4
	},
/turf/open/floor/plasteel/white,
/area/ruin/unpowered)
"J" = (
/obj/effect/turf_decal/tile/blue{
	dir = 4
	},
/turf/open/floor/plasteel/white,
/area/ruin/unpowered)
"K" = (
/obj/structure/window/reinforced{
	dir = 1
	},
/obj/structure/closet/secure_closet/medical3{
	dir = 1
	},
/obj/effect/turf_decal/tile/blue{
	dir = 1
	},
/obj/effect/turf_decal/tile/blue{
	dir = 8
	},
/obj/effect/turf_decal/tile/blue{
	dir = 2
	},
/obj/effect/turf_decal/tile/blue{
	dir = 4
	},
/turf/open/floor/plasteel/white,
/area/ruin/unpowered)
"L" = (
/obj/structure/window/reinforced{
	dir = 2
	},
/obj/effect/turf_decal/tile/blue{
	dir = 8
	},
/obj/effect/turf_decal/tile/blue{
	dir = 2
	},
/obj/effect/turf_decal/tile/blue{
	dir = 4
	},
/obj/effect/turf_decal/tile/blue{
	dir = 1
	},
/turf/open/floor/plasteel/white,
/area/ruin/unpowered)
"M" = (
/obj/effect/spawner/structure/window{
	dir = 1
	},
/turf/open/floor/plating,
/area/ruin/unpowered)
"O" = (
/obj/effect/abstract/open_area_marker{
	dir = 4
	},
/turf/open/floor/plasteel/white,
/area/ruin/unpowered)
"P" = (
/obj/effect/turf_decal/tile/blue{
	dir = 8
	},
/turf/closed/wall,
/area/ruin/unpowered)
"R" = (
/turf/open/floor/plasteel/white,
/area/ruin/unpowered)
"S" = (
/obj/effect/abstract/open_area_marker{
	dir = 8
	},
/turf/open/floor/plasteel/white,
/area/ruin/unpowered)
"T" = (
/obj/structure/table/glass{
	dir = 1
	},
/obj/structure/window/reinforced{
	dir = 8
	},
/obj/effect/spawner/lootdrop/ruinloot/medical{
	dir = 1
	},
/turf/open/floor/plasteel/white,
/area/ruin/unpowered)
"W" = (
/obj/structure/table/glass{
	dir = 1
	},
/obj/structure/window/reinforced{
	dir = 4
	},
/obj/effect/spawner/lootdrop/ruinloot/medical{
	dir = 1
	},
/turf/open/floor/plasteel/white,
/area/ruin/unpowered)
"X" = (
/obj/effect/turf_decal/tile/blue{
	dir = 4
	},
/obj/effect/turf_decal/tile/blue{
	dir = 8
	},
/turf/open/floor/plasteel/white,
/area/ruin/unpowered)
"Y" = (
/obj/effect/abstract/doorway_marker{
	dir = 1
	},
/turf/open/floor/plasteel/white,
/area/ruin/unpowered)

(1,1,1) = {"
c
P
c
c
c
c
c
c
c
R
S
R
c"}(2,1,1) = {"
c
L
W
v
W
i
B
x
c
J
R
R
c"}(3,1,1) = {"
Y
X
t
t
t
t
t
t
M
E
R
R
c"}(4,1,1) = {"
c
J
R
R
R
R
R
t
a
E
R
R
c"}(5,1,1) = {"
c
J
R
M
c
M
R
t
M
E
R
R
c"}(6,1,1) = {"
c
J
R
R
R
R
R
t
a
E
R
R
c"}(7,1,1) = {"
c
J
J
J
J
J
J
X
M
E
R
R
c"}(8,1,1) = {"
c
L
T
p
T
K
k
A
c
f
R
R
c"}(9,1,1) = {"
c
c
c
c
c
c
c
c
c
R
O
R
c"}