//MAP CONVERTED BY dmm2tgm.py THIS HEADER COMMENT PREVENTS RECONVERSION, DO NOT REMOVE
"a" = (
/obj/machinery/door/airlock/medical/glass,
/turf/open/floor/iron/white,
/area/ruin/unpowered)
"c" = (
/turf/closed/wall,
/area/ruin/unpowered)
"f" = (
/obj/effect/turf_decal/tile/blue{
	dir = 8
	},
/turf/open/floor/iron/white,
/area/ruin/unpowered)
"g" = (
/obj/effect/turf_decal/tile/blue/half/contrasted{
	dir = 8
	},
/turf/open/floor/iron/white,
/area/ruin/unpowered)
"h" = (
/obj/machinery/vending/wardrobe/medi_wardrobe,
/obj/effect/turf_decal/tile/blue/fourcorners/contrasted,
/turf/open/floor/iron/white,
/area/ruin/unpowered)
"o" = (
/obj/structure/closet/secure_closet/medical3,
/obj/effect/turf_decal/tile/blue/fourcorners/contrasted,
/turf/open/floor/iron/white,
/area/ruin/unpowered)
"p" = (
/obj/structure/table/glass,
/obj/machinery/door/window{
	dir = 8
	},
/obj/item/storage/firstaid,
/turf/open/floor/iron/white,
/area/ruin/unpowered)
"q" = (
/obj/machinery/vending/medical,
/obj/effect/turf_decal/tile/blue/fourcorners/contrasted,
/turf/open/floor/iron/white,
/area/ruin/unpowered)
"t" = (
/obj/effect/turf_decal/tile/blue{
	dir = 1
	},
/turf/open/floor/iron/white,
/area/ruin/unpowered)
"u" = (
/obj/structure/frame/machine,
/obj/effect/turf_decal/tile/blue/fourcorners/contrasted,
/turf/open/floor/iron/white,
/area/ruin/unpowered)
"v" = (
/obj/structure/table/glass,
/obj/machinery/door/window{
	dir = 4
	},
/obj/effect/spawner/random/ruinloot/medical,
/obj/effect/spawner/random/ruinloot/medical,
/turf/open/floor/iron/white,
/area/ruin/unpowered)
"C" = (
/obj/structure/window/reinforced/spawner/directional/north,
/obj/effect/turf_decal/tile/blue/fourcorners/contrasted,
/turf/open/floor/iron/white,
/area/ruin/unpowered)
"F" = (
/obj/structure/window/reinforced/spawner/directional/south,
/obj/structure/closet/secure_closet/medical3,
/obj/effect/turf_decal/tile/blue/fourcorners/contrasted,
/turf/open/floor/iron/white,
/area/ruin/unpowered)
"J" = (
/obj/effect/turf_decal/tile/blue,
/turf/open/floor/iron/white,
/area/ruin/unpowered)
"M" = (
/obj/effect/spawner/structure/window,
/turf/open/floor/plating,
/area/ruin/unpowered)
"N" = (
/obj/structure/window/reinforced/spawner/directional/south,
/obj/structure/frame/computer{
	dir = 4
	},
/obj/effect/turf_decal/tile/blue/fourcorners/contrasted,
/turf/open/floor/iron/white,
/area/ruin/unpowered)
"O" = (
/obj/effect/abstract/open_area_marker{
	dir = 4
	},
/turf/open/floor/iron/white,
/area/ruin/unpowered)
"P" = (
/obj/effect/turf_decal/tile/blue{
	dir = 1
	},
/turf/closed/wall,
/area/ruin/unpowered)
"R" = (
/turf/open/floor/iron/white,
/area/ruin/unpowered)
"S" = (
/obj/effect/abstract/open_area_marker{
	dir = 8
	},
/turf/open/floor/iron/white,
/area/ruin/unpowered)
"T" = (
/obj/structure/table/glass,
/obj/structure/window/reinforced/spawner/directional/west,
/obj/effect/spawner/random/ruinloot/medical,
/turf/open/floor/iron/white,
/area/ruin/unpowered)
"U" = (
/obj/effect/turf_decal/tile/blue/opposingcorners,
/turf/open/floor/iron/white,
/area/ruin/unpowered)
"W" = (
/obj/structure/table/glass,
/obj/structure/window/reinforced/spawner/directional/east,
/obj/effect/spawner/random/ruinloot/medical,
/turf/open/floor/iron/white,
/area/ruin/unpowered)
"Y" = (
/obj/effect/abstract/doorway_marker,
/turf/open/floor/iron/white,
/area/ruin/unpowered)

(1,1,1) = {"
c
R
S
R
c
c
c
c
c
c
c
P
c
"}
(2,1,1) = {"
c
R
R
J
c
h
q
N
W
v
W
C
c
"}
(3,1,1) = {"
c
R
R
g
M
t
t
t
t
t
t
U
Y
"}
(4,1,1) = {"
c
R
R
g
a
t
R
R
R
R
R
J
c
"}
(5,1,1) = {"
c
R
R
g
M
t
R
M
c
M
R
J
c
"}
(6,1,1) = {"
c
R
R
g
a
t
R
R
R
R
R
J
c
"}
(7,1,1) = {"
c
R
R
g
M
U
J
J
J
J
J
J
c
"}
(8,1,1) = {"
c
R
R
f
c
u
o
F
T
p
T
C
c
"}
(9,1,1) = {"
c
R
O
R
c
c
c
c
c
c
c
c
c
"}
