//MAP CONVERTED BY dmm2tgm.py THIS HEADER COMMENT PREVENTS RECONVERSION, DO NOT REMOVE
"b" = (
/obj/effect/abstract/doorway_marker{
	dir = 8
	},
/turf/open/floor/iron,
/area/ruin/unpowered)
"k" = (
/obj/structure/bodycontainer/morgue{
	dir = 8
	},
/obj/effect/turf_decal/stripes/line{
	dir = 8
	},
/turf/open/floor/iron/dark,
/area/ruin/unpowered)
"m" = (
/obj/structure/bodycontainer/morgue{
	dir = 2
	},
/obj/effect/turf_decal/stripes/line{
	dir = 10
	},
/turf/open/floor/iron/dark,
/area/ruin/unpowered)
"o" = (
/turf/closed/wall,
/area/ruin/unpowered)
"q" = (
/obj/effect/spawner/random/ruinloot/basic,
/turf/open/floor/iron,
/area/ruin/unpowered)
"r" = (
/obj/structure/bodycontainer/morgue{
	dir = 2
	},
/obj/effect/turf_decal/stripes/line,
/turf/open/floor/iron/dark,
/area/ruin/unpowered)
"s" = (
/turf/open/floor/iron,
/area/ruin/unpowered)
"B" = (
/obj/structure/bodycontainer/morgue{
	dir = 1
	},
/obj/effect/turf_decal/stripes/line{
	dir = 9
	},
/turf/open/floor/iron/dark,
/area/ruin/unpowered)
"H" = (
/obj/structure/bodycontainer/morgue{
	dir = 1
	},
/obj/effect/turf_decal/stripes/line{
	dir = 5
	},
/turf/open/floor/iron/dark,
/area/ruin/unpowered)
"I" = (
/obj/structure/bodycontainer/morgue{
	dir = 2
	},
/obj/effect/turf_decal/stripes/line{
	dir = 6
	},
/turf/open/floor/iron/dark,
/area/ruin/unpowered)
"J" = (
/obj/effect/spawner/random/ruinloot/medical,
/turf/open/floor/iron,
/area/ruin/unpowered)
"O" = (
/obj/effect/mapping_helpers/dead_body_placer/ruin_morgue{
	bodycount = 1
	},
/turf/open/floor/iron,
/area/ruin/unpowered)
"V" = (
/obj/structure/bodycontainer/morgue{
	dir = 1
	},
/obj/effect/turf_decal/stripes/line{
	dir = 1
	},
/turf/open/floor/iron/dark,
/area/ruin/unpowered)

(1,1,1) = {"
o
o
b
o
o
"}
(2,1,1) = {"
o
s
s
s
o
"}
(3,1,1) = {"
o
m
O
B
o
"}
(4,1,1) = {"
o
r
s
V
o
"}
(5,1,1) = {"
o
I
q
H
o
"}
(6,1,1) = {"
o
s
s
J
o
"}
(7,1,1) = {"
o
s
O
s
o
"}
(8,1,1) = {"
o
k
k
k
o
"}
(9,1,1) = {"
o
o
o
o
o
"}
