//MAP CONVERTED BY dmm2tgm.py THIS HEADER COMMENT PREVENTS RECONVERSION, DO NOT REMOVE
"b" = (
/obj/effect/abstract/doorway_marker{
	dir = 8
	},
/turf/open/floor/plasteel,
/area/ruin/unpowered)
"k" = (
/obj/structure/bodycontainer/morgue{
	dir = 8
	},
/obj/effect/turf_decal/stripes/line{
	dir = 8
	},
/turf/open/floor/plasteel/dark,
/area/ruin/unpowered)
"m" = (
/obj/structure/bodycontainer/morgue{
	dir = 2
	},
/obj/effect/turf_decal/stripes/line{
	dir = 9
	},
/turf/open/floor/plasteel/dark,
/area/ruin/unpowered)
"o" = (
/turf/closed/wall,
/area/ruin/unpowered)
"q" = (
/obj/effect/spawner/lootdrop/ruinloot/basic{
	dir = 1
	},
/turf/open/floor/plasteel,
/area/ruin/unpowered)
"r" = (
/obj/structure/bodycontainer/morgue{
	dir = 2
	},
/obj/effect/turf_decal/stripes/line{
	dir = 1
	},
/turf/open/floor/plasteel/dark,
/area/ruin/unpowered)
"s" = (
/turf/open/floor/plasteel,
/area/ruin/unpowered)
"B" = (
/obj/structure/bodycontainer/morgue{
	dir = 1
	},
/obj/effect/turf_decal/stripes/line{
	dir = 10
	},
/turf/open/floor/plasteel/dark,
/area/ruin/unpowered)
"H" = (
/obj/structure/bodycontainer/morgue{
	dir = 1
	},
/obj/effect/turf_decal/stripes/line{
	dir = 6
	},
/turf/open/floor/plasteel/dark,
/area/ruin/unpowered)
"I" = (
/obj/structure/bodycontainer/morgue{
	dir = 2
	},
/obj/effect/turf_decal/stripes/line{
	dir = 5
	},
/turf/open/floor/plasteel/dark,
/area/ruin/unpowered)
"J" = (
/obj/effect/spawner/lootdrop/ruinloot/medical{
	dir = 1
	},
/turf/open/floor/plasteel,
/area/ruin/unpowered)
"O" = (
/obj/effect/mapping_helpers/dead_body_placer{
	bodycount = 1;
	dir = 1
	},
/turf/open/floor/plasteel,
/area/ruin/unpowered)
"V" = (
/obj/structure/bodycontainer/morgue{
	dir = 1
	},
/obj/effect/turf_decal/stripes/line{
	dir = 2
	},
/turf/open/floor/plasteel/dark,
/area/ruin/unpowered)

(1,1,1) = {"
o
o
b
o
o"}(2,1,1) = {"
o
s
s
s
o"}(3,1,1) = {"
o
B
O
m
o"}(4,1,1) = {"
o
V
s
r
o"}(5,1,1) = {"
o
H
q
I
o"}(6,1,1) = {"
o
J
s
s
o"}(7,1,1) = {"
o
s
O
s
o"}(8,1,1) = {"
o
k
k
k
o"}(9,1,1) = {"
o
o
o
o
o"}