//MAP CONVERTED BY dmm2tgm.py THIS HEADER COMMENT PREVENTS RECONVERSION, DO NOT REMOVE
"a" = (
/obj/effect/turf_decal/stripes/corner{
	dir = 1
	},
/turf/open/floor/plasteel,
/area/ruin/unpowered)
"d" = (
/obj/machinery/portable_atmospherics/scrubber/huge{
	dir = 1
	},
/obj/effect/turf_decal/bot{
	dir = 4
	},
/turf/open/floor/plasteel,
/area/ruin/unpowered)
"e" = (
/obj/machinery/portable_atmospherics/canister/oxygen{
	dir = 1
	},
/obj/effect/decal/cleanable/dirt{
	dir = 4
	},
/obj/effect/turf_decal/bot{
	dir = 4
	},
/obj/machinery/light{
	dir = 1
	},
/turf/open/floor/plasteel,
/area/ruin/unpowered)
"i" = (
/obj/effect/abstract/doorway_marker{
	dir = 2
	},
/turf/open/floor/plasteel,
/area/ruin/unpowered)
"k" = (
/obj/effect/turf_decal/stripes/line{
	dir = 1
	},
/turf/open/floor/plasteel,
/area/ruin/unpowered)
"l" = (
/obj/machinery/portable_atmospherics/canister/nitrous_oxide{
	dir = 1
	},
/obj/effect/decal/cleanable/dirt{
	dir = 4
	},
/obj/effect/turf_decal/bot{
	dir = 4
	},
/turf/open/floor/plasteel,
/area/ruin/unpowered)
"p" = (
/obj/machinery/portable_atmospherics/canister/oxygen{
	dir = 1
	},
/obj/effect/decal/cleanable/dirt{
	dir = 4
	},
/obj/effect/turf_decal/bot{
	dir = 4
	},
/turf/open/floor/plasteel,
/area/ruin/unpowered)
"q" = (
/obj/machinery/portable_atmospherics/scrubber/huge{
	dir = 1
	},
/obj/effect/decal/cleanable/dirt{
	dir = 4
	},
/obj/effect/turf_decal/bot{
	dir = 4
	},
/turf/open/floor/plasteel,
/area/ruin/unpowered)
"r" = (
/obj/effect/turf_decal/stripes/line{
	dir = 4
	},
/turf/open/floor/plasteel,
/area/ruin/unpowered)
"t" = (
/obj/effect/decal/cleanable/dirt{
	dir = 4
	},
/obj/effect/turf_decal/delivery{
	dir = 4
	},
/turf/open/floor/plasteel,
/area/ruin/unpowered)
"v" = (
/obj/effect/turf_decal/bot{
	dir = 4
	},
/obj/machinery/portable_atmospherics/pump{
	dir = 1
	},
/turf/open/floor/plasteel,
/area/ruin/unpowered)
"z" = (
/obj/machinery/portable_atmospherics/canister/oxygen{
	dir = 1
	},
/obj/effect/turf_decal/bot{
	dir = 4
	},
/turf/open/floor/plasteel,
/area/ruin/unpowered)
"C" = (
/obj/machinery/portable_atmospherics/canister/toxins{
	dir = 1
	},
/obj/effect/turf_decal/bot{
	dir = 4
	},
/turf/open/floor/plasteel,
/area/ruin/unpowered)
"D" = (
/obj/effect/turf_decal/stripes/corner{
	dir = 4
	},
/turf/open/floor/plasteel,
/area/ruin/unpowered)
"F" = (
/obj/machinery/portable_atmospherics/canister/nitrous_oxide{
	dir = 1
	},
/obj/effect/turf_decal/bot{
	dir = 4
	},
/turf/open/floor/plasteel,
/area/ruin/unpowered)
"I" = (
/obj/effect/turf_decal/delivery{
	dir = 4
	},
/turf/open/floor/plasteel,
/area/ruin/unpowered)
"K" = (
/obj/machinery/portable_atmospherics/canister/toxins{
	dir = 1
	},
/obj/effect/turf_decal/bot{
	dir = 4
	},
/obj/machinery/light{
	dir = 1
	},
/turf/open/floor/plasteel,
/area/ruin/unpowered)
"N" = (
/obj/effect/turf_decal/bot{
	dir = 4
	},
/obj/machinery/portable_atmospherics/pump{
	name = "Lil Pump";
	dir = 1
	},
/turf/open/floor/plasteel,
/area/ruin/unpowered)
"O" = (
/obj/effect/turf_decal/stripes/line{
	dir = 8
	},
/turf/open/floor/plasteel,
/area/ruin/unpowered)
"Q" = (
/turf/open/floor/plasteel,
/area/ruin/unpowered)
"R" = (
/obj/effect/decal/cleanable/dirt{
	dir = 4
	},
/obj/effect/turf_decal/stripes/line{
	dir = 4
	},
/turf/open/floor/plasteel,
/area/ruin/unpowered)
"T" = (
/obj/machinery/portable_atmospherics/canister/toxins{
	dir = 1
	},
/obj/effect/decal/cleanable/dirt{
	dir = 4
	},
/obj/effect/turf_decal/bot{
	dir = 4
	},
/turf/open/floor/plasteel,
/area/ruin/unpowered)
"U" = (
/obj/machinery/portable_atmospherics/canister/carbon_dioxide{
	dir = 1
	},
/obj/effect/turf_decal/bot{
	dir = 4
	},
/turf/open/floor/plasteel,
/area/ruin/unpowered)
"V" = (
/turf/closed/wall/r_wall,
/area/ruin/unpowered)

(1,1,1) = {"
V
V
V
V
V
V
V
V
V"}(2,1,1) = {"
V
e
z
z
U
N
I
k
V"}(3,1,1) = {"
V
p
z
z
U
v
t
k
i"}(4,1,1) = {"
V
O
O
O
O
O
O
a
V"}(5,1,1) = {"
V
Q
Q
Q
Q
Q
Q
Q
V"}(6,1,1) = {"
V
R
R
r
r
r
R
D
V"}(7,1,1) = {"
V
T
T
C
F
d
t
k
V"}(8,1,1) = {"
V
K
C
C
l
q
I
k
V"}(9,1,1) = {"
V
V
V
V
V
V
V
V
V"}