//MAP CONVERTED BY dmm2tgm.py THIS HEADER COMMENT PREVENTS RECONVERSION, DO NOT REMOVE
"a" = (
/obj/structure/window/reinforced/spawner/directional/west,
/obj/structure/window/reinforced/spawner/directional/east,
/obj/structure/window/reinforced/spawner/directional/north,
/obj/effect/decal/cleanable/dirt,
/turf/open/floor/plating,
/area/template_noop)
"c" = (
/obj/effect/decal/cleanable/dirt,
/turf/open/floor/iron,
/area/template_noop)
"h" = (
/obj/structure/chair{
	dir = 1
	},
/obj/effect/turf_decal/stripes/line{
	dir = 1
	},
/obj/effect/spawner/random/maintenance,
/turf/open/floor/iron/dark/side{
	dir = 5
	},
/area/template_noop)
"j" = (
/obj/effect/decal/cleanable/dirt,
/turf/open/floor/iron/dark/corner{
	dir = 8
	},
/area/template_noop)
"k" = (
/turf/open/floor/iron/dark/corner{
	dir = 1
	},
/area/template_noop)
"l" = (
/turf/open/floor/iron/dark/side{
	dir = 5
	},
/area/template_noop)
"m" = (
/obj/structure/chair,
/obj/effect/turf_decal/stripes/line,
/obj/effect/spawner/random/maintenance,
/turf/open/floor/iron/dark/corner{
	dir = 8
	},
/area/template_noop)
"n" = (
/obj/structure/chair,
/obj/effect/turf_decal/stripes/line,
/turf/open/floor/iron/dark/corner,
/area/template_noop)
"o" = (
/obj/structure/chair{
	dir = 1
	},
/obj/effect/turf_decal/stripes/line{
	dir = 1
	},
/obj/machinery/light,
/obj/effect/decal/cleanable/dirt,
/turf/open/floor/iron/dark/side{
	dir = 9
	},
/area/template_noop)
"p" = (
/obj/structure/chair,
/obj/effect/turf_decal/stripes/line,
/obj/effect/decal/cleanable/blood/old,
/turf/open/floor/iron/dark/side{
	dir = 6
	},
/area/template_noop)
"s" = (
/obj/effect/decal/cleanable/dirt,
/turf/open/floor/iron/dark/side{
	dir = 1
	},
/area/template_noop)
"t" = (
/turf/open/floor/iron/dark/corner{
	dir = 4
	},
/area/template_noop)
"u" = (
/obj/structure/chair{
	dir = 1
	},
/obj/effect/turf_decal/stripes/line{
	dir = 1
	},
/turf/open/floor/iron/dark/corner{
	dir = 4
	},
/area/template_noop)
"v" = (
/obj/structure/window/reinforced/spawner/directional/west,
/obj/structure/window/reinforced/spawner/directional/east,
/obj/structure/window/reinforced/spawner/directional/north,
/obj/structure/flora/ausbushes/fullgrass,
/obj/item/kirbyplants/dead,
/turf/open/floor/grass,
/area/template_noop)
"w" = (
/turf/open/floor/iron/dark/side{
	dir = 2
	},
/area/template_noop)
"x" = (
/turf/open/floor/iron/dark/side{
	dir = 10
	},
/area/template_noop)
"y" = (
/obj/structure/chair,
/obj/effect/turf_decal/stripes/line,
/obj/machinery/light{
	dir = 1
	},
/obj/effect/spawner/random/maintenance,
/turf/open/floor/iron/dark/side{
	dir = 6
	},
/area/template_noop)
"A" = (
/obj/effect/decal/cleanable/dirt,
/turf/open/floor/iron/dark/corner{
	dir = 4
	},
/area/template_noop)
"B" = (
/turf/open/floor/iron/dark/side{
	dir = 9
	},
/area/template_noop)
"C" = (
/turf/open/floor/iron/dark/side{
	dir = 1
	},
/area/template_noop)
"D" = (
/obj/structure/chair{
	dir = 1
	},
/obj/effect/turf_decal/stripes/line{
	dir = 1
	},
/obj/effect/decal/cleanable/dirt,
/turf/open/floor/iron/dark/side{
	dir = 9
	},
/area/template_noop)
"E" = (
/obj/structure/window/reinforced/spawner/directional/west,
/obj/structure/flora/ausbushes/fullgrass,
/turf/open/floor/grass,
/area/template_noop)
"F" = (
/turf/open/floor/iron/dark/corner,
/area/template_noop)
"G" = (
/obj/structure/chair,
/obj/effect/turf_decal/stripes/line,
/turf/open/floor/iron/dark/side{
	dir = 10
	},
/area/template_noop)
"I" = (
/obj/structure/window/reinforced/spawner/directional/west,
/obj/structure/window/reinforced/spawner/directional/east,
/obj/structure/window/reinforced/spawner/directional/south,
/obj/effect/decal/cleanable/dirt,
/turf/open/floor/plating,
/area/template_noop)
"J" = (
/turf/open/floor/iron/dark/corner{
	dir = 8
	},
/area/template_noop)
"K" = (
/obj/structure/chair{
	dir = 1
	},
/obj/effect/turf_decal/stripes/line{
	dir = 1
	},
/turf/open/floor/iron/dark/corner{
	dir = 1
	},
/area/template_noop)
"L" = (
/turf/open/floor/iron,
/area/template_noop)
"N" = (
/obj/structure/chair,
/obj/effect/turf_decal/stripes/line,
/obj/machinery/light{
	dir = 1
	},
/turf/open/floor/iron/dark/side{
	dir = 10
	},
/area/template_noop)
"O" = (
/obj/structure/chair{
	dir = 1
	},
/obj/effect/turf_decal/stripes/line{
	dir = 1
	},
/obj/machinery/light,
/obj/effect/spawner/random/maintenance,
/turf/open/floor/iron/dark/side{
	dir = 5
	},
/area/template_noop)
"P" = (
/obj/effect/decal/cleanable/dirt,
/obj/item/beacon,
/turf/open/floor/iron,
/area/template_noop)
"Q" = (
/obj/effect/decal/cleanable/dirt,
/turf/open/floor/iron/dark/corner{
	dir = 1
	},
/area/template_noop)
"R" = (
/obj/structure/window/reinforced/spawner/directional/north,
/obj/structure/flora/grass/jungle/b,
/obj/structure/window/reinforced/spawner/directional/south,
/turf/open/floor/grass,
/area/template_noop)
"S" = (
/obj/machinery/status_display/evac,
/turf/closed/wall,
/area/template_noop)
"T" = (
/obj/effect/decal/cleanable/dirt,
/turf/open/floor/iron/dark/corner,
/area/template_noop)
"U" = (
/obj/structure/window/reinforced/spawner/directional/north,
/obj/structure/flora/ausbushes/fullgrass,
/obj/structure/window/reinforced/spawner/directional/south,
/turf/open/floor/grass,
/area/template_noop)
"V" = (
/obj/effect/decal/cleanable/dirt,
/turf/open/floor/iron/dark/side{
	dir = 2
	},
/area/template_noop)
"W" = (
/obj/structure/window/reinforced/spawner/directional/west,
/obj/structure/window/reinforced/spawner/directional/east,
/obj/structure/window/reinforced/spawner/directional/south,
/obj/structure/flora/ausbushes/fullgrass,
/obj/item/kirbyplants/random,
/turf/open/floor/grass,
/area/template_noop)
"X" = (
/obj/structure/window/reinforced/spawner/directional/east,
/obj/structure/flora/ausbushes/fullgrass,
/turf/open/floor/grass,
/area/template_noop)
"Y" = (
/obj/structure/window/reinforced/spawner/directional/north,
/obj/structure/window/reinforced/spawner/directional/south,
/obj/effect/decal/cleanable/dirt,
/turf/open/floor/plating,
/area/template_noop)
"Z" = (
/obj/effect/decal/cleanable/dirt,
/turf/open/floor/iron/dark/side{
	dir = 6
	},
/area/template_noop)

(1,1,1) = {"
B
Q
L
J
x
"}
(2,1,1) = {"
C
v
E
I
V
"}
(3,1,1) = {"
C
u
U
n
V
"}
(4,1,1) = {"
k
O
S
y
j
"}
(5,1,1) = {"
c
h
Y
p
c
"}
(6,1,1) = {"
c
D
U
G
L
"}
(7,1,1) = {"
A
o
S
N
F
"}
(8,1,1) = {"
s
K
R
m
w
"}
(9,1,1) = {"
C
a
X
W
V
"}
(10,1,1) = {"
l
t
P
T
Z
"}
