//MAP CONVERTED BY dmm2tgm.py THIS HEADER COMMENT PREVENTS RECONVERSION, DO NOT REMOVE
"a" = (
/obj/effect/decal/cleanable/blood/gibs/body,
/turf/open/floor/plating,
/area/space)
"b" = (
/obj/effect/decal/cleanable/blood/old,
/turf/open/floor/plating,
/area/space)
"d" = (
/obj/effect/mapping_helpers/dead_body_placer/ruin_morgue,
/turf/open/floor/plating,
/area/space)
"h" = (
/obj/effect/decal/cleanable/blood/gibs/limb,
/obj/machinery/light/small{
	dir = 1
	},
/turf/open/floor/plating,
/area/space)
"i" = (
/obj/effect/mapping_helpers/dead_body_placer/ruin_morgue,
/obj/machinery/light/small,
/turf/open/floor/plating,
/area/space)
"j" = (
/obj/effect/decal/cleanable/blood/old,
/obj/effect/decal/cleanable/blood/gibs/body,
/turf/open/floor/plating,
/area/space)
"k" = (
/obj/effect/decal/cleanable/blood/old,
/obj/machinery/light/small,
/turf/open/floor/plating,
/area/space)
"m" = (
/obj/effect/decal/cleanable/blood/gibs/up,
/turf/open/floor/plating,
/area/space)
"p" = (
/obj/effect/decal/cleanable/blood/footprints{
	dir = 8
	},
/obj/effect/decal/remains/human,
/turf/open/floor/plating,
/area/space)
"q" = (
/obj/effect/decal/cleanable/blood/gibs/torso,
/turf/open/floor/plating,
/area/space)
"t" = (
/obj/effect/decal/cleanable/blood/gibs/limb,
/turf/open/floor/plating,
/area/space)
"u" = (
/obj/effect/decal/cleanable/blood/old,
/obj/effect/decal/remains/human,
/turf/open/floor/plating,
/area/space)
"w" = (
/obj/effect/decal/remains/human,
/turf/open/floor/plating,
/area/space)
"z" = (
/obj/effect/decal/cleanable/blood/gibs/old,
/turf/open/floor/plating,
/area/space)
"F" = (
/obj/effect/decal/cleanable/blood/gibs,
/turf/open/floor/plating,
/area/space)
"S" = (
/obj/item/toy/plush/moth/poison,
/turf/open/floor/plating,
/area/space)
"Y" = (
/obj/effect/decal/cleanable/blood/old,
/obj/machinery/light/small{
	dir = 1
	},
/turf/open/floor/plating,
/area/space)
"Z" = (
/obj/effect/decal/cleanable/blood/old,
/obj/effect/decal/cleanable/blood/gibs/torso,
/turf/open/floor/plating,
/area/space)

(1,1,1) = {"
j
z
q
m
d
"}
(2,1,1) = {"
Y
t
d
b
i
"}
(3,1,1) = {"
d
a
b
j
b
"}
(4,1,1) = {"
w
p
w
w
w
"}
(5,1,1) = {"
w
u
w
w
w
"}
(6,1,1) = {"
w
u
S
w
u
"}
(7,1,1) = {"
w
u
u
w
w
"}
(8,1,1) = {"
w
w
w
w
w
"}
(9,1,1) = {"
h
F
Z
F
k
"}
(10,1,1) = {"
d
m
F
t
d
"}
