//MAP CONVERTED BY dmm2tgm.py THIS HEADER COMMENT PREVENTS RECONVERSION, DO NOT REMOVE
"a" = (
/obj/structure/table/wood,
/obj/item/toy/plush/carpplushie,
/obj/effect/decal/cleanable/cobweb,
/obj/effect/turf_decal/tile/neutral{
	dir = 1
	},
/obj/effect/turf_decal/tile/neutral,
/obj/effect/turf_decal/tile/neutral{
	dir = 4
	},
/obj/effect/turf_decal/tile/neutral{
	dir = 8
	},
/turf/open/floor/plasteel/dark,
/area/template_noop)
"b" = (
/obj/machinery/computer/arcade,
/obj/effect/turf_decal/tile/neutral{
	dir = 1
	},
/obj/effect/turf_decal/tile/neutral,
/obj/effect/turf_decal/tile/neutral{
	dir = 4
	},
/obj/effect/turf_decal/tile/neutral{
	dir = 8
	},
/turf/open/floor/plasteel/dark,
/area/template_noop)
"c" = (
/obj/machinery/computer/arcade,
/obj/effect/decal/cleanable/dirt,
/obj/effect/turf_decal/tile/neutral{
	dir = 1
	},
/obj/effect/turf_decal/tile/neutral,
/obj/effect/turf_decal/tile/neutral{
	dir = 4
	},
/obj/effect/turf_decal/tile/neutral{
	dir = 8
	},
/turf/open/floor/plasteel/dark,
/area/template_noop)
"d" = (
/obj/structure/table/wood,
/obj/item/coin/antagtoken,
/obj/effect/turf_decal/tile/neutral{
	dir = 1
	},
/obj/effect/turf_decal/tile/neutral,
/obj/effect/turf_decal/tile/neutral{
	dir = 4
	},
/obj/effect/turf_decal/tile/neutral{
	dir = 8
	},
/turf/open/floor/plasteel/dark,
/area/template_noop)
"e" = (
/turf/open/floor/plating,
/area/template_noop)
"f" = (
/turf/open/floor/plasteel/dark,
/area/template_noop)
"g" = (
/obj/machinery/computer/arcade,
/turf/open/floor/plating,
/area/template_noop)
"h" = (
/obj/structure/table/wood,
/obj/item/paper_bin,
/obj/item/pen,
/obj/effect/turf_decal/tile/red{
	dir = 1
	},
/obj/effect/turf_decal/tile/red,
/obj/effect/turf_decal/tile/yellow{
	dir = 4
	},
/obj/effect/turf_decal/tile/yellow{
	dir = 8
	},
/turf/open/floor/plasteel,
/area/template_noop)
"i" = (
/obj/structure/table/wood,
/obj/item/folder/blue,
/obj/item/clothing/head/collectable/HoP,
/obj/effect/turf_decal/tile/red{
	dir = 1
	},
/obj/effect/turf_decal/tile/red,
/obj/effect/turf_decal/tile/yellow{
	dir = 4
	},
/obj/effect/turf_decal/tile/yellow{
	dir = 8
	},
/turf/open/floor/plasteel,
/area/template_noop)
"j" = (
/obj/structure/table/wood,
/obj/item/clothing/suit/syndicatefake,
/obj/item/clothing/head/syndicatefake,
/obj/effect/decal/cleanable/dirt,
/obj/effect/turf_decal/tile/red{
	dir = 1
	},
/obj/effect/turf_decal/tile/red,
/obj/effect/turf_decal/tile/yellow{
	dir = 4
	},
/obj/effect/turf_decal/tile/yellow{
	dir = 8
	},
/turf/open/floor/plasteel,
/area/template_noop)
"k" = (
/obj/item/kirbyplants/random,
/turf/open/floor/plating,
/area/template_noop)
"l" = (
/obj/structure/chair/stool/bar,
/turf/open/floor/plasteel/dark,
/area/template_noop)
"m" = (
/obj/structure/chair/stool/bar,
/obj/effect/decal/cleanable/dirt,
/turf/open/floor/plasteel/dark,
/area/template_noop)
"n" = (
/obj/effect/turf_decal/tile/neutral{
	dir = 1
	},
/obj/effect/turf_decal/tile/neutral,
/obj/effect/turf_decal/tile/neutral{
	dir = 4
	},
/obj/effect/turf_decal/tile/neutral{
	dir = 8
	},
/turf/open/floor/plasteel/dark,
/area/template_noop)
"o" = (
/obj/structure/table/wood,
/obj/item/clipboard,
/obj/item/folder,
/obj/item/toy/dummy,
/obj/effect/decal/cleanable/dirt,
/obj/effect/decal/cleanable/dirt,
/obj/effect/turf_decal/tile/red{
	dir = 1
	},
/obj/effect/turf_decal/tile/red,
/obj/effect/turf_decal/tile/yellow{
	dir = 4
	},
/obj/effect/turf_decal/tile/yellow{
	dir = 8
	},
/turf/open/floor/plasteel,
/area/template_noop)
"p" = (
/obj/structure/chair/office{
	dir = 8
	},
/obj/effect/turf_decal/tile/red{
	dir = 1
	},
/obj/effect/turf_decal/tile/red,
/obj/effect/turf_decal/tile/yellow{
	dir = 4
	},
/obj/effect/turf_decal/tile/yellow{
	dir = 8
	},
/turf/open/floor/plasteel,
/area/template_noop)
"q" = (
/obj/structure/table/wood,
/obj/item/clipboard,
/obj/effect/decal/cleanable/dirt,
/obj/effect/turf_decal/tile/red{
	dir = 1
	},
/obj/effect/turf_decal/tile/red,
/obj/effect/turf_decal/tile/yellow{
	dir = 4
	},
/obj/effect/turf_decal/tile/yellow{
	dir = 8
	},
/obj/item/paper/crumpled/beernuke,
/turf/open/floor/plasteel,
/area/template_noop)
"r" = (
/obj/effect/decal/cleanable/dirt,
/obj/effect/turf_decal/tile/neutral{
	dir = 1
	},
/obj/effect/turf_decal/tile/neutral,
/obj/effect/turf_decal/tile/neutral{
	dir = 4
	},
/obj/effect/turf_decal/tile/neutral{
	dir = 8
	},
/turf/open/floor/plasteel/dark,
/area/template_noop)
"s" = (
/obj/structure/table/wood,
/obj/effect/decal/cleanable/dirt,
/obj/effect/turf_decal/tile/red{
	dir = 1
	},
/obj/effect/turf_decal/tile/red,
/obj/effect/turf_decal/tile/yellow{
	dir = 4
	},
/obj/effect/turf_decal/tile/yellow{
	dir = 8
	},
/obj/item/coin/arcade_token{
	pixel_x = 6
	},
/obj/item/coin/arcade_token{
	pixel_x = -6
	},
/obj/item/coin/arcade_token{
	pixel_y = 6
	},
/turf/open/floor/plasteel,
/area/template_noop)
"t" = (
/obj/effect/decal/cleanable/dirt,
/obj/effect/turf_decal/tile/red{
	dir = 1
	},
/obj/effect/turf_decal/tile/red,
/obj/effect/turf_decal/tile/yellow{
	dir = 4
	},
/obj/effect/turf_decal/tile/yellow{
	dir = 8
	},
/turf/open/floor/plasteel,
/area/template_noop)
"u" = (
/obj/structure/chair/stool/bar,
/obj/effect/decal/cleanable/dirt,
/obj/effect/decal/cleanable/dirt,
/turf/open/floor/plasteel/dark,
/area/template_noop)
"v" = (
/obj/structure/table/wood,
/obj/item/toy/talking/AI,
/turf/open/floor/plating,
/area/template_noop)
"w" = (
/obj/structure/table/wood,
/obj/effect/decal/cleanable/dirt,
/obj/item/coin/arcade_token,
/turf/open/floor/plating,
/area/template_noop)
"x" = (
/obj/structure/table/wood,
/obj/item/toy/talking/codex_gigas,
/obj/effect/turf_decal/tile/neutral{
	dir = 1
	},
/obj/effect/turf_decal/tile/neutral,
/obj/effect/turf_decal/tile/neutral{
	dir = 4
	},
/obj/effect/turf_decal/tile/neutral{
	dir = 8
	},
/turf/open/floor/plasteel/dark,
/area/template_noop)
"y" = (
/obj/machinery/computer/arcade,
/obj/effect/decal/cleanable/dirt,
/turf/open/floor/plating,
/area/template_noop)
"z" = (
/obj/machinery/airalarm{
	dir = 1;
	pixel_y = -22
	},
/obj/structure/table/wood,
/obj/effect/decal/cleanable/dirt,
/obj/item/coin/arcade_token,
/turf/open/floor/plating,
/area/template_noop)
"A" = (
/obj/structure/table/wood,
/obj/item/gun/ballistic/automatic/toy/pistol/unrestricted,
/obj/effect/turf_decal/tile/neutral{
	dir = 1
	},
/obj/effect/turf_decal/tile/neutral,
/obj/effect/turf_decal/tile/neutral{
	dir = 4
	},
/obj/effect/turf_decal/tile/neutral{
	dir = 8
	},
/turf/open/floor/plasteel/dark,
/area/template_noop)
"B" = (
/obj/effect/turf_decal/tile/neutral{
	dir = 1
	},
/obj/effect/turf_decal/tile/neutral,
/obj/effect/turf_decal/tile/neutral{
	dir = 4
	},
/obj/effect/turf_decal/tile/neutral{
	dir = 8
	},
/obj/effect/trap/nexus/trickyspawner,
/turf/open/floor/plasteel/dark,
/area/template_noop)
"C" = (
/obj/structure/chair/stool/bar,
/obj/effect/decal/cleanable/dirt,
/obj/effect/spawner/lootdrop/trap,
/turf/open/floor/plasteel/dark,
/area/template_noop)

(1,1,1) = {"
a
k
r
k
w
"}
(2,1,1) = {"
b
l
e
u
c
"}
(3,1,1) = {"
c
m
n
l
g
"}
(4,1,1) = {"
d
e
n
f
x
"}
(5,1,1) = {"
e
e
B
n
n
"}
(6,1,1) = {"
f
f
r
e
n
"}
(7,1,1) = {"
g
n
n
l
b
"}
(8,1,1) = {"
h
o
s
C
y
"}
(9,1,1) = {"
i
p
t
e
z
"}
(10,1,1) = {"
j
q
t
v
A
"}
