//MAP CONVERTED BY dmm2tgm.py THIS HEADER COMMENT PREVENTS RECONVERSION, DO NOT REMOVE
"a" = (
/obj/structure/closet{
	dir = 1
	},
/obj/item/gavelblock{
	dir = 1
	},
/obj/item/gavelhammer{
	dir = 1
	},
/obj/effect/decal/cleanable/dirt{
	dir = 4
	},
/turf/open/floor/plasteel,
/area/template_noop)
"b" = (
/obj/effect/decal/cleanable/dirt{
	dir = 4
	},
/turf/open/floor/plasteel,
/area/template_noop)
"c" = (
/obj/structure/chair{
	dir = 4
	},
/obj/machinery/light/built{
	icon_state = "tube-empty";
	dir = 2
	},
/obj/effect/turf_decal/tile/red{
	dir = 2
	},
/obj/effect/turf_decal/tile/red{
	dir = 1
	},
/obj/effect/turf_decal/tile/red{
	dir = 8
	},
/obj/effect/decal/cleanable/dirt{
	dir = 4
	},
/turf/open/floor/plasteel,
/area/template_noop)
"d" = (
/obj/structure/table_frame/wood{
	dir = 1
	},
/turf/open/floor/plating{
	icon_state = "panelscorched"
	},
/area/template_noop)
"e" = (
/obj/effect/turf_decal/tile/neutral{
	dir = 8
	},
/obj/effect/turf_decal/tile/neutral{
	dir = 2
	},
/obj/effect/decal/cleanable/dirt{
	dir = 4
	},
/turf/open/floor/plasteel,
/area/template_noop)
"f" = (
/obj/effect/turf_decal/tile/neutral{
	dir = 2
	},
/obj/effect/turf_decal/tile/neutral{
	dir = 8
	},
/obj/effect/turf_decal/tile/neutral{
	dir = 4
	},
/obj/effect/decal/cleanable/dirt{
	dir = 4
	},
/turf/open/floor/plasteel,
/area/template_noop)
"g" = (
/obj/machinery/light/broken{
	icon_state = "tube-broken";
	dir = 2
	},
/obj/effect/decal/cleanable/dirt{
	dir = 4
	},
/turf/open/floor/plating,
/area/template_noop)
"h" = (
/obj/structure/window/reinforced{
	dir = 8
	},
/obj/effect/decal/cleanable/dirt{
	dir = 4
	},
/turf/open/floor/plating,
/area/template_noop)
"i" = (
/obj/effect/decal/cleanable/dirt{
	dir = 4
	},
/turf/open/floor/plasteel/dark,
/area/template_noop)
"j" = (
/obj/effect/decal/cleanable/dirt{
	dir = 4
	},
/turf/open/floor/plating,
/area/template_noop)
"k" = (
/turf/open/floor/plating{
	icon_state = "panelscorched"
	},
/area/template_noop)
"l" = (
/obj/effect/decal/cleanable/ash{
	dir = 4
	},
/turf/open/floor/plating{
	icon_state = "panelscorched"
	},
/area/template_noop)
"m" = (
/obj/structure/table/wood{
	dir = 1
	},
/obj/effect/turf_decal/tile/neutral{
	dir = 2
	},
/obj/effect/turf_decal/tile/neutral{
	dir = 4
	},
/obj/effect/decal/cleanable/dirt{
	dir = 4
	},
/turf/open/floor/plasteel,
/area/template_noop)
"n" = (
/obj/structure/chair{
	dir = 8
	},
/obj/effect/turf_decal/tile/blue{
	dir = 2
	},
/obj/effect/turf_decal/tile/blue{
	dir = 8
	},
/obj/effect/turf_decal/tile/blue{
	dir = 4
	},
/obj/effect/decal/cleanable/dirt{
	dir = 4
	},
/turf/open/floor/plasteel,
/area/template_noop)
"o" = (
/obj/structure/chair{
	dir = 8
	},
/obj/structure/window/reinforced{
	dir = 8
	},
/obj/structure/window/reinforced{
	dir = 1
	},
/obj/effect/turf_decal/tile/neutral{
	dir = 4
	},
/obj/effect/turf_decal/tile/neutral{
	dir = 2
	},
/obj/effect/turf_decal/tile/neutral{
	dir = 1
	},
/obj/effect/turf_decal/tile/neutral{
	dir = 8
	},
/obj/effect/decal/cleanable/dirt{
	dir = 4
	},
/turf/open/floor/plasteel/dark,
/area/template_noop)
"p" = (
/obj/machinery/door/window/northleft{
	name = "old cell door"
	},
/obj/effect/decal/cleanable/dirt{
	dir = 4
	},
/turf/open/floor/plasteel/dark,
/area/template_noop)
"q" = (
/obj/structure/chair{
	dir = 8
	},
/obj/effect/turf_decal/tile/blue{
	dir = 2
	},
/obj/effect/turf_decal/tile/blue{
	dir = 4
	},
/obj/effect/decal/cleanable/dirt{
	dir = 4
	},
/turf/open/floor/plasteel,
/area/template_noop)
"r" = (
/obj/structure/chair{
	dir = 4
	},
/obj/effect/decal/cleanable/dirt{
	dir = 4
	},
/turf/open/floor/plasteel,
/area/template_noop)
"s" = (
/obj/structure/chair{
	dir = 4
	},
/obj/effect/turf_decal/tile/green{
	dir = 8
	},
/obj/effect/turf_decal/tile/green{
	dir = 1
	},
/obj/effect/turf_decal/tile/green{
	dir = 2
	},
/obj/effect/decal/cleanable/dirt{
	dir = 4
	},
/turf/open/floor/plasteel,
/area/template_noop)
"t" = (
/obj/structure/table/wood{
	dir = 1
	},
/obj/item/book/manual/wiki/security_space_law{
	dir = 1
	},
/obj/effect/turf_decal/tile/neutral{
	dir = 2
	},
/obj/effect/turf_decal/tile/neutral{
	dir = 4
	},
/obj/effect/decal/cleanable/dirt{
	dir = 4
	},
/turf/open/floor/plasteel,
/area/template_noop)
"u" = (
/obj/structure/chair{
	dir = 8
	},
/obj/effect/turf_decal/tile/blue{
	dir = 1
	},
/obj/effect/turf_decal/tile/blue{
	dir = 2
	},
/obj/effect/turf_decal/tile/blue{
	dir = 4
	},
/obj/effect/decal/cleanable/dirt{
	dir = 4
	},
/turf/open/floor/plasteel,
/area/template_noop)
"v" = (
/obj/effect/decal/cleanable/dirt{
	dir = 4
	},
/turf/open/floor/plating{
	icon_state = "platingdmg3"
	},
/area/template_noop)
"w" = (
/obj/structure/chair{
	dir = 4
	},
/obj/machinery/light/built{
	dir = 1
	},
/obj/effect/turf_decal/tile/green{
	dir = 8
	},
/obj/effect/turf_decal/tile/green{
	dir = 1
	},
/obj/effect/turf_decal/tile/green{
	dir = 4
	},
/obj/effect/decal/cleanable/dirt{
	dir = 4
	},
/turf/open/floor/plasteel,
/area/template_noop)
"x" = (
/obj/structure/table/wood{
	dir = 1
	},
/obj/item/folder/blue{
	dir = 1
	},
/obj/effect/turf_decal/tile/neutral{
	dir = 4
	},
/obj/effect/turf_decal/tile/neutral{
	dir = 2
	},
/obj/effect/decal/cleanable/dirt{
	dir = 4
	},
/turf/open/floor/plasteel,
/area/template_noop)
"y" = (
/obj/effect/turf_decal/tile/neutral{
	dir = 4
	},
/obj/effect/turf_decal/tile/neutral{
	dir = 1
	},
/obj/effect/decal/cleanable/dirt{
	dir = 4
	},
/turf/open/floor/plasteel,
/area/template_noop)
"z" = (
/obj/effect/turf_decal/tile/neutral{
	dir = 2
	},
/obj/effect/turf_decal/tile/neutral{
	dir = 4
	},
/obj/effect/turf_decal/tile/neutral{
	dir = 1
	},
/obj/effect/decal/cleanable/dirt{
	dir = 4
	},
/turf/open/floor/plasteel,
/area/template_noop)
"A" = (
/obj/machinery/light{
	dir = 1
	},
/obj/effect/decal/cleanable/dirt{
	dir = 4
	},
/turf/open/floor/plasteel,
/area/template_noop)
"B" = (
/obj/structure/chair{
	dir = 8
	},
/obj/effect/decal/cleanable/dirt{
	dir = 4
	},
/turf/open/floor/plasteel,
/area/template_noop)
"C" = (
/obj/effect/trap/trigger/reusable/random{
	dir = 1
	},
/turf/open/floor/plating{
	icon_state = "panelscorched"
	},
/area/template_noop)
"D" = (
/obj/structure/table_frame/wood{
	dir = 1
	},
/obj/effect/trap/nexus/trickyspawner/shitsec{
	mobs = 3;
	dir = 1
	},
/turf/open/floor/plating{
	icon_state = "panelscorched"
	},
/area/template_noop)

(1,1,1) = {"
r
r
b
j
a"}(2,1,1) = {"
j
b
b
b
b"}(3,1,1) = {"
w
s
k
l
c"}(4,1,1) = {"
x
d
k
d
d"}(5,1,1) = {"
y
k
C
k
e"}(6,1,1) = {"
y
b
l
k
e"}(7,1,1) = {"
z
t
D
m
f"}(8,1,1) = {"
A
u
q
n
g"}(9,1,1) = {"
b
j
b
o
h"}(10,1,1) = {"
B
v
j
p
i"}