//MAP CONVERTED BY dmm2tgm.py THIS HEADER COMMENT PREVENTS RECONVERSION, DO NOT REMOVE
"a" = (
/obj/machinery/dna_scannernew,
/obj/effect/turf_decal/tile/blue,
/obj/effect/turf_decal/tile/blue{
	dir = 8
	},
/obj/effect/turf_decal/tile/blue{
	dir = 1
	},
/turf/open/floor/plasteel,
/area/template_noop)
"b" = (
/obj/item/storage/pod{
	pixel_x = 7;
	pixel_y = -32
	},
/turf/open/floor/plating,
/area/template_noop)
"g" = (
/obj/machinery/light/small{
	dir = 4
	},
/turf/open/floor/plating,
/area/template_noop)
"j" = (
/obj/effect/spawner/lootdrop/grille_or_trash,
/turf/open/floor/plating,
/area/template_noop)
"l" = (
/obj/structure/reagent_dispensers/watertank,
/turf/open/floor/plating,
/area/template_noop)
"q" = (
/turf/open/floor/plating{
	icon_state = "platingdmg3"
	},
/area/template_noop)
"r" = (
/obj/structure/reagent_dispensers/fueltank,
/obj/machinery/light/small{
	dir = 1
	},
/turf/open/floor/plating,
/area/template_noop)
"s" = (
/obj/effect/turf_decal/tile/blue{
	dir = 8
	},
/obj/effect/turf_decal/tile/blue{
	dir = 1
	},
/turf/open/floor/plasteel,
/area/template_noop)
"u" = (
/obj/machinery/computer/scan_consolenew{
	dir = 1
	},
/obj/machinery/light,
/obj/effect/turf_decal/tile/blue,
/obj/effect/turf_decal/tile/blue{
	dir = 8
	},
/turf/open/floor/plasteel,
/area/template_noop)
"v" = (
/obj/effect/landmark/blobstart,
/turf/open/floor/plating,
/area/template_noop)
"w" = (
/turf/open/floor/plasteel,
/area/template_noop)
"x" = (
/obj/machinery/door/airlock/maintenance/external/glass,
/obj/structure/barricade/wooden,
/turf/open/floor/plating,
/area/template_noop)
"y" = (
/obj/effect/landmark/blobstart,
/obj/effect/turf_decal/tile/blue,
/obj/effect/turf_decal/tile/blue{
	dir = 4
	},
/turf/open/floor/plasteel,
/area/template_noop)
"B" = (
/obj/structure/rack,
/obj/effect/spawner/lootdrop/maintenance/five,
/turf/open/floor/plating,
/area/template_noop)
"C" = (
/obj/effect/turf_decal/tile/blue{
	dir = 1
	},
/obj/effect/turf_decal/tile/blue{
	dir = 4
	},
/turf/open/floor/plasteel,
/area/template_noop)
"D" = (
/obj/effect/spawner/structure/window/reinforced,
/turf/open/floor/plating,
/area/template_noop)
"E" = (
/obj/effect/turf_decal/tile/blue{
	dir = 8
	},
/obj/effect/turf_decal/tile/blue{
	dir = 1
	},
/obj/effect/turf_decal/tile/blue{
	dir = 4
	},
/turf/open/floor/plasteel,
/area/template_noop)
"F" = (
/obj/item/kirbyplants/random,
/obj/structure/noticeboard{
	pixel_y = 32
	},
/obj/effect/turf_decal/tile/blue,
/obj/effect/turf_decal/tile/blue{
	dir = 1
	},
/obj/effect/turf_decal/tile/blue{
	dir = 4
	},
/turf/open/floor/plasteel,
/area/template_noop)
"H" = (
/obj/structure/closet/firecloset/full,
/turf/open/floor/plating,
/area/template_noop)
"I" = (
/obj/structure/chair/office/light,
/turf/open/floor/plasteel,
/area/template_noop)
"J" = (
/obj/structure/table,
/obj/item/folder/white,
/obj/item/storage/box/disks,
/obj/item/clothing/gloves/color/latex,
/obj/structure/sign/poster/official/bless_this_spess{
	pixel_x = 32
	},
/obj/effect/turf_decal/tile/blue,
/obj/effect/turf_decal/tile/blue{
	dir = 8
	},
/obj/effect/turf_decal/tile/blue{
	dir = 4
	},
/turf/open/floor/plasteel,
/area/template_noop)
"L" = (
/obj/machinery/door/airlock/maintenance/external/glass,
/obj/effect/mapping_helpers/airlock/abandoned,
/turf/open/floor/plating,
/area/template_noop)
"M" = (
/turf/open/floor/plating,
/area/template_noop)
"P" = (
/obj/item/radio/intercom{
	pixel_y = 26
	},
/obj/machinery/light{
	dir = 1
	},
/turf/open/floor/plating,
/area/template_noop)
"Q" = (
/turf/closed/wall,
/area/template_noop)
"R" = (
/obj/structure/closet/crate,
/obj/effect/spawner/lootdrop/maintenance/five,
/turf/open/floor/plating,
/area/template_noop)
"T" = (
/turf/open/floor/plating{
	icon_state = "panelscorched"
	},
/area/template_noop)
"V" = (
/obj/effect/landmark/event_spawn,
/turf/open/floor/plating,
/area/template_noop)
"W" = (
/obj/machinery/light/small{
	dir = 8
	},
/turf/open/floor/plating,
/area/template_noop)
"X" = (
/turf/open/floor/plating{
	icon_state = "platingdmg1"
	},
/area/template_noop)

(1,1,1) = {"
M
M
E
s
a
"}
(2,1,1) = {"
P
w
C
I
u
"}
(3,1,1) = {"
x
Q
F
y
J
"}
(4,1,1) = {"
b
Q
D
D
Q
"}
(5,1,1) = {"
q
W
H
B
B
"}
(6,1,1) = {"
M
M
v
X
M
"}
(7,1,1) = {"
X
q
V
g
M
"}
(8,1,1) = {"
j
j
j
Q
L
"}
(9,1,1) = {"
r
M
M
Q
R
"}
(10,1,1) = {"
l
M
T
Q
R
"}
