//MAP CONVERTED BY dmm2tgm.py THIS HEADER COMMENT PREVENTS RECONVERSION, DO NOT REMOVE
"a" = (
/obj/structure/closet,
/obj/item/gavelblock,
/obj/item/gavelhammer,
/obj/effect/decal/cleanable/dirt,
/turf/open/floor/plasteel,
/area/template_noop)
"b" = (
/obj/effect/decal/cleanable/dirt,
/turf/open/floor/plasteel,
/area/template_noop)
"c" = (
/obj/structure/chair{
	dir = 4
	},
/obj/machinery/light/built{
	icon_state = "tube-empty";
	dir = 1
	},
/obj/effect/turf_decal/tile/red{
	dir = 4
	},
/obj/effect/turf_decal/tile/red{
	dir = 8
	},
/obj/effect/turf_decal/tile/red{
	dir = 1
	},
/obj/effect/decal/cleanable/dirt,
/turf/open/floor/plasteel,
/area/template_noop)
"d" = (
/obj/structure/table_frame/wood,
/turf/open/floor/plating{
	icon_state = "panelscorched"
	},
/area/template_noop)
"e" = (
/obj/effect/turf_decal/tile/neutral{
	dir = 1
	},
/obj/effect/turf_decal/tile/neutral{
	dir = 4
	},
/obj/effect/decal/cleanable/dirt,
/turf/open/floor/plasteel,
/area/template_noop)
"f" = (
/obj/effect/turf_decal/tile/neutral{
	dir = 4
	},
/obj/effect/turf_decal/tile/neutral{
	dir = 1
	},
/obj/effect/turf_decal/tile/neutral,
/obj/effect/decal/cleanable/dirt,
/turf/open/floor/plasteel,
/area/template_noop)
"g" = (
/obj/machinery/light/broken{
	icon_state = "tube-broken";
	dir = 1
	},
/obj/effect/decal/cleanable/dirt,
/turf/open/floor/plating,
/area/template_noop)
"h" = (
/obj/structure/window/reinforced{
	dir = 8
	},
/obj/effect/decal/cleanable/dirt,
/turf/open/floor/plating,
/area/template_noop)
"i" = (
/obj/effect/decal/cleanable/dirt,
/turf/open/floor/plasteel/dark,
/area/template_noop)
"j" = (
/obj/effect/decal/cleanable/dirt,
/turf/open/floor/plating,
/area/template_noop)
"k" = (
/turf/open/floor/plating{
	icon_state = "panelscorched"
	},
/area/template_noop)
"l" = (
/obj/effect/decal/cleanable/ash,
/turf/open/floor/plating{
	icon_state = "panelscorched"
	},
/area/template_noop)
"m" = (
/obj/structure/table/wood,
/obj/effect/turf_decal/tile/neutral{
	dir = 4
	},
/obj/effect/turf_decal/tile/neutral,
/obj/effect/decal/cleanable/dirt,
/turf/open/floor/plasteel,
/area/template_noop)
"n" = (
/obj/structure/chair{
	dir = 8
	},
/obj/effect/turf_decal/tile/blue{
	dir = 4
	},
/obj/effect/turf_decal/tile/blue{
	dir = 1
	},
/obj/effect/turf_decal/tile/blue,
/obj/effect/decal/cleanable/dirt,
/turf/open/floor/plasteel,
/area/template_noop)
"o" = (
/obj/structure/chair{
	dir = 8
	},
/obj/structure/window/reinforced{
	dir = 8
	},
/obj/structure/window/reinforced,
/obj/effect/turf_decal/tile/neutral,
/obj/effect/turf_decal/tile/neutral{
	dir = 4
	},
/obj/effect/turf_decal/tile/neutral{
	dir = 8
	},
/obj/effect/turf_decal/tile/neutral{
	dir = 1
	},
/obj/effect/decal/cleanable/dirt,
/turf/open/floor/plasteel/dark,
/area/template_noop)
"p" = (
/obj/machinery/door/window/southleft{
	name = "old cell door"
	},
/obj/effect/decal/cleanable/dirt,
/turf/open/floor/plasteel/dark,
/area/template_noop)
"q" = (
/obj/structure/chair{
	dir = 8
	},
/obj/effect/turf_decal/tile/blue{
	dir = 4
	},
/obj/effect/turf_decal/tile/blue,
/obj/effect/decal/cleanable/dirt,
/turf/open/floor/plasteel,
/area/template_noop)
"r" = (
/obj/structure/chair{
	dir = 4
	},
/obj/effect/decal/cleanable/dirt,
/turf/open/floor/plasteel,
/area/template_noop)
"s" = (
/obj/structure/chair{
	dir = 4
	},
/obj/effect/turf_decal/tile/green{
	dir = 1
	},
/obj/effect/turf_decal/tile/green{
	dir = 8
	},
/obj/effect/turf_decal/tile/green{
	dir = 4
	},
/obj/effect/decal/cleanable/dirt,
/turf/open/floor/plasteel,
/area/template_noop)
"t" = (
/obj/structure/table/wood,
/obj/item/book/manual/wiki/security_space_law,
/obj/effect/turf_decal/tile/neutral{
	dir = 4
	},
/obj/effect/turf_decal/tile/neutral,
/obj/effect/decal/cleanable/dirt,
/turf/open/floor/plasteel,
/area/template_noop)
"u" = (
/obj/structure/chair{
	dir = 8
	},
/obj/effect/turf_decal/tile/blue{
	dir = 8
	},
/obj/effect/turf_decal/tile/blue{
	dir = 4
	},
/obj/effect/turf_decal/tile/blue,
/obj/effect/decal/cleanable/dirt,
/turf/open/floor/plasteel,
/area/template_noop)
"v" = (
/obj/effect/decal/cleanable/dirt,
/turf/open/floor/plating{
	icon_state = "platingdmg3"
	},
/area/template_noop)
"w" = (
/obj/structure/chair{
	dir = 4
	},
/obj/machinery/light/built,
/obj/effect/turf_decal/tile/green{
	dir = 1
	},
/obj/effect/turf_decal/tile/green{
	dir = 8
	},
/obj/effect/turf_decal/tile/green,
/obj/effect/decal/cleanable/dirt,
/turf/open/floor/plasteel,
/area/template_noop)
"x" = (
/obj/structure/table/wood,
/obj/item/folder/blue,
/obj/effect/turf_decal/tile/neutral,
/obj/effect/turf_decal/tile/neutral{
	dir = 4
	},
/obj/effect/decal/cleanable/dirt,
/turf/open/floor/plasteel,
/area/template_noop)
"y" = (
/obj/effect/turf_decal/tile/neutral,
/obj/effect/turf_decal/tile/neutral{
	dir = 8
	},
/obj/effect/decal/cleanable/dirt,
/turf/open/floor/plasteel,
/area/template_noop)
"z" = (
/obj/effect/turf_decal/tile/neutral{
	dir = 4
	},
/obj/effect/turf_decal/tile/neutral,
/obj/effect/turf_decal/tile/neutral{
	dir = 8
	},
/obj/effect/decal/cleanable/dirt,
/turf/open/floor/plasteel,
/area/template_noop)
"A" = (
/obj/machinery/light,
/obj/effect/decal/cleanable/dirt,
/turf/open/floor/plasteel,
/area/template_noop)
"B" = (
/obj/structure/chair{
	dir = 8
	},
/obj/effect/decal/cleanable/dirt,
/turf/open/floor/plasteel,
/area/template_noop)
"C" = (
/obj/effect/trap/trigger/reusable/random,
/turf/open/floor/plating{
	icon_state = "panelscorched"
	},
/area/template_noop)
"D" = (
/obj/structure/table_frame/wood,
/obj/effect/trap/nexus/trickyspawner/shitsec{
	mobs = 3
	},
/turf/open/floor/plating{
	icon_state = "panelscorched"
	},
/area/template_noop)

(1,1,1) = {"
a
j
b
r
r
"}
(2,1,1) = {"
b
b
b
b
j
"}
(3,1,1) = {"
c
l
k
s
w
"}
(4,1,1) = {"
d
d
k
d
x
"}
(5,1,1) = {"
e
k
C
k
y
"}
(6,1,1) = {"
e
k
l
b
y
"}
(7,1,1) = {"
f
m
D
t
z
"}
(8,1,1) = {"
g
n
q
u
A
"}
(9,1,1) = {"
h
o
b
j
b
"}
(10,1,1) = {"
i
p
j
v
B
"}
