//MAP CONVERTED BY dmm2tgm.py THIS HEADER COMMENT PREVENTS RECONVERSION, DO NOT REMOVE
"a" = (
/turf/open/floor/plasteel,
/area/template_noop)
"b" = (
/obj/effect/decal/cleanable/blood/tracks{
	dir = 2
	},
/turf/open/floor/plating,
/area/template_noop)
"h" = (
/obj/item/caution{
	desc = "CAUTION! BIOHAZARD QUARANTINE!";
	name = "biohazard warning sign";
	dir = 1
	},
/obj/effect/decal/cleanable/dirt/dust{
	dir = 4
	},
/turf/open/floor/plating,
/area/template_noop)
"i" = (
/obj/effect/decal/cleanable/dirt/dust{
	dir = 4
	},
/turf/open/floor/plasteel,
/area/template_noop)
"j" = (
/obj/machinery/door/airlock/maintenance_hatch{
	dir = 1
	},
/obj/effect/decal/cleanable/blood/tracks{
	dir = 2
	},
/turf/open/floor/plating,
/area/template_noop)
"n" = (
/obj/effect/decal/cleanable/blood/old{
	dir = 4
	},
/turf/open/floor/plasteel,
/area/template_noop)
"o" = (
/obj/machinery/door/airlock/maintenance_hatch{
	dir = 1
	},
/obj/effect/decal/cleanable/dirt/dust{
	dir = 4
	},
/turf/open/floor/plasteel,
/area/template_noop)
"r" = (
/obj/structure/sign/warning/biohazard{
	dir = 1
	},
/turf/closed/wall,
/area/template_noop)
"t" = (
/turf/closed/wall,
/area/template_noop)
"u" = (
/mob/living/simple_animal/hostile/macrophage/aggro/vector,
/obj/effect/decal/cleanable/dirt/dust{
	dir = 4
	},
/obj/effect/decal/cleanable/dirt/dust{
	dir = 4
	},
/obj/item/clothing/gloves/color/yellow{
	dir = 1
	},
/obj/effect/decal/cleanable/blood/gibs/old{
	dir = 4
	},
/turf/open/floor/plating,
/area/template_noop)
"x" = (
/obj/effect/decal/cleanable/blood/tracks{
	dir = 2
	},
/obj/effect/decal/cleanable/dirt/dust{
	dir = 4
	},
/obj/effect/mob_spawn/human/clown/corpse{
	dir = 1
	},
/obj/effect/decal/cleanable/blood/gibs/old{
	dir = 4
	},
/turf/open/floor/plasteel,
/area/template_noop)
"y" = (
/obj/item/caution{
	desc = "CAUTION! BIOHAZARD QUARANTINE!";
	name = "biohazard warning sign";
	dir = 1
	},
/turf/open/floor/plating,
/area/template_noop)
"A" = (
/obj/item/caution{
	desc = "CAUTION! BIOHAZARD QUARANTINE!";
	name = "biohazard warning sign";
	dir = 1
	},
/obj/effect/decal/cleanable/blood/tracks{
	dir = 2
	},
/obj/effect/decal/cleanable/dirt/dust{
	dir = 4
	},
/turf/open/floor/plating,
/area/template_noop)
"C" = (
/obj/effect/decal/cleanable/blood/tracks{
	dir = 2
	},
/obj/item/ammo_casing/spent{
	dir = 1
	},
/turf/open/floor/plating,
/area/template_noop)
"D" = (
/obj/effect/mob_spawn/human/corpse/assistant{
	dir = 1
	},
/obj/effect/decal/cleanable/blood{
	dir = 4
	},
/turf/open/floor/plasteel,
/area/template_noop)
"H" = (
/obj/item/ammo_casing/spent{
	dir = 1
	},
/obj/effect/decal/cleanable/dirt/dust{
	dir = 4
	},
/turf/open/floor/plasteel,
/area/template_noop)
"I" = (
/obj/machinery/power/floodlight{
	dir = 1
	},
/turf/open/floor/plating,
/area/template_noop)
"K" = (
/obj/structure/barricade/sandbags{
	dir = 1
	},
/obj/effect/decal/cleanable/blood/gibs/old{
	dir = 4
	},
/obj/effect/decal/cleanable/blood/old{
	dir = 4
	},
/turf/open/floor/plating,
/area/template_noop)
"L" = (
/obj/effect/decal/cleanable/dirt/dust{
	dir = 4
	},
/obj/effect/decal/cleanable/blood/old{
	dir = 4
	},
/turf/open/floor/plating,
/area/template_noop)
"N" = (
/turf/open/floor/plating,
/area/template_noop)
"O" = (
/obj/structure/barricade/sandbags{
	dir = 1
	},
/turf/open/floor/plasteel,
/area/template_noop)
"Q" = (
/obj/item/ammo_casing/spent{
	dir = 1
	},
/obj/item/ammo_casing/spent{
	pixel_y = -4;
	dir = 1
	},
/obj/effect/decal/cleanable/dirt/dust{
	dir = 4
	},
/turf/open/floor/plasteel,
/area/template_noop)
"S" = (
/obj/machinery/door/airlock/maintenance_hatch{
	dir = 1
	},
/turf/open/floor/plating,
/area/template_noop)
"U" = (
/obj/effect/decal/cleanable/dirt/dust{
	dir = 4
	},
/turf/open/floor/plating,
/area/template_noop)
"W" = (
/obj/structure/barricade/sandbags{
	dir = 1
	},
/obj/effect/decal/cleanable/dirt/dust{
	dir = 4
	},
/obj/effect/decal/cleanable/blood/gibs/old{
	dir = 4
	},
/turf/open/floor/plasteel,
/area/template_noop)
"Y" = (
/obj/effect/decal/cleanable/dirt/dust{
	dir = 4
	},
/obj/structure/closet{
	dir = 1
	},
/obj/effect/spawner/lootdrop/maintenance/two{
	dir = 1
	},
/turf/open/floor/plating,
/area/template_noop)

(1,1,1) = {"
a
h
U
r
Y"}(2,1,1) = {"
i
t
r
t
L"}(3,1,1) = {"
n
t
u
t
a"}(4,1,1) = {"
y
r
x
t
y"}(5,1,1) = {"
N
o
A
t
i"}(6,1,1) = {"
U
t
b
t
U"}(7,1,1) = {"
t
t
j
r
S"}(8,1,1) = {"
U
H
C
a
D"}(9,1,1) = {"
U
I
K
W
i"}(10,1,1) = {"
N
y
Q
O
N"}