//MAP CONVERTED BY dmm2tgm.py THIS HEADER COMMENT PREVENTS RECONVERSION, DO NOT REMOVE
"a" = (
/obj/machinery/vending/snack/random{
	dir = 1
	},
/obj/effect/decal/cleanable/cobweb{
	dir = 4
	},
/obj/effect/turf_decal/tile/neutral{
	dir = 8
	},
/obj/effect/turf_decal/tile/neutral{
	dir = 4
	},
/obj/effect/turf_decal/tile/neutral{
	dir = 2
	},
/obj/effect/turf_decal/tile/neutral{
	dir = 1
	},
/turf/open/floor/plasteel/dark,
/area/template_noop)
"b" = (
/obj/machinery/vending/cola/random{
	dir = 1
	},
/obj/effect/decal/cleanable/dirt{
	dir = 4
	},
/obj/effect/turf_decal/tile/neutral{
	dir = 8
	},
/obj/effect/turf_decal/tile/neutral{
	dir = 4
	},
/obj/effect/turf_decal/tile/neutral{
	dir = 2
	},
/obj/effect/turf_decal/tile/neutral{
	dir = 1
	},
/turf/open/floor/plasteel/dark,
/area/template_noop)
"c" = (
/obj/effect/decal/cleanable/dirt{
	dir = 4
	},
/obj/item/kirbyplants/random{
	dir = 1
	},
/obj/structure/sign/poster/contraband/random{
	pixel_y = -32;
	dir = 1
	},
/obj/effect/turf_decal/tile/neutral{
	dir = 8
	},
/obj/effect/turf_decal/tile/neutral{
	dir = 4
	},
/obj/effect/turf_decal/tile/neutral{
	dir = 2
	},
/obj/effect/turf_decal/tile/neutral{
	dir = 1
	},
/turf/open/floor/plasteel/dark,
/area/template_noop)
"d" = (
/obj/structure/chair/stool{
	dir = 1
	},
/obj/machinery/light/small{
	dir = 2
	},
/obj/effect/turf_decal/tile/neutral{
	dir = 8
	},
/obj/effect/turf_decal/tile/neutral{
	dir = 4
	},
/obj/effect/turf_decal/tile/neutral{
	dir = 2
	},
/obj/effect/turf_decal/tile/neutral{
	dir = 1
	},
/turf/open/floor/plasteel/dark,
/area/template_noop)
"e" = (
/obj/effect/spawner/lootdrop/maintenance{
	dir = 1
	},
/obj/effect/turf_decal/tile/neutral{
	dir = 8
	},
/obj/effect/turf_decal/tile/neutral{
	dir = 4
	},
/obj/effect/turf_decal/tile/neutral{
	dir = 2
	},
/obj/effect/turf_decal/tile/neutral{
	dir = 1
	},
/turf/open/floor/plasteel/dark,
/area/template_noop)
"f" = (
/obj/structure/chair/stool{
	dir = 1
	},
/obj/effect/decal/cleanable/dirt{
	dir = 4
	},
/obj/effect/turf_decal/tile/neutral{
	dir = 8
	},
/obj/effect/turf_decal/tile/neutral{
	dir = 4
	},
/obj/effect/turf_decal/tile/neutral{
	dir = 2
	},
/obj/effect/turf_decal/tile/neutral{
	dir = 1
	},
/turf/open/floor/plasteel/dark,
/area/template_noop)
"g" = (
/turf/closed/wall,
/area/template_noop)
"h" = (
/obj/effect/turf_decal/tile/red{
	dir = 4
	},
/obj/effect/turf_decal/tile/red{
	dir = 1
	},
/obj/machinery/microwave{
	desc = "Cooks and boils stuff, somehow.";
	pixel_x = -3;
	pixel_y = -5;
	dir = 1
	},
/obj/structure/table{
	dir = 1
	},
/turf/open/floor/plasteel,
/area/template_noop)
"i" = (
/obj/structure/table{
	dir = 1
	},
/obj/item/clothing/head/chefhat{
	dir = 1
	},
/obj/item/clothing/suit/apron/chef{
	dir = 1
	},
/obj/machinery/light/small{
	icon_state = "bulb";
	dir = 2
	},
/turf/open/floor/plasteel/white/side,
/area/template_noop)
"j" = (
/obj/structure/sink/kitchen{
	desc = "A sink used for washing one's hands and face. It looks rusty and home-made";
	name = "old sink";
	pixel_y = -28;
	dir = 1
	},
/obj/effect/decal/cleanable/cobweb/cobweb2{
	dir = 4
	},
/obj/effect/decal/cleanable/dirt{
	dir = 4
	},
/obj/effect/turf_decal/tile/red{
	dir = 4
	},
/obj/effect/turf_decal/tile/red{
	dir = 1
	},
/obj/structure/table{
	dir = 1
	},
/turf/open/floor/plasteel,
/area/template_noop)
"k" = (
/obj/effect/decal/cleanable/dirt{
	dir = 4
	},
/obj/effect/turf_decal/tile/red{
	dir = 8
	},
/obj/effect/turf_decal/tile/red{
	dir = 4
	},
/obj/effect/turf_decal/tile/yellow{
	dir = 2
	},
/obj/effect/turf_decal/tile/yellow{
	dir = 1
	},
/turf/open/floor/plasteel,
/area/template_noop)
"l" = (
/obj/effect/turf_decal/tile/red{
	dir = 8
	},
/obj/effect/turf_decal/tile/red{
	dir = 4
	},
/obj/effect/turf_decal/tile/yellow{
	dir = 2
	},
/obj/effect/turf_decal/tile/yellow{
	dir = 1
	},
/turf/open/floor/plasteel,
/area/template_noop)
"m" = (
/obj/structure/chair/stool/bar{
	dir = 1
	},
/obj/effect/turf_decal/tile/red{
	dir = 8
	},
/obj/effect/turf_decal/tile/red{
	dir = 4
	},
/obj/effect/turf_decal/tile/yellow{
	dir = 2
	},
/obj/effect/turf_decal/tile/yellow{
	dir = 1
	},
/turf/open/floor/plasteel,
/area/template_noop)
"n" = (
/obj/structure/table/reinforced{
	dir = 1
	},
/obj/effect/spawner/lootdrop/maintenance{
	dir = 1
	},
/obj/effect/turf_decal/delivery{
	dir = 4
	},
/turf/open/floor/plasteel,
/area/template_noop)
"o" = (
/turf/open/floor/plasteel/white,
/area/template_noop)
"p" = (
/obj/effect/turf_decal/tile/red{
	dir = 8
	},
/obj/effect/turf_decal/tile/red{
	dir = 4
	},
/obj/effect/turf_decal/tile/red{
	dir = 2
	},
/obj/effect/turf_decal/tile/red{
	dir = 1
	},
/turf/open/floor/plasteel,
/area/template_noop)
"q" = (
/obj/item/storage/bag/tray{
	dir = 1
	},
/obj/structure/table{
	dir = 1
	},
/obj/structure/table{
	dir = 1
	},
/turf/open/floor/plasteel/white,
/area/template_noop)
"r" = (
/obj/item/chair/stool/bar{
	pixel_y = 8;
	dir = 1
	},
/obj/effect/decal/cleanable/dirt{
	dir = 4
	},
/obj/effect/decal/cleanable/vomit/old{
	dir = 4
	},
/obj/effect/turf_decal/tile/red{
	dir = 8
	},
/obj/effect/turf_decal/tile/red{
	dir = 4
	},
/obj/effect/turf_decal/tile/yellow{
	dir = 2
	},
/obj/effect/turf_decal/tile/yellow{
	dir = 1
	},
/turf/open/floor/plasteel,
/area/template_noop)
"s" = (
/obj/structure/table/reinforced{
	dir = 1
	},
/obj/item/reagent_containers/food/condiment/saltshaker{
	pixel_x = -8;
	pixel_y = -5;
	dir = 1
	},
/obj/item/reagent_containers/food/condiment/peppermill{
	pixel_x = -8;
	dir = 1
	},
/obj/effect/turf_decal/delivery{
	dir = 4
	},
/turf/open/floor/plasteel,
/area/template_noop)
"t" = (
/obj/structure/table/reinforced{
	dir = 1
	},
/obj/effect/decal/cleanable/dirt{
	dir = 4
	},
/obj/item/reagent_containers/food/snacks/meat/slab/human{
	pixel_x = 3;
	pixel_y = -3;
	dir = 1
	},
/obj/item/reagent_containers/food/snacks/meat/slab/human{
	dir = 1
	},
/obj/effect/turf_decal/delivery{
	dir = 4
	},
/turf/open/floor/plasteel,
/area/template_noop)
"u" = (
/obj/structure/table_frame/wood{
	dir = 1
	},
/obj/effect/decal/cleanable/dirt{
	dir = 4
	},
/obj/effect/turf_decal/tile/red{
	dir = 8
	},
/obj/effect/turf_decal/tile/red{
	dir = 4
	},
/obj/effect/turf_decal/tile/yellow{
	dir = 2
	},
/obj/effect/turf_decal/tile/yellow{
	dir = 1
	},
/turf/open/floor/plasteel,
/area/template_noop)
"v" = (
/obj/structure/chair/stool/bar{
	dir = 1
	},
/obj/effect/decal/cleanable/dirt{
	dir = 4
	},
/obj/effect/turf_decal/tile/red{
	dir = 8
	},
/obj/effect/turf_decal/tile/red{
	dir = 4
	},
/obj/effect/turf_decal/tile/yellow{
	dir = 2
	},
/obj/effect/turf_decal/tile/yellow{
	dir = 1
	},
/turf/open/floor/plasteel,
/area/template_noop)
"w" = (
/obj/machinery/light/small{
	dir = 1
	},
/obj/effect/turf_decal/tile/red{
	dir = 8
	},
/obj/effect/turf_decal/tile/red{
	dir = 4
	},
/obj/effect/turf_decal/tile/yellow{
	dir = 2
	},
/obj/effect/turf_decal/tile/yellow{
	dir = 1
	},
/turf/open/floor/plasteel,
/area/template_noop)
"x" = (
/obj/structure/closet/secure_closet/freezer/fridge/open{
	dir = 1
	},
/obj/effect/decal/cleanable/dirt{
	dir = 4
	},
/turf/open/floor/plating,
/area/template_noop)
"y" = (
/obj/effect/turf_decal/bot{
	dir = 4
	},
/obj/structure/closet/secure_closet/freezer/kitchen/maintenance{
	dir = 1
	},
/turf/open/floor/plasteel,
/area/template_noop)
"z" = (
/obj/structure/rack{
	dir = 1
	},
/obj/effect/decal/cleanable/dirt{
	dir = 4
	},
/obj/item/storage/box/donkpockets{
	dir = 1
	},
/obj/item/kitchen/knife/butcher{
	dir = 1
	},
/obj/item/stack/packageWrap{
	dir = 1
	},
/obj/effect/turf_decal/bot{
	dir = 4
	},
/turf/open/floor/plasteel,
/area/template_noop)
"R" = (
/obj/effect/decal/cleanable/blood/gibs/old{
	dir = 4
	},
/turf/open/floor/plasteel/white,
/area/template_noop)
"Y" = (
/obj/effect/decal/cleanable/vomit/old{
	dir = 4
	},
/turf/open/floor/plasteel/white,
/area/template_noop)

(1,1,1) = {"
u
k
k
k
a"}(2,1,1) = {"
r
l
l
l
b"}(3,1,1) = {"
v
l
l
l
c"}(4,1,1) = {"
w
k
k
k
d"}(5,1,1) = {"
m
l
l
l
e"}(6,1,1) = {"
m
m
r
m
f"}(7,1,1) = {"
g
t
s
n
g"}(8,1,1) = {"
x
o
p
o
h"}(9,1,1) = {"
y
p
Y
p
i"}(10,1,1) = {"
z
R
p
q
j"}