//MAP CONVERTED BY dmm2tgm.py THIS HEADER COMMENT PREVENTS RECONVERSION, DO NOT REMOVE
"a" = (
/obj/machinery/vending/cigarette,
/turf/open/floor/plating,
/area/template_noop)
"b" = (
/obj/machinery/door/airlock/maintenance/external/glass,
/turf/open/floor/iron,
/area/template_noop)
"c" = (
/turf/open/floor/iron,
/area/template_noop)
"g" = (
/obj/effect/landmark/blobstart,
/turf/open/floor/plating,
/area/template_noop)
"i" = (
/turf/open/floor/plating{
	burnt = 1
	},
/area/template_noop)
"l" = (
/obj/effect/turf_decal/tile/blue/half/contrasted,
/turf/open/floor/iron,
/area/template_noop)
"m" = (
/obj/machinery/light,
/obj/structure/closet/crate,
/obj/effect/spawner/random/maintenance/three,
/obj/effect/turf_decal/tile/blue/half/contrasted{
	dir = 8
	},
/turf/open/floor/iron,
/area/template_noop)
"p" = (
/turf/closed/wall,
/area/template_noop)
"q" = (
/obj/structure/chair/fancy/comfy{
	color = "#66b266"
	},
/turf/open/floor/plating,
/area/template_noop)
"s" = (
/obj/effect/landmark/event_spawn,
/turf/open/floor/iron,
/area/template_noop)
"u" = (
/obj/machinery/light/small{
	dir = 8
	},
/obj/effect/turf_decal/tile/blue/half/contrasted,
/turf/open/floor/iron,
/area/template_noop)
"v" = (
/obj/item/storage/pod{
	pixel_x = 32
	},
/turf/open/floor/plating,
/area/template_noop)
"y" = (
/obj/effect/turf_decal/tile/blue/half/contrasted{
	dir = 1
	},
/turf/open/floor/iron,
/area/template_noop)
"A" = (
/obj/machinery/light{
	dir = 1
	},
/turf/open/floor/iron,
/area/template_noop)
"D" = (
/obj/item/kirbyplants/random,
/turf/open/floor/plating,
/area/template_noop)
"E" = (
/obj/item/kirbyplants/random,
/obj/effect/turf_decal/tile/blue/anticorner/contrasted{
	dir = 1
	},
/turf/open/floor/iron,
/area/template_noop)
"F" = (
/obj/effect/spawner/random/maintenance/three,
/obj/structure/closet/crate,
/obj/effect/turf_decal/tile/blue/half/contrasted{
	dir = 8
	},
/turf/open/floor/iron,
/area/template_noop)
"G" = (
/turf/open/floor/plating{
	broken = 1
	},
/area/template_noop)
"J" = (
/obj/structure/table,
/obj/item/folder/white,
/obj/item/wrench/medical,
/obj/structure/sign/poster/official/moth4{
	pixel_x = -32
	},
/turf/open/floor/plating,
/area/template_noop)
"L" = (
/obj/machinery/light{
	dir = 1
	},
/obj/structure/chair/fancy/comfy{
	color = "#66b266"
	},
/obj/effect/turf_decal/tile/blue/half/contrasted{
	dir = 4
	},
/turf/open/floor/iron,
/area/template_noop)
"O" = (
/obj/machinery/newscaster{
	pixel_x = 32
	},
/turf/open/floor/plating,
/area/template_noop)
"Q" = (
/obj/effect/turf_decal/tile/blue/anticorner/contrasted,
/turf/open/floor/iron,
/area/template_noop)
"R" = (
/obj/effect/turf_decal/tile/blue/half/contrasted{
	dir = 8
	},
/turf/open/floor/iron,
/area/template_noop)
"S" = (
/turf/open/floor/plating,
/area/template_noop)
"T" = (
/obj/structure/chair/fancy/comfy{
	color = "#66b266"
	},
/obj/item/radio/intercom{
	pixel_y = 26
	},
/obj/effect/turf_decal/tile/blue/half/contrasted{
	dir = 4
	},
/turf/open/floor/iron,
/area/template_noop)
"V" = (
/obj/machinery/light/small{
	dir = 4
	},
/turf/open/floor/plating,
/area/template_noop)
"W" = (
/obj/structure/sign/nanotrasen{
	pixel_y = 32
	},
/obj/structure/chair/fancy/comfy{
	color = "#66b266"
	},
/obj/effect/turf_decal/tile/blue/half/contrasted{
	dir = 4
	},
/turf/open/floor/iron,
/area/template_noop)
"X" = (
/obj/structure/rack,
/obj/effect/spawner/random/maintenance/five,
/turf/open/floor/plating,
/area/template_noop)

(1,1,1) = {"
E
y
S
J
a
"}
(2,1,1) = {"
T
S
G
c
F
"}
(3,1,1) = {"
L
i
s
G
m
"}
(4,1,1) = {"
W
c
g
S
R
"}
(5,1,1) = {"
q
i
G
c
R
"}
(6,1,1) = {"
D
c
S
c
S
"}
(7,1,1) = {"
i
c
S
c
X
"}
(8,1,1) = {"
A
V
c
v
X
"}
(9,1,1) = {"
p
p
b
p
p
"}
(10,1,1) = {"
S
O
l
u
Q
"}
