"a" = (/obj/effect/decal/cleanable/cobweb,/obj/effect/turf_decal/tile/blue{dir = 1},/obj/effect/turf_decal/tile/blue{dir = 4},/obj/effect/turf_decal/tile/blue{dir = 8},/turf/open/floor/plasteel/dark,/area/template_noop)
"b" = (/obj/effect/turf_decal/tile/blue{dir = 1},/obj/effect/turf_decal/tile/blue{dir = 4},/turf/open/floor/plasteel/dark,/area/template_noop)
"c" = (/obj/effect/turf_decal/tile/blue{dir = 1},/obj/effect/turf_decal/tile/blue{dir = 4},/obj/machinery/light{dir = 1},/turf/open/floor/plasteel/dark,/area/template_noop)
"d" = (/obj/effect/decal/cleanable/dirt/dust,/obj/effect/turf_decal/tile/blue{dir = 1},/obj/effect/turf_decal/tile/blue{dir = 4},/turf/open/floor/plasteel/dark,/area/template_noop)
"e" = (/turf/open/floor/plasteel/dark,/area/template_noop)
"f" = (/obj/effect/turf_decal/tile/blue{dir = 1},/obj/effect/turf_decal/tile/blue{dir = 4},/obj/effect/turf_decal/tile/blue,/turf/open/floor/plasteel/dark,/area/template_noop)
"g" = (/obj/effect/turf_decal/tile/blue{dir = 1},/obj/effect/turf_decal/tile/blue{dir = 8},/turf/open/floor/plasteel/dark,/area/template_noop)
"h" = (/obj/structure/table,/obj/item/paper_bin{step_y = 4},/turf/open/floor/plasteel/dark,/area/template_noop)
"i" = (/obj/structure/chair/office/light,/obj/effect/decal/cleanable/dirt/dust,/turf/open/floor/plasteel/dark,/area/template_noop)
"j" = (/turf/open/floor/plating{icon_state = "platingdmg3"},/area/template_noop)
"k" = (/obj/structure/chair/office/light,/turf/open/floor/plating,/area/template_noop)
"l" = (/obj/structure/table,/obj/item/pen,/turf/open/floor/plating{icon_state = "platingdmg1"},/area/template_noop)
"m" = (/obj/structure/chair/office/light{dir = 4},/obj/effect/decal/cleanable/dirt/dust,/turf/open/floor/plasteel/dark,/area/template_noop)
"n" = (/obj/structure/table,/obj/item/folder/blue,/obj/item/pen,/obj/effect/decal/cleanable/dirt/dust,/turf/open/floor/plasteel/dark,/area/template_noop)
"o" = (/turf/open/floor/plating,/area/template_noop)
"p" = (/obj/structure/table,/turf/open/floor/plasteel/dark,/area/template_noop)
"q" = (/obj/structure/table,/obj/effect/decal/cleanable/dirt/dust,/turf/open/floor/plating{icon_state = "panelscorched"},/area/template_noop)
"r" = (/obj/effect/decal/cleanable/dirt/dust,/obj/effect/turf_decal/tile/blue{dir = 4},/obj/effect/turf_decal/tile/blue,/turf/open/floor/plasteel/dark,/area/template_noop)
"s" = (/obj/effect/decal/cleanable/dirt/dust,/turf/open/floor/plasteel/dark,/area/template_noop)
"t" = (/obj/structure/chair/office/light{dir = 1},/turf/open/floor/plasteel/dark,/area/template_noop)
"u" = (/obj/structure/chair/office/light{dir = 1},/obj/effect/decal/cleanable/dirt/dust,/turf/open/floor/plasteel/dark,/area/template_noop)
"v" = (/obj/structure/table,/obj/item/reagent_containers/food/drinks/mug,/turf/open/floor/plasteel/dark,/area/template_noop)
"w" = (/obj/effect/decal/cleanable/dirt/dust,/obj/effect/turf_decal/tile/blue{dir = 1},/obj/effect/turf_decal/tile/blue{dir = 8},/obj/effect/turf_decal/tile/blue,/turf/open/floor/plasteel/dark,/area/template_noop)
"x" = (/obj/effect/decal/cleanable/dirt/dust,/obj/effect/turf_decal/tile/blue{dir = 8},/obj/effect/turf_decal/tile/blue,/turf/open/floor/plasteel/dark,/area/template_noop)
"y" = (/obj/effect/turf_decal/tile/blue{dir = 1},/obj/effect/turf_decal/tile/blue{dir = 4},/obj/machinery/light/broken{icon_state = "tube-broken"; dir = 1},/turf/open/floor/plasteel/dark,/area/template_noop)
"z" = (/obj/effect/turf_decal/tile/blue{dir = 8},/obj/effect/turf_decal/tile/blue,/turf/open/floor/plasteel/dark,/area/template_noop)
"A" = (/obj/structure/table,/obj/effect/decal/cleanable/dirt/dust,/turf/open/floor/plating,/area/template_noop)
"B" = (/obj/effect/decal/cleanable/dirt/dust,/obj/effect/turf_decal/tile/blue{dir = 4},/obj/effect/turf_decal/tile/blue,/obj/effect/turf_decal/tile/blue{dir = 8},/turf/open/floor/plasteel/dark,/area/template_noop)
"C" = (/obj/effect/decal/cleanable/dirt/dust,/obj/effect/turf_decal/tile/blue{dir = 8},/obj/effect/turf_decal/tile/blue,/obj/machinery/light/broken,/turf/open/floor/plasteel/dark,/area/template_noop)
"D" = (/obj/structure/table,/turf/open/floor/plating,/area/template_noop)
"E" = (/obj/structure/chair/office/light{dir = 8},/turf/open/floor/plating{icon_state = "platingdmg3"},/area/template_noop)
"F" = (/obj/effect/decal/cleanable/dirt/dust,/turf/open/floor/plating,/area/template_noop)
"G" = (/obj/structure/chair/office/light{dir = 1},/obj/effect/decal/cleanable/dirt/dust,/turf/open/floor/plating{icon_state = "panelscorched"},/area/template_noop)
"H" = (/obj/machinery/light/built,/turf/open/floor/plating,/area/template_noop)

(1,1,1) = {"
abydeejcbf
gehiikkloo
emnqAlDDEs
jFptGutver
wFHzesxCxB
"}
