//MAP CONVERTED BY dmm2tgm.py THIS HEADER COMMENT PREVENTS RECONVERSION, DO NOT REMOVE
"a" = (
/turf/open/floor/plating,
/area/template_noop)
"b" = (
/obj/structure/window/reinforced/spawner/east,
/obj/structure/lattice{
	dir = 1
	},
/turf/open/space/basic,
/area/space)
"e" = (
/obj/structure/window/reinforced/spawner/north,
/obj/structure/sign/warning/vacuum{
	pixel_y = -32;
	dir = 1
	},
/turf/open/floor/plating,
/area/template_noop)
"g" = (
/obj/structure/window/reinforced/spawner/west,
/obj/structure/closet/firecloset/full{
	dir = 1
	},
/turf/open/floor/plating{
	icon_state = "platingdmg3"
	},
/area/template_noop)
"i" = (
/obj/structure/window/reinforced/spawner/east,
/obj/structure/closet/crate{
	dir = 1
	},
/obj/effect/spawner/lootdrop/maintenance/eight{
	dir = 1
	},
/turf/open/floor/plating,
/area/template_noop)
"k" = (
/obj/structure/window/reinforced/spawner/west,
/obj/structure/reagent_dispensers/fueltank{
	dir = 1
	},
/turf/open/floor/plating,
/area/template_noop)
"l" = (
/obj/structure/window/reinforced/spawner/west,
/obj/structure/window/reinforced/spawner/north,
/turf/open/space/basic,
/area/space)
"m" = (
/obj/structure/window/reinforced/spawner{
	dir = 1
	},
/turf/open/floor/plating{
	icon_state = "platingdmg1"
	},
/area/template_noop)
"n" = (
/obj/machinery/light{
	dir = 2
	},
/turf/open/floor/plating,
/area/template_noop)
"o" = (
/obj/effect/landmark/blobstart{
	dir = 1
	},
/turf/open/floor/plating,
/area/template_noop)
"p" = (
/obj/structure/lattice{
	dir = 1
	},
/turf/open/space/basic,
/area/space)
"s" = (
/obj/structure/window/reinforced/spawner/north,
/turf/open/floor/plating,
/area/template_noop)
"v" = (
/obj/structure/window/reinforced/spawner/west,
/obj/structure/lattice{
	dir = 1
	},
/turf/open/space/basic,
/area/space)
"z" = (
/obj/structure/window/reinforced/spawner/north,
/turf/open/floor/plating{
	icon_state = "platingdmg1"
	},
/area/template_noop)
"B" = (
/obj/structure/window/reinforced/spawner/north,
/turf/open/space/basic,
/area/space)
"D" = (
/obj/structure/window/reinforced/spawner/west,
/obj/structure/window/reinforced/spawner{
	dir = 1
	},
/turf/open/space/basic,
/area/space)
"E" = (
/obj/structure/window/reinforced/spawner{
	dir = 1
	},
/turf/open/space/basic,
/area/space)
"F" = (
/obj/effect/landmark/event_spawn{
	dir = 1
	},
/turf/open/floor/plating,
/area/template_noop)
"G" = (
/obj/structure/window/reinforced/spawner/east,
/obj/structure/closet/crate{
	dir = 1
	},
/obj/effect/spawner/lootdrop/maintenance/five{
	dir = 1
	},
/turf/open/floor/plating{
	icon_state = "platingdmg3"
	},
/area/template_noop)
"H" = (
/obj/structure/window/reinforced/spawner{
	dir = 1
	},
/obj/structure/window/reinforced/spawner/east,
/turf/open/space/basic,
/area/space)
"K" = (
/obj/machinery/light{
	dir = 1
	},
/turf/open/floor/plating,
/area/template_noop)
"L" = (
/obj/structure/window/reinforced/spawner/east,
/obj/structure/closet/crate{
	dir = 1
	},
/obj/effect/spawner/lootdrop/maintenance/three{
	dir = 1
	},
/turf/open/floor/plating,
/area/template_noop)
"M" = (
/obj/structure/window/reinforced/spawner{
	dir = 1
	},
/turf/open/floor/plating,
/area/template_noop)
"U" = (
/obj/structure/window/reinforced/spawner/west,
/obj/structure/reagent_dispensers/watertank{
	dir = 1
	},
/turf/open/floor/plating,
/area/template_noop)
"V" = (
/obj/structure/window/reinforced/spawner/north,
/obj/item/radio/intercom{
	pixel_y = -26;
	dir = 1
	},
/turf/open/floor/plating{
	icon_state = "panelscorched"
	},
/area/template_noop)
"Z" = (
/obj/structure/window/reinforced/spawner/east,
/obj/structure/window/reinforced/spawner/north,
/turf/open/space/basic,
/area/space)

(1,1,1) = {"
a
a
o
a
a"}(2,1,1) = {"
K
L
G
i
n"}(3,1,1) = {"
M
l
v
D
s"}(4,1,1) = {"
M
B
p
E
V"}(5,1,1) = {"
M
B
p
E
e"}(6,1,1) = {"
m
B
p
E
s"}(7,1,1) = {"
M
B
p
E
z"}(8,1,1) = {"
M
Z
b
H
s"}(9,1,1) = {"
K
g
U
k
n"}(10,1,1) = {"
a
a
F
a
a"}