//MAP CONVERTED BY dmm2tgm.py THIS HEADER COMMENT PREVENTS RECONVERSION, DO NOT REMOVE
"a" = (
/turf/open/floor/plating,
/area/template_noop)
"b" = (
/obj/structure/window/reinforced/spawner{
	dir = 1
	},
/obj/structure/rack{
	dir = 1
	},
/obj/item/storage/box/ingredients/carnivore{
	dir = 1
	},
/obj/item/reagent_containers/food/snacks/bun{
	dir = 1
	},
/obj/item/reagent_containers/food/snacks/bun{
	dir = 1
	},
/obj/item/reagent_containers/food/snacks/bun{
	dir = 1
	},
/obj/item/reagent_containers/food/snacks/bun{
	dir = 1
	},
/obj/item/reagent_containers/food/snacks/bun{
	dir = 1
	},
/obj/item/reagent_containers/food/snacks/bun{
	dir = 1
	},
/obj/item/reagent_containers/food/snacks/bun{
	dir = 1
	},
/turf/open/floor/grass,
/area/template_noop)
"c" = (
/obj/effect/spawner/lootdrop/grille_or_trash{
	dir = 1
	},
/turf/open/floor/plating,
/area/template_noop)
"d" = (
/obj/structure/window/reinforced/spawner{
	dir = 1
	},
/obj/machinery/deepfryer{
	dir = 1
	},
/turf/open/floor/plasteel/cafeteria,
/area/template_noop)
"g" = (
/obj/structure/window/reinforced/spawner/north,
/mob/living/simple_animal/mouse/gray,
/turf/open/floor/grass,
/area/template_noop)
"h" = (
/obj/machinery/door/window{
	dir = 1
	},
/obj/effect/decal/cleanable/blood/old{
	dir = 4
	},
/turf/open/floor/plasteel/cafeteria,
/area/template_noop)
"i" = (
/turf/closed/wall,
/area/template_noop)
"l" = (
/obj/machinery/microwave{
	dir = 1
	},
/obj/structure/window/reinforced/spawner/north,
/obj/structure/table{
	dir = 1
	},
/turf/open/floor/plasteel/cafeteria,
/area/template_noop)
"n" = (
/obj/structure/table{
	dir = 1
	},
/obj/item/reagent_containers/food/snacks/burger/rat{
	pixel_x = 4;
	pixel_y = -6;
	dir = 1
	},
/obj/item/reagent_containers/food/snacks/burger/rat{
	dir = 1
	},
/obj/structure/window/reinforced/spawner/north,
/turf/open/floor/monotile/steel,
/area/template_noop)
"o" = (
/obj/structure/chair/stool/bar{
	dir = 1
	},
/obj/effect/decal/cleanable/blood/old{
	dir = 4
	},
/obj/effect/landmark/event_spawn{
	dir = 1
	},
/turf/open/floor/plating,
/area/template_noop)
"p" = (
/obj/structure/sign/nanotrasen{
	dir = 1
	},
/turf/closed/wall,
/area/template_noop)
"r" = (
/obj/structure/window/reinforced/spawner/north,
/obj/structure/window/reinforced/spawner/east,
/mob/living/simple_animal/mouse/brown,
/turf/open/floor/grass,
/area/template_noop)
"v" = (
/turf/open/floor/plating{
	icon_state = "platingdmg1"
	},
/area/template_noop)
"w" = (
/obj/structure/rack{
	dir = 1
	},
/obj/item/stack/cable_coil/blue,
/obj/item/stack/cable_coil/blue,
/obj/item/kitchen/knife/butcher{
	dir = 1
	},
/obj/item/clothing/suit/hooded/wintercoat/security{
	dir = 1
	},
/turf/open/floor/plating{
	icon_state = "platingdmg1"
	},
/area/template_noop)
"z" = (
/mob/living/simple_animal/mouse/brown,
/turf/open/floor/grass,
/area/template_noop)
"A" = (
/obj/structure/window/reinforced/spawner{
	dir = 1
	},
/obj/structure/reagent_dispensers/cooking_oil{
	dir = 1
	},
/turf/open/floor/plasteel/cafeteria,
/area/template_noop)
"B" = (
/mob/living/simple_animal/mouse/white,
/turf/open/floor/grass,
/area/template_noop)
"C" = (
/obj/structure/window/reinforced/spawner{
	dir = 1
	},
/obj/structure/window/reinforced/spawner/east,
/mob/living/simple_animal/mouse/gray,
/turf/open/floor/grass,
/area/template_noop)
"D" = (
/obj/structure/window/reinforced/spawner{
	dir = 1
	},
/obj/structure/window/reinforced/spawner/east,
/obj/structure/table{
	dir = 1
	},
/obj/item/reagent_containers/food/drinks/beer{
	pixel_x = -7;
	pixel_y = -5;
	dir = 1
	},
/obj/item/reagent_containers/food/drinks/beer{
	pixel_x = 6;
	pixel_y = -4;
	dir = 1
	},
/obj/item/reagent_containers/food/drinks/beer{
	pixel_y = -6;
	dir = 1
	},
/obj/item/reagent_containers/food/drinks/beer{
	pixel_x = -1;
	dir = 1
	},
/turf/open/floor/plasteel/cafeteria,
/area/template_noop)
"F" = (
/obj/structure/table{
	dir = 1
	},
/obj/machinery/light/small{
	dir = 2
	},
/obj/item/reagent_containers/food/snacks/burger/rat{
	pixel_x = 7;
	pixel_y = -5;
	dir = 1
	},
/obj/item/reagent_containers/food/snacks/burger/rat{
	pixel_x = -4;
	pixel_y = -4;
	dir = 1
	},
/obj/item/reagent_containers/food/snacks/burger/rat{
	dir = 1
	},
/turf/open/floor/monotile/steel,
/area/template_noop)
"G" = (
/obj/machinery/light/small{
	dir = 1
	},
/turf/open/floor/plating,
/area/template_noop)
"H" = (
/obj/machinery/light/small{
	dir = 8
	},
/turf/open/floor/plating,
/area/template_noop)
"I" = (
/obj/structure/chair/stool/bar{
	dir = 1
	},
/obj/effect/landmark/blobstart{
	dir = 1
	},
/turf/open/floor/plating{
	icon_state = "panelscorched"
	},
/area/template_noop)
"J" = (
/obj/machinery/light/small{
	dir = 4
	},
/turf/open/floor/plating,
/area/template_noop)
"K" = (
/obj/effect/decal/cleanable/blood/old{
	dir = 4
	},
/obj/item/reagent_containers/food/snacks/bun{
	dir = 1
	},
/turf/open/floor/plasteel/cafeteria,
/area/template_noop)
"L" = (
/obj/machinery/door/window/eastright,
/mob/living/simple_animal/mouse/gray,
/turf/open/floor/grass,
/area/template_noop)
"M" = (
/obj/machinery/light/small{
	dir = 2
	},
/turf/open/floor/plating,
/area/template_noop)
"N" = (
/obj/item/trash/popcorn{
	dir = 1
	},
/turf/open/floor/plating,
/area/template_noop)
"O" = (
/turf/open/floor/plating{
	icon_state = "panelscorched"
	},
/area/template_noop)
"Q" = (
/turf/open/floor/plasteel/cafeteria,
/area/template_noop)
"R" = (
/obj/machinery/light/small{
	dir = 2
	},
/obj/effect/spawner/lootdrop/grille_or_trash{
	dir = 1
	},
/turf/open/floor/plating,
/area/template_noop)
"S" = (
/obj/structure/sign/barsign{
	pixel_y = -32;
	dir = 1
	},
/turf/open/floor/plating{
	icon_state = "platingdmg1"
	},
/area/template_noop)
"T" = (
/obj/effect/decal/cleanable/oil{
	dir = 4
	},
/turf/open/floor/plating,
/area/template_noop)
"V" = (
/obj/structure/window/reinforced/spawner{
	dir = 1
	},
/mob/living/simple_animal/mouse/white,
/turf/open/floor/grass,
/area/template_noop)
"Y" = (
/turf/open/floor/plating{
	icon_state = "platingdmg3"
	},
/area/template_noop)

(1,1,1) = {"
a
H
Y
a
a"}(2,1,1) = {"
c
i
p
i
c"}(3,1,1) = {"
G
g
B
b
M"}(4,1,1) = {"
a
g
z
V
v"}(5,1,1) = {"
Y
r
L
C
O"}(6,1,1) = {"
a
l
K
d
S"}(7,1,1) = {"
a
h
Q
A
a"}(8,1,1) = {"
G
n
F
D
R"}(9,1,1) = {"
N
I
o
w
a"}(10,1,1) = {"
a
T
v
J
a"}