//MAP CONVERTED BY dmm2tgm.py THIS HEADER COMMENT PREVENTS RECONVERSION, DO NOT REMOVE
"a" = (
/obj/machinery/shower{
	dir = 4
	},
/obj/effect/decal/cleanable/dirt{
	dir = 4
	},
/turf/open/floor/noslip,
/area/template_noop)
"b" = (
/obj/structure/closet/radiation{
	dir = 1
	},
/obj/structure/window/reinforced{
	dir = 8
	},
/obj/effect/decal/cleanable/dirt{
	dir = 4
	},
/turf/open/floor/plasteel,
/area/template_noop)
"c" = (
/obj/structure/closet/radiation{
	dir = 1
	},
/obj/machinery/light/built{
	icon_state = "tube-empty";
	dir = 2
	},
/obj/effect/decal/cleanable/dirt{
	dir = 4
	},
/turf/open/floor/plasteel,
/area/template_noop)
"d" = (
/obj/structure/window/reinforced{
	dir = 8
	},
/obj/effect/decal/cleanable/dirt{
	dir = 4
	},
/turf/open/floor/plating,
/area/template_noop)
"e" = (
/obj/effect/decal/cleanable/dirt{
	dir = 4
	},
/turf/open/floor/plating,
/area/template_noop)
"f" = (
/obj/effect/turf_decal/stripes/line{
	dir = 10
	},
/obj/effect/decal/cleanable/dirt{
	dir = 4
	},
/turf/open/floor/plasteel,
/area/template_noop)
"g" = (
/obj/structure/window/reinforced{
	dir = 1
	},
/obj/effect/turf_decal/stripes/line{
	dir = 2
	},
/obj/effect/decal/cleanable/dirt{
	dir = 4
	},
/turf/open/floor/plasteel,
/area/template_noop)
"h" = (
/obj/structure/window/reinforced{
	dir = 1
	},
/obj/effect/turf_decal/stripes/line{
	dir = 2
	},
/obj/machinery/light/broken{
	icon_state = "tube-broken";
	dir = 2
	},
/obj/effect/turf_decal/caution/stand_clear{
	icon_state = "stand_clear";
	dir = 8
	},
/obj/effect/decal/cleanable/dirt{
	dir = 4
	},
/turf/open/floor/plasteel,
/area/template_noop)
"i" = (
/obj/structure/window/reinforced{
	dir = 1
	},
/obj/effect/decal/cleanable/dirt{
	dir = 4
	},
/turf/open/floor/plating,
/area/template_noop)
"j" = (
/obj/effect/decal/cleanable/dirt{
	dir = 4
	},
/obj/item/circular_saw{
	dir = 1
	},
/turf/open/floor/plating,
/area/template_noop)
"k" = (
/obj/structure/window/reinforced{
	dir = 8
	},
/turf/open/floor/plating{
	icon_state = "panelscorched"
	},
/area/template_noop)
"l" = (
/obj/effect/decal/cleanable/dirt{
	dir = 4
	},
/turf/open/floor/plasteel,
/area/template_noop)
"m" = (
/obj/effect/decal/cleanable/dirt{
	dir = 4
	},
/obj/item/storage/belt/medical{
	dir = 1
	},
/turf/open/floor/plasteel,
/area/template_noop)
"n" = (
/turf/open/floor/mineral/uranium,
/area/template_noop)
"o" = (
/obj/structure/window/reinforced{
	dir = 8
	},
/turf/open/floor/plating{
	icon_state = "platingdmg1"
	},
/area/template_noop)
"p" = (
/turf/open/floor/plating{
	icon_state = "panelscorched"
	},
/area/template_noop)
"q" = (
/obj/machinery/door/window/westleft,
/turf/open/floor/plating{
	icon_state = "panelscorched"
	},
/area/template_noop)
"r" = (
/obj/item/surgicaldrill{
	dir = 1
	},
/turf/open/floor/plating{
	icon_state = "platingdmg1"
	},
/area/template_noop)
"s" = (
/obj/structure/window/reinforced{
	dir = 1
	},
/obj/structure/window/reinforced{
	dir = 4
	},
/obj/effect/turf_decal/stripes/corner{
	dir = 8
	},
/obj/effect/decal/cleanable/dirt{
	dir = 4
	},
/turf/open/floor/plasteel,
/area/template_noop)
"t" = (
/obj/effect/decal/remains/human{
	dir = 4
	},
/turf/open/floor/mineral/uranium,
/area/template_noop)
"u" = (
/obj/effect/decal/cleanable/ash{
	dir = 4
	},
/turf/open/floor/plating{
	icon_state = "panelscorched"
	},
/area/template_noop)
"v" = (
/obj/effect/turf_decal/stripes/line{
	dir = 8
	},
/obj/effect/turf_decal/caution/stand_clear{
	icon_state = "stand_clear";
	dir = 1
	},
/obj/effect/decal/cleanable/dirt{
	dir = 4
	},
/obj/effect/trap/nexus/trickyspawner/catbutcher{
	dir = 1
	},
/turf/open/floor/plasteel,
/area/template_noop)
"w" = (
/obj/machinery/door/window/westleft,
/obj/machinery/door/window/eastleft,
/obj/effect/turf_decal/delivery{
	dir = 4
	},
/obj/effect/decal/cleanable/dirt{
	dir = 4
	},
/turf/open/floor/plasteel,
/area/template_noop)
"x" = (
/obj/item/scalpel{
	dir = 1
	},
/turf/open/floor/plating{
	icon_state = "panelscorched"
	},
/area/template_noop)
"y" = (
/obj/structure/window/reinforced{
	dir = 8
	},
/obj/effect/decal/cleanable/dirt{
	dir = 4
	},
/obj/item/hemostat{
	dir = 1
	},
/turf/open/floor/plasteel,
/area/template_noop)
"z" = (
/obj/effect/turf_decal/stripes/line{
	dir = 9
	},
/obj/effect/decal/cleanable/dirt{
	dir = 4
	},
/turf/open/floor/plasteel,
/area/template_noop)
"A" = (
/obj/structure/window/reinforced{
	dir = 4
	},
/obj/structure/window/reinforced{
	dir = 2
	},
/obj/effect/decal/cleanable/dirt{
	dir = 4
	},
/turf/open/floor/plating,
/area/template_noop)
"B" = (
/obj/structure/window/reinforced{
	dir = 8
	},
/obj/effect/turf_decal/stripes/line{
	dir = 4
	},
/obj/effect/decal/cleanable/dirt{
	dir = 4
	},
/turf/open/floor/plasteel,
/area/template_noop)
"C" = (
/obj/machinery/computer/operating{
	dir = 2
	},
/obj/effect/decal/cleanable/dirt{
	dir = 4
	},
/turf/open/floor/plasteel,
/area/template_noop)
"D" = (
/obj/structure/table/optable{
	dir = 1
	},
/obj/effect/decal/cleanable/blood/old{
	dir = 4
	},
/turf/open/floor/plating{
	icon_state = "panelscorched"
	},
/area/template_noop)
"E" = (
/obj/structure/table{
	dir = 1
	},
/obj/machinery/light{
	dir = 1
	},
/obj/item/surgical_drapes{
	dir = 1
	},
/turf/open/floor/plating{
	icon_state = "panelscorched"
	},
/area/template_noop)
"F" = (
/obj/effect/decal/cleanable/dirt{
	dir = 4
	},
/obj/item/retractor{
	dir = 1
	},
/turf/open/floor/plating,
/area/template_noop)
"G" = (
/obj/structure/window/reinforced{
	dir = 2
	},
/obj/effect/decal/cleanable/dirt{
	dir = 4
	},
/turf/open/floor/plating,
/area/template_noop)
"H" = (
/obj/structure/window/reinforced{
	dir = 2
	},
/obj/effect/turf_decal/stripes/line{
	dir = 1
	},
/obj/machinery/light/broken{
	dir = 1
	},
/obj/effect/turf_decal/caution/stand_clear{
	dir = 4
	},
/obj/effect/decal/cleanable/dirt{
	dir = 4
	},
/turf/open/floor/plasteel,
/area/template_noop)
"I" = (
/obj/structure/window/reinforced{
	dir = 2
	},
/obj/effect/turf_decal/stripes/line{
	dir = 1
	},
/obj/effect/decal/cleanable/dirt{
	dir = 4
	},
/obj/item/cautery{
	dir = 1
	},
/turf/open/floor/plasteel,
/area/template_noop)
"J" = (
/obj/effect/turf_decal/stripes/line{
	dir = 5
	},
/obj/effect/decal/cleanable/dirt{
	dir = 4
	},
/turf/open/floor/plasteel,
/area/template_noop)
"K" = (
/obj/structure/window/reinforced{
	dir = 8
	},
/obj/effect/decal/cleanable/dirt{
	dir = 4
	},
/obj/effect/spawner/lootdrop/trap/reusable{
	dir = 1
	},
/turf/open/floor/plating,
/area/template_noop)
"L" = (
/obj/effect/decal/cleanable/dirt{
	dir = 4
	},
/obj/effect/spawner/lootdrop/trap/reusable{
	dir = 1
	},
/turf/open/floor/plasteel,
/area/template_noop)

(1,1,1) = {"
C
l
l
l
a"}(2,1,1) = {"
D
x
l
m
b"}(3,1,1) = {"
E
p
u
l
c"}(4,1,1) = {"
k
y
q
k
d"}(5,1,1) = {"
L
z
v
r
e"}(6,1,1) = {"
F
A
w
s
f"}(7,1,1) = {"
G
n
n
t
g"}(8,1,1) = {"
H
n
n
n
h"}(9,1,1) = {"
I
n
n
n
i"}(10,1,1) = {"
J
B
K
o
j"}