//MAP CONVERTED BY dmm2tgm.py THIS HEADER COMMENT PREVENTS RECONVERSION, DO NOT REMOVE
"a" = (
/obj/structure/table,
/obj/item/reagent_containers/medspray/dye{
	pixel_x = 14;
	pixel_y = 3
	},
/turf/open/floor/monotile,
/area/template_noop)
"b" = (
/obj/structure/table,
/obj/structure/mirror{
	pixel_y = 28
	},
/obj/item/razor{
	pixel_x = -5
	},
/obj/item/handmirror{
	pixel_x = 5;
	pixel_y = 4
	},
/obj/effect/decal/cleanable/blood,
/turf/open/floor/plasteel/cafeteria,
/area/template_noop)
"c" = (
/obj/effect/decal/cleanable/glass,
/turf/open/floor/monotile,
/area/template_noop)
"d" = (
/obj/structure/mineral_door/wood,
/turf/open/floor/plating,
/area/template_noop)
"e" = (
/obj/effect/decal/cleanable/blood/drip,
/turf/open/floor/monotile,
/area/template_noop)
"f" = (
/obj/effect/decal/cleanable/blood/splatter,
/turf/open/floor/plating,
/area/template_noop)
"g" = (
/obj/effect/decal/remains/human,
/obj/machinery/vending/wallmed{
	pixel_y = -28
	},
/obj/effect/decal/cleanable/dirt/dust,
/turf/open/floor/plating,
/area/template_noop)
"h" = (
/turf/open/floor/plasteel/cafeteria,
/area/template_noop)
"i" = (
/obj/structure/table,
/obj/item/paper/pamphlet/ruin/spacehotel,
/turf/open/floor/plasteel/cafeteria,
/area/template_noop)
"j" = (
/turf/closed/wall,
/area/template_noop)
"k" = (
/turf/open/floor/carpet{
	icon_state = "carpetsymbol"
	},
/area/template_noop)
"l" = (
/obj/item/hemostat,
/obj/item/retractor,
/obj/item/storage/toolbox/mechanical,
/obj/item/clothing/suit/apron/surgical,
/obj/item/roller,
/obj/item/tank/internals/anesthetic,
/obj/structure/closet/cardboard,
/obj/item/cautery,
/obj/effect/spawner/lootdrop/teratoma/major,
/obj/item/surgical_drapes,
/obj/item/storage/firstaid,
/obj/item/storage/firstaid/toxin,
/obj/item/storage/box/syringes,
/obj/item/reagent_containers/glass/bottle/morphine,
/obj/item/reagent_containers/glass/bottle/morphine,
/obj/item/stack/sheet/mineral/silver{
	amount = 2
	},
/obj/item/stack/sheet/iron/ten,
/obj/item/twohanded/required/chainsaw,
/obj/effect/decal/cleanable/cobweb/cobweb2,
/obj/item/clothing/head/wig/random,
/obj/item/reagent_containers/medspray/spraytan,
/obj/item/radio,
/turf/open/floor/plating,
/area/template_noop)
"m" = (
/obj/structure/table,
/obj/item/reagent_containers/medspray/spraytan{
	pixel_x = 8;
	pixel_y = 4
	},
/obj/item/reagent_containers/medspray/barber{
	pixel_y = 3
	},
/obj/item/reagent_containers/medspray/sterilizine{
	pixel_x = -8;
	pixel_y = 5
	},
/turf/open/floor/plasteel/cafeteria,
/area/template_noop)
"n" = (
/obj/structure/dresser,
/obj/item/flashlight/lamp{
	pixel_x = 2;
	pixel_y = 14
	},
/turf/open/floor/monotile,
/area/template_noop)
"o" = (
/obj/effect/landmark/start/randommaint/backalley_doc,
/obj/effect/decal/cleanable/blood/drip,
/turf/open/floor/plasteel/cafeteria,
/area/template_noop)
"p" = (
/obj/structure/chair/office/light{
	dir = 1
	},
/obj/effect/decal/cleanable/food/tomato_smudge,
/turf/open/floor/plasteel/ameridiner,
/area/template_noop)
"q" = (
/obj/structure/table,
/obj/item/reagent_containers/spray/cleaner,
/obj/effect/decal/cleanable/blood,
/turf/open/floor/plasteel/cafeteria,
/area/template_noop)
"r" = (
/obj/structure/window/spawner/west,
/obj/effect/decal/cleanable/dirt/dust,
/turf/open/floor/carpet{
	icon_state = "carpetsymbol"
	},
/area/template_noop)
"s" = (
/obj/machinery/door/window/westleft,
/turf/open/floor/carpet{
	icon_state = "carpetsymbol"
	},
/area/template_noop)
"t" = (
/turf/open/floor/monotile,
/area/template_noop)
"u" = (
/obj/machinery/light/small{
	dir = 4
	},
/turf/open/floor/monotile,
/area/template_noop)
"v" = (
/obj/structure/window/spawner/west,
/obj/structure/table/wood,
/obj/item/twohanded/required/kirbyplants{
	icon_state = "plant-18";
	pixel_y = 10
	},
/turf/open/floor/carpet{
	icon_state = "carpetsymbol"
	},
/area/template_noop)
"w" = (
/obj/structure/chair/sofa/left,
/turf/open/floor/carpet{
	icon_state = "carpetsymbol"
	},
/area/template_noop)
"x" = (
/obj/effect/decal/cleanable/vomit/old,
/turf/open/floor/monotile,
/area/template_noop)
"y" = (
/obj/structure/table,
/obj/effect/decal/cleanable/blood/bubblegum,
/turf/open/floor/plasteel/cafeteria,
/area/template_noop)
"z" = (
/obj/structure/closet/crate/freezer{
	name = "refreshment cooler"
	},
/obj/effect/spawner/lootdrop/teratoma/minor,
/obj/effect/spawner/lootdrop/teratoma/minor,
/obj/effect/spawner/lootdrop/teratoma/minor,
/obj/item/reagent_containers/food/drinks/beer/light,
/obj/item/reagent_containers/food/drinks/soda_cans/sodawater,
/obj/item/reagent_containers/food/drinks/soda_cans/shamblers,
/obj/item/reagent_containers/food/drinks/soda_cans/shamblers,
/obj/item/reagent_containers/food/drinks/soda_cans/grey_bull,
/obj/item/reagent_containers/food/drinks/soda_cans/grey_bull,
/obj/item/reagent_containers/food/drinks/soda_cans/air,
/obj/item/reagent_containers/food/drinks/soda_cans/dr_gibb,
/obj/item/reagent_containers/food/drinks/soda_cans/dr_gibb,
/obj/item/reagent_containers/food/drinks/soda_cans/cola,
/obj/item/reagent_containers/food/drinks/soda_cans/cola,
/obj/item/reagent_containers/food/drinks/soda_cans/pwr_game,
/obj/item/reagent_containers/food/drinks/soda_cans/pwr_game,
/obj/item/reagent_containers/food/drinks/soda_cans/space_up,
/obj/item/reagent_containers/food/drinks/soda_cans/space_up,
/obj/item/reagent_containers/food/drinks/soda_cans/starkist,
/obj/item/storage/pill_bottle/happy,
/turf/open/floor/carpet{
	icon_state = "carpetsymbol"
	},
/area/template_noop)
"A" = (
/obj/structure/chair/sofa/right,
/obj/effect/decal/cleanable/blood/splatter,
/turf/open/floor/carpet{
	icon_state = "carpetsymbol"
	},
/area/template_noop)
"B" = (
/obj/effect/decal/cleanable/dirt/dust,
/turf/open/floor/monotile,
/area/template_noop)
"C" = (
/obj/effect/decal/cleanable/dirt/dust,
/turf/open/floor/carpet{
	icon_state = "carpetsymbol"
	},
/area/template_noop)
"D" = (
/obj/machinery/light/small{
	dir = 4
	},
/turf/open/floor/carpet{
	icon_state = "carpetsymbol"
	},
/area/template_noop)
"E" = (
/obj/structure/table/wood,
/obj/item/clothing/head/wig/random,
/obj/item/clothing/head/wig/random,
/turf/open/floor/monotile,
/area/template_noop)
"F" = (
/obj/structure/table/wood,
/obj/machinery/light/small,
/obj/item/clothing/head/wig/random,
/turf/open/floor/monotile,
/area/template_noop)

(1,1,1) = {"
a
n
x
t
t
"}
(2,1,1) = {"
m
o
h
B
E
"}
(3,1,1) = {"
b
p
h
t
F
"}
(4,1,1) = {"
i
q
y
t
E
"}
(5,1,1) = {"
c
t
t
B
B
"}
(6,1,1) = {"
e
u
t
t
t
"}
(7,1,1) = {"
d
j
r
s
v
"}
(8,1,1) = {"
f
j
A
C
k
"}
(9,1,1) = {"
g
j
w
k
k
"}
(10,1,1) = {"
l
j
k
D
z
"}
