//MAP CONVERTED BY dmm2tgm.py THIS HEADER COMMENT PREVENTS RECONVERSION, DO NOT REMOVE
"e" = (
/turf/open/floor/iron/dark,
/area/template_noop)
"h" = (
/obj/structure/table,
/obj/item/paper_bin,
/turf/open/floor/iron/dark,
/area/template_noop)
"i" = (
/obj/structure/chair/office/light,
/obj/effect/decal/cleanable/dirt/dust,
/turf/open/floor/iron/dark,
/area/template_noop)
"j" = (
/turf/open/floor/plating{
	broken = 1
	},
/area/template_noop)
"k" = (
/obj/structure/chair/office/light,
/turf/open/floor/plating,
/area/template_noop)
"l" = (
/obj/structure/table,
/obj/item/pen,
/turf/open/floor/plating{
	broken = 1
	},
/area/template_noop)
"m" = (
/obj/structure/chair/office/light{
	dir = 4
	},
/obj/effect/decal/cleanable/dirt/dust,
/turf/open/floor/iron/dark,
/area/template_noop)
"n" = (
/obj/structure/table,
/obj/item/folder/blue,
/obj/item/pen,
/obj/effect/decal/cleanable/dirt/dust,
/turf/open/floor/iron/dark,
/area/template_noop)
"o" = (
/turf/open/floor/plating,
/area/template_noop)
"p" = (
/obj/structure/table,
/turf/open/floor/iron/dark,
/area/template_noop)
"q" = (
/obj/structure/table,
/obj/effect/decal/cleanable/dirt/dust,
/turf/open/floor/plating{
	burnt = 1
	},
/area/template_noop)
"s" = (
/obj/effect/decal/cleanable/dirt/dust,
/turf/open/floor/iron/dark,
/area/template_noop)
"t" = (
/obj/structure/chair/office/light{
	dir = 1
	},
/turf/open/floor/iron/dark,
/area/template_noop)
"u" = (
/obj/structure/chair/office/light{
	dir = 1
	},
/obj/effect/decal/cleanable/dirt/dust,
/turf/open/floor/iron/dark,
/area/template_noop)
"v" = (
/obj/structure/table,
/obj/item/reagent_containers/cup/glass/mug,
/turf/open/floor/iron/dark,
/area/template_noop)
"A" = (
/obj/structure/table,
/obj/effect/decal/cleanable/dirt/dust,
/turf/open/floor/plating,
/area/template_noop)
"D" = (
/obj/structure/table,
/turf/open/floor/plating,
/area/template_noop)
"E" = (
/obj/structure/chair/office/light{
	dir = 8
	},
/turf/open/floor/plating{
	broken = 1
	},
/area/template_noop)
"F" = (
/obj/effect/decal/cleanable/dirt/dust,
/turf/open/floor/plating,
/area/template_noop)
"G" = (
/obj/structure/chair/office/light{
	dir = 1
	},
/obj/effect/decal/cleanable/dirt/dust,
/turf/open/floor/plating{
	burnt = 1
	},
/area/template_noop)
"H" = (
/obj/machinery/light/built,
/turf/open/floor/plating,
/area/template_noop)
"I" = (
/obj/effect/turf_decal/tile/blue/half/contrasted{
	dir = 4
	},
/turf/open/floor/iron/dark,
/area/template_noop)
"J" = (
/obj/machinery/light/broken{
	icon_state = "tube-broken";
	dir = 1
	},
/obj/effect/turf_decal/tile/blue/half/contrasted{
	dir = 4
	},
/turf/open/floor/iron/dark,
/area/template_noop)
"M" = (
/obj/effect/turf_decal/tile/blue/anticorner/contrasted{
	dir = 4
	},
/turf/open/floor/iron/dark,
/area/template_noop)
"N" = (
/obj/effect/turf_decal/tile/blue/half/contrasted{
	dir = 8
	},
/turf/open/floor/iron/dark,
/area/template_noop)
"O" = (
/obj/machinery/light{
	dir = 1
	},
/obj/effect/turf_decal/tile/blue/half/contrasted{
	dir = 4
	},
/turf/open/floor/iron/dark,
/area/template_noop)
"P" = (
/obj/effect/decal/cleanable/dirt/dust,
/obj/machinery/light/broken,
/obj/effect/turf_decal/tile/blue/half/contrasted{
	dir = 8
	},
/turf/open/floor/iron/dark,
/area/template_noop)
"R" = (
/obj/effect/decal/cleanable/cobweb,
/obj/effect/turf_decal/tile/blue/anticorner/contrasted{
	dir = 1
	},
/turf/open/floor/iron/dark,
/area/template_noop)
"S" = (
/obj/effect/decal/cleanable/dirt/dust,
/obj/effect/turf_decal/tile/blue/anticorner/contrasted{
	dir = 8
	},
/turf/open/floor/iron/dark,
/area/template_noop)
"T" = (
/obj/effect/decal/cleanable/dirt/dust,
/obj/effect/turf_decal/tile/blue/half/contrasted{
	dir = 8
	},
/turf/open/floor/iron/dark,
/area/template_noop)
"V" = (
/obj/effect/turf_decal/tile/blue/half/contrasted{
	dir = 1
	},
/turf/open/floor/iron/dark,
/area/template_noop)
"W" = (
/obj/effect/decal/cleanable/dirt/dust,
/obj/effect/turf_decal/tile/blue/half/contrasted{
	dir = 4
	},
/turf/open/floor/iron/dark,
/area/template_noop)
"X" = (
/obj/effect/decal/cleanable/dirt/dust,
/obj/effect/turf_decal/tile/blue/half/contrasted,
/turf/open/floor/iron/dark,
/area/template_noop)
"Y" = (
/obj/effect/decal/cleanable/dirt/dust,
/obj/effect/turf_decal/tile/blue/anticorner/contrasted,
/turf/open/floor/iron/dark,
/area/template_noop)

(1,1,1) = {"
R
V
e
j
S
"}
(2,1,1) = {"
I
e
m
F
F
"}
(3,1,1) = {"
J
h
n
p
H
"}
(4,1,1) = {"
W
i
q
t
N
"}
(5,1,1) = {"
e
i
A
G
e
"}
(6,1,1) = {"
e
k
l
u
s
"}
(7,1,1) = {"
j
k
D
t
T
"}
(8,1,1) = {"
O
l
D
v
P
"}
(9,1,1) = {"
I
o
E
e
T
"}
(10,1,1) = {"
M
o
s
X
Y
"}
