//MAP CONVERTED BY dmm2tgm.py THIS HEADER COMMENT PREVENTS RECONVERSION, DO NOT REMOVE
"a" = (
/obj/effect/spawner/room/tenxfive,
/turf/open/floor/plating,
/area/space)
"f" = (
/obj/effect/spawner/room/fivexfour,
/turf/open/floor/plating,
/area/space)
"i" = (
/turf/closed/wall,
/area/space)
"j" = (
/obj/effect/mapping_helpers/airlock/abandoned,
/obj/machinery/door/airlock/maintenance_hatch{
	name = "Maintenance Hatch";
	req_access_txt = "12"
	},
/turf/open/floor/plating,
/area/space)
"w" = (
/obj/effect/spawner/room/tenxten,
/turf/open/floor/plating,
/area/space)
"x" = (
/obj/effect/spawner/room/threexfive,
/turf/open/floor/plating,
/area/space)
"z" = (
/obj/effect/spawner/room/fland,
/turf/closed/wall,
/area/space)
"C" = (
/turf/open/space/basic,
/area/space)
"K" = (
/turf/open/floor/plating,
/area/space)
"L" = (
/obj/effect/spawner/room/threexthree,
/turf/open/floor/plating,
/area/space)
"S" = (
/obj/effect/spawner/room/fivexthree,
/turf/open/floor/plating,
/area/space)

(1,1,1) = {"
i
i
j
i
i
C
i
i
i
j
i
i
i
C
i
i
i
i
i
j
j
i
i
i
i
i
"}
(2,1,1) = {"
i
K
K
L
i
C
i
K
K
K
K
a
i
C
i
K
K
K
K
K
K
K
K
K
w
i
"}
(3,1,1) = {"
j
K
K
K
j
C
i
K
K
K
K
K
i
C
i
K
K
K
K
K
K
K
K
K
K
i
"}
(4,1,1) = {"
i
K
K
K
i
C
i
K
K
K
K
K
i
C
i
K
K
K
K
K
K
K
K
K
K
i
"}
(5,1,1) = {"
i
i
j
i
i
C
i
K
K
K
K
K
i
C
i
K
K
K
K
K
K
K
K
K
K
i
"}
(6,1,1) = {"
C
C
C
C
C
C
j
K
K
K
K
K
j
C
j
K
K
K
K
K
K
K
K
K
K
j
"}
(7,1,1) = {"
i
i
j
i
i
C
j
K
K
K
K
K
j
C
j
K
K
K
K
K
K
K
K
K
K
j
"}
(8,1,1) = {"
i
K
K
S
i
C
i
K
K
K
K
K
i
C
i
K
K
K
K
K
K
K
K
K
K
i
"}
(9,1,1) = {"
i
K
K
K
i
C
i
K
K
K
K
K
i
C
i
K
K
K
K
K
K
K
K
K
K
i
"}
(10,1,1) = {"
j
K
K
K
j
C
i
K
K
K
K
K
i
C
i
K
K
K
K
K
K
K
K
K
K
i
"}
(11,1,1) = {"
i
K
K
K
i
C
i
K
K
K
K
K
i
C
i
K
K
K
K
K
K
K
K
K
K
i
"}
(12,1,1) = {"
i
K
K
K
i
C
i
i
i
j
i
i
i
C
i
i
i
i
i
j
j
i
i
i
i
i
"}
(13,1,1) = {"
i
i
j
i
i
C
C
C
C
C
C
C
C
C
C
C
C
C
C
C
C
C
C
C
C
C
"}
(14,1,1) = {"
C
C
C
C
C
C
C
C
i
i
j
i
i
i
C
i
i
i
i
i
i
i
i
i
i
C
"}
(15,1,1) = {"
i
i
i
j
i
i
i
C
i
K
K
K
f
i
C
i
K
K
K
K
K
K
K
K
z
C
"}
(16,1,1) = {"
i
K
K
K
K
x
i
C
i
K
K
K
K
i
C
K
K
K
K
K
K
K
K
K
K
C
"}
(17,1,1) = {"
j
K
K
K
K
K
j
C
j
K
K
K
K
j
C
K
K
K
K
K
K
K
K
K
i
C
"}
(18,1,1) = {"
i
K
K
K
K
K
i
C
i
K
K
K
K
i
C
i
K
K
K
K
K
K
K
K
i
C
"}
(19,1,1) = {"
i
i
i
j
i
i
i
C
i
K
K
K
K
i
C
i
i
i
i
i
i
i
i
i
i
C
"}
(20,1,1) = {"
C
C
C
C
C
C
C
C
i
i
j
i
i
i
C
C
C
C
C
C
C
C
C
C
C
C
"}
