//MAP CONVERTED BY dmm2tgm.py THIS HEADER COMMENT PREVENTS RECONVERSION, DO NOT REMOVE
"aa" = (
/obj/machinery/light/small{
	dir = 8
	},
/obj/machinery/airalarm/all_access{
	dir = 4;
	pixel_x = -24
	},
/obj/machinery/atmospherics/components/unary/vent_pump/on,
/obj/effect/decal/cleanable/dirt,
/turf/open/floor/pod/dark,
/area/shuttle/pirate)
"ab" = (
/obj/structure/table,
/obj/effect/decal/cleanable/dirt,
/obj/machinery/recharger,
/obj/effect/turf_decal/tile/red{
	dir = 1
	},
/obj/effect/turf_decal/tile/red,
/obj/effect/turf_decal/tile/red{
	dir = 8
	},
/turf/open/floor/plasteel/dark,
/area/shuttle/pirate)
"ad" = (
/obj/structure/table,
/obj/machinery/button/door{
	id = "piratebridge";
	name = "Bridge Shutters Control";
	pixel_y = -5
	},
/obj/item/radio/intercom{
	pixel_y = 5
	},
/obj/effect/decal/cleanable/dirt,
/obj/effect/turf_decal/tile/red,
/obj/effect/turf_decal/tile/red{
	dir = 4
	},
/obj/effect/turf_decal/tile/red{
	dir = 8
	},
/turf/open/floor/plasteel/dark,
/area/shuttle/pirate)
"ae" = (
/obj/effect/decal/cleanable/dirt,
/obj/effect/turf_decal/tile/red{
	dir = 1
	},
/turf/open/floor/plasteel/dark,
/area/shuttle/pirate)
"af" = (
/turf/template_noop,
/area/template_noop)
"ag" = (
/obj/structure/chair/fancy/shuttle{
	dir = 1
	},
/turf/open/floor/plasteel/dark,
/area/shuttle/pirate)
"ah" = (
/obj/effect/decal/cleanable/dirt,
/obj/effect/turf_decal/tile/red{
	dir = 4
	},
/turf/open/floor/plasteel/dark,
/area/shuttle/pirate)
"ai" = (
/obj/machinery/atmospherics/components/unary/vent_pump/on{
	dir = 1
	},
/obj/effect/decal/cleanable/dirt,
/obj/machinery/light/small,
/turf/open/floor/pod/dark,
/area/shuttle/pirate)
"aj" = (
/turf/closed/wall/mineral/plastitanium/nodiagonal,
/area/shuttle/pirate)
"ak" = (
/obj/machinery/airalarm/all_access{
	dir = 4;
	pixel_x = -24
	},
/obj/effect/decal/cleanable/dirt,
/obj/machinery/light/small{
	dir = 8
	},
/obj/effect/decal/cleanable/dirt,
/obj/effect/turf_decal/tile/bar,
/obj/effect/turf_decal/tile/bar{
	dir = 1
	},
/turf/open/floor/plasteel,
/area/shuttle/pirate)
"al" = (
/obj/machinery/loot_locator,
/obj/effect/decal/cleanable/dirt,
/obj/effect/turf_decal/tile/red{
	dir = 1
	},
/obj/effect/turf_decal/tile/red{
	dir = 4
	},
/obj/effect/turf_decal/tile/red{
	dir = 8
	},
/turf/open/floor/plasteel/dark,
/area/shuttle/pirate)
"am" = (
/obj/machinery/atmospherics/components/unary/vent_pump/on,
/obj/effect/turf_decal/tile/neutral{
	dir = 1
	},
/obj/effect/turf_decal/tile/neutral,
/obj/effect/turf_decal/tile/neutral{
	dir = 4
	},
/obj/effect/turf_decal/tile/neutral{
	dir = 8
	},
/turf/open/floor/plasteel/dark,
/area/shuttle/pirate)
"an" = (
/obj/structure/chair/fancy/shuttle{
	dir = 4
	},
/obj/machinery/button/door{
	id = "piratebridgebolt";
	name = "Bridge Bolt Control";
	normaldoorcontrol = 1;
	pixel_y = -24;
	specialfunctions = 4
	},
/obj/effect/turf_decal/tile/red,
/turf/open/floor/plasteel/dark,
/area/shuttle/pirate)
"ao" = (
/obj/machinery/light/small{
	dir = 4
	},
/obj/machinery/airalarm/all_access{
	dir = 8;
	pixel_x = 24
	},
/obj/machinery/atmospherics/components/unary/vent_pump/on,
/obj/effect/decal/cleanable/dirt,
/obj/item/reagent_containers/food/snacks/grown/wheat{
	pixel_x = 9
	},
/obj/item/reagent_containers/food/snacks/grown/wheat{
	pixel_x = -8;
	pixel_y = 6
	},
/obj/item/reagent_containers/food/snacks/grown/wheat{
	pixel_x = 6;
	pixel_y = 3
	},
/obj/item/reagent_containers/food/snacks/grown/wheat{
	pixel_x = -7;
	pixel_y = 1
	},
/obj/item/reagent_containers/food/snacks/grown/wheat{
	pixel_x = 2;
	pixel_y = -2
	},
/obj/item/reagent_containers/food/snacks/grown/wheat{
	pixel_x = -6;
	pixel_y = -3
	},
/turf/open/floor/grass,
/area/shuttle/pirate)
"aq" = (
/obj/structure/chair/stool,
/obj/machinery/atmospherics/components/unary/vent_pump/on{
	dir = 4
	},
/obj/effect/decal/cleanable/dirt,
/obj/effect/turf_decal/tile/bar,
/obj/effect/turf_decal/tile/bar{
	dir = 1
	},
/turf/open/floor/plasteel,
/area/shuttle/pirate)
"ar" = (
/obj/effect/decal/cleanable/dirt,
/obj/effect/decal/cleanable/dirt,
/obj/effect/turf_decal/tile/bar,
/obj/effect/turf_decal/tile/bar{
	dir = 1
	},
/obj/machinery/vending/cigarette/syndicate,
/turf/open/floor/plasteel,
/area/shuttle/pirate)
"au" = (
/obj/machinery/atmospherics/pipe/simple/supply/hidden,
/obj/machinery/door/airlock/engineering{
	name = "Engineering";
	req_access_txt = "180"
	},
/obj/effect/decal/cleanable/dirt,
/turf/open/floor/pod/dark,
/area/shuttle/pirate)
"aw" = (
/obj/machinery/atmospherics/pipe/simple/supply/hidden{
	dir = 5
	},
/obj/effect/decal/cleanable/dirt,
/obj/effect/turf_decal/tile/bar,
/obj/effect/turf_decal/tile/bar{
	dir = 1
	},
/turf/open/floor/plasteel,
/area/shuttle/pirate)
"ax" = (
/obj/machinery/firealarm{
	pixel_y = 24
	},
/obj/machinery/atmospherics/pipe/simple/supply/hidden{
	dir = 4
	},
/obj/effect/turf_decal/tile/bar,
/obj/effect/turf_decal/tile/bar{
	dir = 1
	},
/turf/open/floor/plasteel,
/area/shuttle/pirate)
"ay" = (
/obj/machinery/atmospherics/pipe/simple/supply/hidden{
	dir = 10
	},
/obj/effect/decal/cleanable/dirt,
/obj/effect/turf_decal/tile/bar,
/obj/effect/turf_decal/tile/bar{
	dir = 1
	},
/obj/structure/table,
/obj/machinery/chem_dispenser/drinks/beer/fullupgrade,
/turf/open/floor/plasteel,
/area/shuttle/pirate)
"az" = (
/obj/effect/decal/cleanable/dirt,
/obj/structure/table,
/obj/machinery/chem_dispenser/drinks/fullupgrade,
/obj/effect/turf_decal/tile/bar,
/obj/effect/turf_decal/tile/bar{
	dir = 1
	},
/turf/open/floor/plasteel,
/area/shuttle/pirate)
"aB" = (
/obj/machinery/light/small{
	dir = 4
	},
/obj/machinery/computer/monitor/secret{
	dir = 8
	},
/obj/effect/decal/cleanable/dirt,
/obj/machinery/airalarm/all_access{
	dir = 1;
	pixel_y = -24
	},
/obj/effect/turf_decal/tile/red{
	dir = 1
	},
/obj/effect/turf_decal/tile/red,
/obj/effect/turf_decal/tile/red{
	dir = 8
	},
/turf/open/floor/plasteel/dark,
/area/shuttle/pirate)
"aC" = (
/obj/machinery/shuttle_scrambler,
/obj/effect/decal/cleanable/dirt,
/obj/effect/turf_decal/tile/red{
	dir = 1
	},
/obj/effect/turf_decal/tile/red,
/obj/effect/turf_decal/tile/red{
	dir = 4
	},
/turf/open/floor/plasteel/dark,
/area/shuttle/pirate)
"aD" = (
/obj/effect/decal/cleanable/dirt,
/turf/open/floor/plating,
/area/shuttle/pirate)
"aG" = (
/obj/effect/turf_decal/stripes/line{
	dir = 1
	},
/obj/structure/cable{
	icon_state = "0-4"
	},
/obj/effect/decal/cleanable/dirt,
/obj/machinery/power/rtg/advanced{
	power_gen = 8000
	},
/turf/open/floor/plating,
/area/shuttle/pirate)
"aH" = (
/obj/structure/shuttle/engine/propulsion/left,
/turf/open/floor/plating/airless,
/area/shuttle/pirate)
"aI" = (
/obj/machinery/light/small{
	dir = 8
	},
/obj/structure/sign/warning/vacuum/external{
	pixel_x = -32
	},
/obj/effect/decal/cleanable/dirt,
/turf/open/floor/plating,
/area/shuttle/pirate)
"aK" = (
/obj/structure/shuttle/engine/propulsion,
/turf/open/floor/plating/airless,
/area/shuttle/pirate)
"aL" = (
/obj/machinery/atmospherics/pipe/manifold/supply/hidden{
	dir = 4
	},
/obj/effect/decal/cleanable/dirt,
/turf/open/floor/plating,
/area/shuttle/pirate)
"aM" = (
/obj/structure/closet/secure_closet/personal,
/obj/effect/decal/cleanable/dirt,
/obj/effect/turf_decal/stripes/line,
/turf/open/floor/wood,
/area/shuttle/pirate)
"aN" = (
/obj/machinery/light/small,
/obj/machinery/button/door{
	id = "pirateportexternal";
	name = "External Bolt Control";
	normaldoorcontrol = 1;
	pixel_x = -4;
	pixel_y = -24;
	specialfunctions = 4
	},
/obj/effect/turf_decal/stripes/corner{
	dir = 8
	},
/obj/effect/decal/cleanable/dirt,
/turf/open/floor/plating,
/area/shuttle/pirate)
"aO" = (
/obj/machinery/light/small,
/obj/machinery/button/door{
	id = "piratestarboardexternal";
	name = "External Bolt Control";
	normaldoorcontrol = 1;
	pixel_x = 4;
	pixel_y = -24;
	specialfunctions = 4
	},
/obj/effect/turf_decal/stripes/corner,
/obj/effect/decal/cleanable/dirt,
/turf/open/floor/plating,
/area/shuttle/pirate)
"aQ" = (
/obj/machinery/porta_turret/syndicate/pod{
	dir = 1;
	faction = list("pirate")
	},
/turf/closed/wall/mineral/plastitanium/nodiagonal,
/area/shuttle/pirate)
"aR" = (
/obj/machinery/porta_turret/syndicate/pod{
	faction = list("pirate")
	},
/turf/closed/wall/mineral/plastitanium,
/area/shuttle/pirate)
"aS" = (
/obj/effect/turf_decal/stripes/line,
/obj/effect/decal/cleanable/dirt,
/turf/open/floor/plating,
/area/shuttle/pirate)
"aU" = (
/obj/structure/sign/departments/engineering,
/turf/closed/wall/mineral/plastitanium/nodiagonal,
/area/shuttle/pirate)
"aV" = (
/obj/effect/mob_spawn/human/pirate{
	dir = 1
	},
/obj/effect/turf_decal/stripes/line,
/obj/effect/turf_decal/tile/neutral{
	dir = 1
	},
/obj/effect/turf_decal/tile/neutral,
/obj/effect/turf_decal/tile/neutral{
	dir = 4
	},
/obj/effect/turf_decal/tile/neutral{
	dir = 8
	},
/turf/open/floor/plasteel/dark,
/area/shuttle/pirate)
"aW" = (
/obj/machinery/light/small{
	dir = 8
	},
/obj/effect/decal/cleanable/dirt,
/obj/machinery/firealarm{
	dir = 1;
	pixel_y = -24
	},
/obj/effect/turf_decal/tile/red,
/obj/effect/turf_decal/tile/red{
	dir = 4
	},
/obj/effect/turf_decal/tile/red{
	dir = 8
	},
/obj/machinery/computer/camera_advanced/syndie{
	dir = 4
	},
/turf/open/floor/plasteel/dark,
/area/shuttle/pirate)
"be" = (
/obj/machinery/space_heater,
/obj/effect/turf_decal/bot,
/obj/machinery/atmospherics/pipe/simple/supply/hidden{
	dir = 4
	},
/obj/effect/decal/cleanable/dirt,
/obj/effect/decal/cleanable/oil,
/turf/open/floor/plating,
/area/shuttle/pirate)
"bg" = (
/obj/effect/turf_decal/stripes/line,
/obj/effect/decal/cleanable/dirt,
/obj/structure/table,
/obj/item/gun/energy/laser/retro,
/obj/item/gun/energy/laser/retro{
	pixel_x = -3;
	pixel_y = 6
	},
/obj/machinery/recharger,
/obj/machinery/turretid{
	icon_state = "control_kill";
	lethal = 1;
	locked = 0;
	pixel_y = 24;
	req_access = null;
	req_access_txt = "180"
	},
/turf/open/floor/pod/light,
/area/shuttle/pirate)
"bk" = (
/obj/effect/turf_decal/stripes/line{
	dir = 1
	},
/obj/machinery/power/smes/engineering{
	charge = 1e+006
	},
/obj/effect/decal/cleanable/dirt,
/obj/structure/cable/yellow,
/turf/open/floor/plating,
/area/shuttle/pirate)
"bl" = (
/obj/effect/turf_decal/stripes/line{
	dir = 6
	},
/obj/machinery/light/small{
	dir = 1
	},
/obj/machinery/airalarm/all_access{
	pixel_y = 24
	},
/obj/effect/decal/cleanable/dirt,
/obj/structure/table,
/obj/item/gun/energy/laser/retro{
	pixel_x = -3;
	pixel_y = 6
	},
/obj/item/gun/energy/laser/retro,
/turf/open/floor/pod/light,
/area/shuttle/pirate)
"bm" = (
/obj/machinery/atmospherics/pipe/simple/supply/hidden,
/turf/open/floor/pod/dark,
/area/shuttle/pirate)
"bo" = (
/obj/machinery/light/small{
	dir = 4
	},
/obj/structure/sign/warning/vacuum/external{
	pixel_x = 32
	},
/turf/open/floor/plating,
/area/shuttle/pirate)
"br" = (
/obj/structure/table/wood,
/obj/item/storage/box/matches,
/obj/item/reagent_containers/food/drinks/bottle/rum{
	name = "Captain Pete's Private Reserve Cuban Spaced Rum";
	pixel_x = -6;
	pixel_y = 8
	},
/obj/item/reagent_containers/food/drinks/drinkingglass/shotglass{
	pixel_x = 6;
	pixel_y = 12
	},
/obj/item/clothing/mask/cigarette/cigar,
/obj/effect/decal/cleanable/dirt,
/obj/effect/turf_decal/stripes/line,
/turf/open/floor/wood,
/area/shuttle/pirate)
"bt" = (
/obj/effect/turf_decal/stripes/line{
	dir = 10
	},
/obj/machinery/light/small{
	dir = 1
	},
/obj/machinery/firealarm{
	pixel_y = 24
	},
/obj/effect/decal/cleanable/dirt,
/obj/structure/table,
/obj/item/melee/transforming/energy/sword/pirate{
	pixel_x = -1;
	pixel_y = 6
	},
/obj/item/melee/transforming/energy/sword/pirate{
	pixel_x = 6;
	pixel_y = 6
	},
/obj/item/melee/transforming/energy/sword/pirate{
	pixel_x = 13;
	pixel_y = 6
	},
/turf/open/floor/pod/light,
/area/shuttle/pirate)
"bu" = (
/obj/machinery/firealarm{
	pixel_y = 24
	},
/obj/machinery/atmospherics/pipe/simple/supply/hidden{
	dir = 4
	},
/obj/effect/decal/cleanable/dirt,
/turf/open/floor/plasteel,
/area/shuttle/pirate)
"bv" = (
/obj/machinery/atmospherics/pipe/simple/supply/hidden{
	dir = 9
	},
/obj/effect/decal/cleanable/dirt,
/turf/open/floor/plasteel,
/area/shuttle/pirate)
"bx" = (
/obj/machinery/atmospherics/pipe/simple/supply/hidden{
	dir = 4
	},
/obj/effect/decal/cleanable/dirt,
/obj/effect/turf_decal/tile/bar,
/obj/effect/turf_decal/tile/bar{
	dir = 1
	},
/turf/open/floor/plasteel,
/area/shuttle/pirate)
"by" = (
/obj/machinery/atmospherics/pipe/manifold4w/supply/hidden,
/obj/effect/decal/cleanable/dirt,
/obj/machinery/piratepad,
/turf/open/floor/pod/dark,
/area/shuttle/pirate)
"bA" = (
/obj/machinery/atmospherics/pipe/simple/supply/hidden{
	dir = 4
	},
/turf/open/floor/pod/dark,
/area/shuttle/pirate)
"bB" = (
/obj/machinery/atmospherics/pipe/manifold/supply/hidden,
/obj/effect/decal/cleanable/dirt,
/turf/open/floor/plasteel,
/area/shuttle/pirate)
"bC" = (
/obj/machinery/airalarm/all_access{
	dir = 8;
	pixel_x = 24
	},
/obj/machinery/light/small{
	dir = 4
	},
/obj/machinery/atmospherics/pipe/manifold/supply/hidden{
	dir = 4
	},
/obj/effect/decal/cleanable/dirt,
/obj/effect/turf_decal/tile/neutral,
/turf/open/floor/plasteel,
/area/shuttle/pirate)
"bF" = (
/obj/effect/decal/cleanable/dirt,
/obj/structure/table,
/obj/machinery/microwave{
	pixel_y = 5
	},
/obj/effect/decal/cleanable/dirt,
/obj/effect/turf_decal/tile/bar,
/obj/effect/turf_decal/tile/bar{
	dir = 1
	},
/turf/open/floor/plasteel,
/area/shuttle/pirate)
"bH" = (
/obj/machinery/vending/boozeomat/all_access{
	onstation = 0
	},
/obj/effect/turf_decal/tile/bar,
/obj/effect/turf_decal/tile/bar{
	dir = 1
	},
/turf/open/floor/plasteel,
/area/shuttle/pirate)
"bI" = (
/obj/machinery/light/small,
/obj/machinery/computer/piratepad_control{
	dir = 1
	},
/turf/open/floor/pod/dark,
/area/shuttle/pirate)
"bJ" = (
/obj/machinery/atmospherics/pipe/manifold/supply/hidden{
	dir = 8
	},
/obj/effect/decal/cleanable/dirt,
/obj/effect/turf_decal/tile/neutral,
/obj/effect/turf_decal/tile/neutral{
	dir = 4
	},
/obj/effect/turf_decal/tile/neutral{
	dir = 8
	},
/turf/open/floor/plasteel,
/area/shuttle/pirate)
"bK" = (
/obj/effect/decal/cleanable/dirt,
/obj/structure/sink{
	pixel_y = 24
	},
/obj/structure/toilet{
	dir = 8
	},
/obj/machinery/light/small,
/obj/machinery/atmospherics/components/unary/vent_pump/on{
	dir = 8
	},
/turf/open/floor/plasteel/showroomfloor,
/area/shuttle/pirate)
"bO" = (
/obj/machinery/power/apc{
	aidisabled = 1;
	dir = 1;
	name = "Pirate Corvette APC";
	pixel_y = 24;
	req_access = null
	},
/obj/structure/reagent_dispensers/watertank,
/obj/effect/turf_decal/bot,
/obj/effect/decal/cleanable/dirt,
/obj/structure/cable/yellow{
	icon_state = "0-2"
	},
/turf/open/floor/plating,
/area/shuttle/pirate)
"bP" = (
/obj/machinery/atmospherics/components/unary/vent_pump/on{
	dir = 1
	},
/obj/effect/decal/cleanable/dirt,
/turf/open/floor/plating,
/area/shuttle/pirate)
"bQ" = (
/obj/effect/decal/cleanable/dirt,
/obj/structure/cable/yellow{
	icon_state = "1-2"
	},
/turf/open/floor/plating,
/area/shuttle/pirate)
"bX" = (
/obj/effect/decal/cleanable/dirt,
/obj/machinery/power/terminal{
	dir = 4
	},
/obj/structure/cable{
	icon_state = "0-8"
	},
/obj/effect/turf_decal/stripes/line{
	dir = 1
	},
/turf/open/floor/plating,
/area/shuttle/pirate)
"df" = (
/obj/machinery/porta_turret/syndicate/pod{
	dir = 4;
	faction = list("pirate")
	},
/turf/closed/wall/mineral/plastitanium,
/area/shuttle/pirate)
"dy" = (
/obj/structure/chair/wood/normal,
/obj/machinery/atmospherics/components/unary/vent_pump/on{
	dir = 1
	},
/obj/machinery/light/small{
	dir = 4
	},
/obj/effect/decal/cleanable/dirt,
/turf/open/floor/wood,
/area/shuttle/pirate)
"dU" = (
/obj/machinery/light/small{
	dir = 8
	},
/obj/machinery/atmospherics/components/unary/vent_pump/on{
	dir = 1
	},
/obj/effect/turf_decal/tile/neutral{
	dir = 1
	},
/obj/effect/turf_decal/tile/neutral,
/obj/effect/turf_decal/tile/neutral{
	dir = 4
	},
/obj/effect/turf_decal/tile/neutral{
	dir = 8
	},
/turf/open/floor/plasteel/dark,
/area/shuttle/pirate)
"ek" = (
/obj/effect/turf_decal/stripes/line,
/obj/effect/decal/cleanable/dirt,
/obj/structure/table,
/obj/structure/sign/poster/contraband/revolver{
	pixel_x = 32
	},
/obj/item/storage/backpack/duffelbag/syndie/x4{
	pixel_y = 8
	},
/obj/item/grenade/smokebomb{
	pixel_x = -5
	},
/obj/item/grenade/smokebomb{
	pixel_x = 5
	},
/obj/item/grenade/empgrenade,
/obj/item/grenade/empgrenade,
/obj/item/storage/backpack/duffelbag/syndie/c4,
/turf/open/floor/pod/light,
/area/shuttle/pirate)
"ep" = (
/obj/structure/window/reinforced{
	dir = 1;
	pixel_y = 1
	},
/obj/structure/shuttle/engine/heater,
/turf/open/floor/plating/airless,
/area/shuttle/pirate)
"er" = (
/obj/structure/shuttle/engine/propulsion/right,
/turf/open/floor/plating/airless,
/area/shuttle/pirate)
"ex" = (
/obj/effect/decal/cleanable/dirt,
/obj/structure/closet/secure_closet/freezer{
	locked = 0;
	name = "fridge"
	},
/obj/item/reagent_containers/food/condiment/milk,
/obj/item/reagent_containers/food/condiment/milk,
/obj/item/reagent_containers/food/condiment/milk,
/obj/item/reagent_containers/food/condiment/milk,
/obj/item/reagent_containers/food/condiment/milk,
/obj/item/reagent_containers/food/condiment/milk,
/obj/item/reagent_containers/food/condiment/milk,
/obj/item/reagent_containers/food/condiment/milk,
/obj/item/reagent_containers/food/condiment/milk,
/obj/item/reagent_containers/food/condiment/milk,
/turf/open/floor/plating/airless,
/area/shuttle/pirate)
"ey" = (
/obj/machinery/door/poddoor/shutters/preopen{
	id = "piratebridge"
	},
/obj/structure/grille,
/obj/structure/window/plastitanium,
/turf/open/floor/plating,
/area/shuttle/pirate)
"ez" = (
/obj/machinery/hydroponics/soil{
	self_sustaining = 1
	},
/obj/item/seeds/wheat,
/turf/open/floor/grass,
/area/shuttle/pirate)
"eA" = (
/obj/effect/decal/cleanable/dirt,
/obj/structure/closet/secure_closet/freezer{
	locked = 0;
	name = "fridge"
	},
/obj/item/reagent_containers/food/condiment/milk,
/obj/item/reagent_containers/food/condiment/milk,
/obj/item/reagent_containers/food/condiment/milk,
/obj/item/reagent_containers/food/condiment/milk,
/obj/item/reagent_containers/food/condiment/milk,
/obj/item/reagent_containers/food/condiment/milk,
/obj/item/reagent_containers/food/condiment/milk,
/obj/item/reagent_containers/food/condiment/milk,
/obj/item/reagent_containers/food/condiment/milk,
/obj/item/reagent_containers/food/condiment/milk,
/turf/open/floor/pod/dark,
/area/shuttle/pirate)
"eE" = (
/obj/machinery/atmospherics/pipe/simple/supply/hidden{
	dir = 6
	},
/obj/effect/decal/cleanable/dirt,
/turf/open/floor/plasteel,
/area/shuttle/pirate)
"fW" = (
/turf/closed/wall/mineral/plastitanium,
/area/shuttle/pirate)
"fY" = (
/obj/machinery/atmospherics/pipe/manifold/supply/hidden{
	dir = 1
	},
/turf/open/floor/pod/dark,
/area/shuttle/pirate)
"gL" = (
/obj/machinery/door/airlock/hatch{
	name = "Barn";
	req_access_txt = "180"
	},
/obj/machinery/atmospherics/pipe/simple/supply/hidden,
/obj/effect/decal/cleanable/dirt,
/turf/open/floor/pod/dark,
/area/shuttle/pirate)
"gY" = (
/obj/machinery/atmospherics/pipe/simple/supply/hidden{
	dir = 4
	},
/obj/effect/decal/cleanable/dirt,
/turf/open/floor/pod/dark,
/area/shuttle/pirate)
"jm" = (
/obj/machinery/door/airlock/external/glass{
	id_tag = "piratestarboardexternal";
	req_access_txt = "180"
	},
/obj/effect/mapping_helpers/airlock/cyclelink_helper{
	dir = 1
	},
/obj/docking_port/mobile/pirate{
	dwidth = 11;
	height = 16;
	launch_status = 0;
	movement_force = list("KNOCKDOWN" = 0, "THROW" = 0);
	name = "Pirate Ship";
	port_direction = 2;
	width = 17
	},
/obj/docking_port/stationary{
	dwidth = 11;
	height = 16;
	id = "pirateship_home";
	name = "Deep Space";
	width = 17
	},
/obj/structure/fans/tiny,
/turf/open/floor/plating,
/area/shuttle/pirate)
"jZ" = (
/obj/machinery/door/airlock/hatch{
	id_tag = "piratebridgebolt";
	name = "Bridge";
	req_access_txt = "180"
	},
/obj/machinery/atmospherics/pipe/simple/supply/hidden,
/obj/effect/turf_decal/tile/neutral{
	dir = 1
	},
/obj/effect/turf_decal/tile/neutral,
/obj/effect/turf_decal/tile/neutral{
	dir = 4
	},
/obj/effect/turf_decal/tile/neutral{
	dir = 8
	},
/turf/open/floor/plasteel/dark,
/area/shuttle/pirate)
"km" = (
/obj/effect/turf_decal/bot,
/obj/machinery/firealarm{
	pixel_y = 24
	},
/obj/effect/decal/cleanable/dirt,
/obj/machinery/atmospherics/pipe/simple/supply/hidden{
	dir = 4
	},
/obj/structure/rack,
/obj/item/multitool,
/obj/item/stack/sheet/mineral/plasma{
	amount = 10
	},
/obj/item/storage/box/lights/bulbs,
/obj/item/flashlight{
	pixel_x = 3;
	pixel_y = 3
	},
/obj/item/storage/toolbox/mechanical{
	pixel_y = 4
	},
/turf/open/floor/plating,
/area/shuttle/pirate)
"mD" = (
/obj/machinery/atmospherics/components/unary/vent_pump/on,
/obj/structure/closet/secure_closet/personal,
/obj/effect/decal/cleanable/dirt,
/turf/open/floor/plasteel,
/area/shuttle/pirate)
"np" = (
/obj/structure/reagent_dispensers/fueltank,
/obj/effect/turf_decal/bot,
/obj/machinery/airalarm/all_access{
	pixel_y = 24
	},
/obj/effect/decal/cleanable/dirt,
/turf/open/floor/plating,
/area/shuttle/pirate)
"oS" = (
/obj/structure/chair/fancy/shuttle{
	dir = 8
	},
/obj/effect/decal/cleanable/dirt,
/obj/effect/turf_decal/tile/red{
	dir = 8
	},
/turf/open/floor/plasteel/dark,
/area/shuttle/pirate)
"qL" = (
/obj/machinery/atmospherics/pipe/simple/supply/hidden,
/obj/machinery/door/airlock{
	name = "Crew Cabin";
	req_access_txt = "180"
	},
/obj/effect/decal/cleanable/dirt,
/obj/effect/turf_decal/tile/neutral{
	dir = 1
	},
/obj/effect/turf_decal/tile/neutral,
/obj/effect/turf_decal/tile/neutral{
	dir = 4
	},
/obj/effect/turf_decal/tile/neutral{
	dir = 8
	},
/turf/open/floor/plasteel/dark,
/area/shuttle/pirate)
"vB" = (
/obj/effect/turf_decal/stripes/line{
	dir = 9
	},
/obj/effect/decal/cleanable/dirt,
/obj/structure/rack{
	dir = 8;
	layer = 2.9
	},
/obj/item/ammo_box/magazine/m12g/breacher,
/obj/item/ammo_box/magazine/m12g/breacher,
/obj/item/ammo_box/magazine/m12g/slug,
/obj/item/ammo_box/magazine/m12g/slug,
/obj/item/ammo_box/magazine/m12g,
/obj/item/ammo_box/magazine/m12g,
/obj/item/ammo_box/magazine/m12g,
/obj/item/ammo_box/magazine/m12g,
/obj/item/gun/ballistic/shotgun/bulldog/unrestricted,
/turf/open/floor/pod/light,
/area/shuttle/pirate)
"wR" = (
/obj/machinery/porta_turret/syndicate/pod{
	dir = 8;
	faction = list("pirate")
	},
/turf/closed/wall/mineral/plastitanium,
/area/shuttle/pirate)
"xE" = (
/obj/effect/turf_decal/delivery,
/obj/effect/decal/cleanable/dirt,
/obj/machinery/power/port_gen/pacman{
	anchored = 1
	},
/turf/open/floor/plating,
/area/shuttle/pirate)
"CZ" = (
/obj/machinery/atmospherics/pipe/simple/supply/hidden{
	dir = 4
	},
/obj/machinery/door/airlock/hatch{
	name = "Armory Access";
	req_access_txt = "180"
	},
/obj/effect/decal/cleanable/dirt,
/turf/open/floor/pod/dark,
/area/shuttle/pirate)
"Gk" = (
/obj/effect/turf_decal/delivery,
/obj/effect/decal/cleanable/dirt,
/obj/machinery/atmospherics/components/unary/tank/air{
	dir = 4
	},
/turf/open/floor/plating,
/area/shuttle/pirate)
"IN" = (
/obj/machinery/door/airlock/external/glass{
	id_tag = "pirateportexternal";
	req_access_txt = "180"
	},
/obj/effect/mapping_helpers/airlock/cyclelink_helper{
	dir = 1
	},
/obj/structure/fans/tiny,
/turf/open/floor/plating,
/area/shuttle/pirate)
"Jm" = (
/obj/machinery/atmospherics/pipe/simple/supply/hidden,
/obj/machinery/door/airlock{
	name = "Captain's Quarters";
	req_access_txt = "180"
	},
/obj/effect/decal/cleanable/dirt,
/turf/open/floor/wood,
/area/shuttle/pirate)
"JT" = (
/obj/effect/turf_decal/stripes/line{
	dir = 5
	},
/obj/effect/decal/cleanable/dirt,
/obj/structure/rack{
	dir = 8;
	layer = 2.9
	},
/obj/item/restraints/handcuffs,
/obj/item/restraints/handcuffs,
/obj/item/restraints/handcuffs,
/obj/item/restraints/handcuffs,
/obj/item/restraints/handcuffs,
/obj/item/restraints/legcuffs/bola/tactical,
/obj/item/restraints/legcuffs/bola/tactical,
/obj/item/clothing/mask/muzzle,
/obj/item/clothing/mask/muzzle,
/obj/item/clothing/mask/muzzle,
/obj/item/clothing/mask/muzzle,
/turf/open/floor/pod/light,
/area/shuttle/pirate)
"MA" = (
/obj/machinery/door/airlock/external/glass{
	id_tag = "pirateportexternal";
	req_access_txt = "180"
	},
/obj/effect/mapping_helpers/airlock/cyclelink_helper,
/obj/effect/decal/cleanable/dirt,
/turf/open/floor/plating,
/area/shuttle/pirate)
"NE" = (
/obj/machinery/door/airlock{
	name = "The Poopdeck";
	req_access_txt = "180"
	},
/obj/effect/decal/cleanable/dirt,
/obj/machinery/atmospherics/pipe/simple/supply/hidden{
	dir = 4
	},
/turf/open/floor/plasteel/showroomfloor,
/area/shuttle/pirate)
"Oe" = (
/obj/machinery/atmospherics/pipe/manifold4w/supply/hidden,
/obj/effect/turf_decal/tile/bar,
/obj/effect/turf_decal/tile/bar{
	dir = 1
	},
/turf/open/floor/plasteel,
/area/shuttle/pirate)
"OD" = (
/obj/machinery/airalarm/all_access{
	pixel_y = 24
	},
/obj/structure/sign/poster/contraband/random{
	pixel_x = 32
	},
/obj/effect/turf_decal/tile/neutral{
	dir = 1
	},
/obj/effect/turf_decal/tile/neutral,
/obj/effect/turf_decal/tile/neutral{
	dir = 4
	},
/obj/effect/turf_decal/tile/neutral{
	dir = 8
	},
/turf/open/floor/plasteel/dark,
/area/shuttle/pirate)
"OL" = (
/obj/machinery/atmospherics/pipe/simple/supply/hidden,
/obj/effect/decal/cleanable/dirt,
/obj/effect/turf_decal/tile/bar,
/obj/effect/turf_decal/tile/bar{
	dir = 1
	},
/turf/open/floor/plasteel,
/area/shuttle/pirate)
"RY" = (
/obj/effect/mob_spawn/human/pirate/captain{
	dir = 4
	},
/obj/machinery/airalarm/all_access{
	pixel_y = 24
	},
/obj/effect/decal/cleanable/dirt,
/obj/structure/sign/poster/contraband/random{
	pixel_x = -32
	},
/turf/open/floor/wood,
/area/shuttle/pirate)
"RZ" = (
/obj/effect/decal/cleanable/dirt,
/mob/living/simple_animal/cow{
	atmos_requirements = list("min_oxy" = 0, "max_oxy" = 0, "min_tox" = 0, "max_tox" = 0, "min_co2" = 0, "max_co2" = 0, "min_n2" = 0, "max_n2" = 0);
	desc = "Stolen from a cow genetics lab, she can survive in a vacuum safely, her milk is also delicious!";
	name = "Ol Betsy"
	},
/turf/open/floor/grass,
/area/shuttle/pirate)
"Sk" = (
/obj/machinery/computer/shuttle_flight/pirate{
	req_access_txt = "180"
	},
/obj/effect/decal/cleanable/dirt,
/obj/effect/turf_decal/tile/red,
/obj/effect/turf_decal/tile/red{
	dir = 8
	},
/turf/open/floor/plasteel/dark,
/area/shuttle/pirate)
"Ur" = (
/obj/structure/closet/secure_closet/personal,
/obj/effect/decal/cleanable/dirt,
/obj/effect/turf_decal/tile/neutral,
/obj/effect/turf_decal/tile/neutral{
	dir = 8
	},
/turf/open/floor/plasteel,
/area/shuttle/pirate)
"WH" = (
/obj/machinery/door/airlock/hatch{
	name = "Milk Storage";
	req_access_txt = "180"
	},
/obj/machinery/atmospherics/pipe/simple/supply/hidden,
/obj/effect/decal/cleanable/dirt,
/turf/open/floor/pod/dark,
/area/shuttle/pirate)
"Zv" = (
/obj/machinery/door/airlock/external/glass{
	id_tag = "piratestarboardexternal";
	req_access_txt = "180"
	},
/obj/effect/mapping_helpers/airlock/cyclelink_helper,
/obj/effect/decal/cleanable/dirt,
/turf/open/floor/plating,
/area/shuttle/pirate)

(1,1,1) = {"
af
af
aj
fW
aj
aj
aj
aj
aj
aj
aj
wR
af
af
af
af
"}
(2,1,1) = {"
af
aj
aj
ex
eA
aa
WH
aw
ak
bF
aj
aj
aj
fW
af
af
"}
(3,1,1) = {"
aQ
aj
aj
aj
aj
aj
aj
ax
aq
ar
aj
RY
aM
ep
aH
af
"}
(4,1,1) = {"
af
af
af
af
af
af
ey
ay
Oe
OL
Jm
dy
br
ep
er
af
"}
(5,1,1) = {"
af
af
af
af
af
af
aj
az
bx
bH
aj
aj
aj
aj
aj
aR
"}
(6,1,1) = {"
af
af
af
ey
ey
aj
aj
aj
CZ
aj
aj
Gk
aS
MA
aI
IN
"}
(7,1,1) = {"
af
af
ey
ey
aC
aW
aj
bg
gY
JT
aj
km
aN
aj
aj
aj
"}
(8,1,1) = {"
af
af
ey
ab
ae
oS
aj
bl
fY
ai
aU
be
aD
aG
ep
aH
"}
(9,1,1) = {"
af
af
ey
Sk
ag
am
jZ
bm
by
bm
au
aL
bP
bX
ep
aK
"}
(10,1,1) = {"
af
af
ey
ad
ah
an
aj
bt
gY
bI
aj
bO
bQ
bk
ep
er
"}
(11,1,1) = {"
af
af
ey
ey
al
aB
aj
ek
bA
vB
aj
np
aO
aj
aj
aj
"}
(12,1,1) = {"
af
af
af
ey
ey
aj
aj
aj
CZ
aj
aj
xE
aS
Zv
bo
jm
"}
(13,1,1) = {"
af
af
af
af
af
af
aj
mD
bB
Ur
aj
aj
aj
aj
aj
aR
"}
(14,1,1) = {"
af
af
af
af
af
af
ey
eE
bC
bJ
qL
dU
aV
ep
aH
af
"}
(15,1,1) = {"
aQ
aj
aj
aj
aj
aj
aj
bu
aj
NE
aj
OD
aV
ep
er
af
"}
(16,1,1) = {"
af
aj
aj
ez
RZ
ao
gL
bv
aj
bK
aj
aj
aj
fW
af
af
"}
(17,1,1) = {"
af
af
aj
aj
aj
aj
aj
aj
aj
aj
aj
df
af
af
af
af
"}
