//MAP CONVERTED BY dmm2tgm.py THIS HEADER COMMENT PREVENTS RECONVERSION, DO NOT REMOVE
"a" = (
/turf/closed/wall/r_wall,
/area/ruin/unpowered)
"b" = (
/turf/open/lava/smooth/lava_land_surface,
/area/ruin/unpowered)
"c" = (
/obj/item/paper/fluff/stations/lavaland/sloth/note,
/turf/open/floor/sepia{
	slowdown = 10
	},
/area/ruin/unpowered)
"d" = (
/turf/open/floor/sepia{
	slowdown = 10
	},
/area/ruin/unpowered)
"e" = (
/obj/machinery/door/airlock/wood,
/turf/open/floor/sepia{
	slowdown = 10
	},
/area/ruin/unpowered)
"f" = (
/obj/structure/table/wood,
/obj/item/food/grown/citrus/orange,
/turf/open/floor/sepia{
	slowdown = 10
	},
/area/ruin/unpowered)
"g" = (
/obj/structure/bed,
/obj/item/bedsheet/brown,
/turf/open/floor/sepia{
	slowdown = 10
	},
/area/ruin/unpowered)

(1,1,1) = {"
b
b
b
b
b
b
b
b
b
b
b
b
b
b
b
b
b
b
b
"}
(2,1,1) = {"
b
a
a
a
a
a
a
a
a
a
a
a
a
a
a
a
a
a
b
"}
(3,1,1) = {"
b
a
d
d
d
d
d
d
d
d
d
d
d
d
d
d
d
a
b
"}
(4,1,1) = {"
b
a
d
a
a
a
a
a
a
a
a
a
a
a
a
a
d
a
b
"}
(5,1,1) = {"
b
a
d
a
d
d
d
d
d
d
d
d
d
d
d
a
d
a
b
"}
(6,1,1) = {"
b
a
d
a
d
a
a
a
a
a
a
a
a
a
d
a
d
a
b
"}
(7,1,1) = {"
b
a
d
a
d
a
d
d
d
d
d
d
d
a
d
a
d
a
b
"}
(8,1,1) = {"
b
a
d
a
d
a
d
a
a
a
a
a
d
a
d
a
d
a
b
"}
(9,1,1) = {"
b
a
d
a
d
a
d
a
f
d
d
a
d
a
d
a
d
a
b
"}
(10,1,1) = {"
b
a
d
a
d
a
d
a
d
c
d
a
d
a
d
a
d
e
b
"}
(11,1,1) = {"
b
a
d
a
d
a
d
a
g
d
d
a
d
a
d
a
a
a
b
"}
(12,1,1) = {"
b
a
d
a
d
a
d
a
a
a
d
a
d
a
d
d
d
a
b
"}
(13,1,1) = {"
b
a
d
a
d
a
d
d
d
d
d
a
d
a
a
a
d
a
b
"}
(14,1,1) = {"
b
a
d
a
d
a
a
a
a
a
a
a
d
d
d
a
d
a
b
"}
(15,1,1) = {"
b
a
d
a
d
d
d
d
d
d
d
d
d
d
d
a
d
a
b
"}
(16,1,1) = {"
b
a
d
a
a
a
a
a
a
a
a
a
a
a
a
a
d
a
b
"}
(17,1,1) = {"
b
a
d
d
d
d
d
d
d
d
d
d
d
d
d
d
d
a
b
"}
(18,1,1) = {"
b
a
a
a
a
a
a
a
a
a
a
a
a
a
a
a
a
a
b
"}
(19,1,1) = {"
b
b
b
b
b
b
b
b
b
b
b
b
b
b
b
b
b
b
b
"}
