"aa" = (/turf/closed/mineral/volcanic/lava_land_surface,/area/lavaland/surface/outdoors)
"ab" = (/turf/open/floor/plating/asteroid/basalt/lava_land_surface,/area/lavaland/surface/outdoors)
"ac" = (/obj/machinery/atmospherics/components/unary/tank/air{dir = 2},/turf/open/floor/plasteel/freezer,/area/ruin/powered/seedvault)
"ad" = (/obj/structure/table/wood,/obj/item/lighter,/obj/item/lighter,/obj/item/storage/fancy/rollingpapers,/obj/item/storage/fancy/rollingpapers,/obj/item/storage/fancy/rollingpapers,/obj/item/storage/fancy/rollingpapers,/turf/open/floor/plasteel/freezer,/area/ruin/powered/seedvault)
"ae" = (/obj/structure/table/wood,/obj/item/storage/box/disks_plantgene,/turf/open/floor/plasteel/freezer,/area/ruin/powered/seedvault)
"af" = (/obj/machinery/plantgenes/seedvault{pixel_y = 6},/obj/structure/table/wood,/turf/open/floor/plasteel/freezer,/area/ruin/powered/seedvault)
"ag" = (/obj/structure/table/wood,/obj/machinery/smartfridge/disks{pixel_y = 2},/turf/open/floor/plasteel/freezer,/area/ruin/powered/seedvault)
"ah" = (/turf/open/floor/plasteel/freezer,/area/ruin/powered/seedvault)
"ai" = (/obj/structure/closet/crate/hydroponics,/obj/structure/beebox,/obj/item/melee/flyswatter,/obj/item/honey_frame,/obj/item/honey_frame,/obj/item/honey_frame,/obj/item/queen_bee/bought,/obj/item/clothing/head/beekeeper_head,/obj/item/clothing/suit/beekeeper_suit,/turf/open/floor/plasteel/freezer,/area/ruin/powered/seedvault)
"aj" = (/obj/structure/shuttle/engine/propulsion{dir = 8},/turf/open/floor/plating/asteroid/basalt/lava_land_surface,/area/lavaland/surface/outdoors)
"ak" = (/obj/structure/closet/crate,/obj/effect/spawner/lootdrop/seed_vault,/turf/open/floor/plasteel/freezer,/area/ruin/powered/seedvault)
"al" = (/obj/machinery/door/airlock,/turf/open/floor/plasteel/freezer,/area/ruin/powered/seedvault)
"am" = (/obj/machinery/door/airlock/external,/obj/structure/fans/tiny,/obj/effect/mapping_helpers/airlock/cyclelink_helper{dir = 8},/turf/open/floor/plasteel/freezer,/area/ruin/powered/seedvault)
"an" = (/obj/machinery/smartfridge,/turf/open/floor/plasteel/freezer,/area/ruin/powered/seedvault)
"ap" = (/obj/machinery/hydroponics/constructable,/turf/open/floor/plasteel/freezer,/area/ruin/powered/seedvault)
"aq" = (/obj/item/hatchet,/obj/item/storage/bag/plants,/obj/item/reagent_containers/glass/bucket,/obj/structure/table/wood,/turf/open/floor/plasteel/freezer,/area/ruin/powered/seedvault)
"ar" = (/obj/structure/table/wood,/obj/item/storage/bag/plants,/obj/item/storage/bag/plants,/obj/item/storage/bag/plants,/obj/item/storage/bag/plants,/turf/open/floor/plasteel/freezer,/area/ruin/powered/seedvault)
"as" = (/obj/structure/table/wood,/obj/item/gun/energy/floragun,/obj/item/gun/energy/floragun,/obj/item/gun/energy/floragun,/obj/item/gun/energy/floragun,/obj/item/storage/box/disks_plantgene,/turf/open/floor/plasteel/freezer,/area/ruin/powered/seedvault)
"at" = (/obj/effect/mob_spawn/human/seed_vault,/turf/open/floor/plasteel/freezer,/area/ruin/powered/seedvault)
"au" = (/obj/structure/sink{dir = 8; pixel_x = -12; pixel_y = 2},/turf/open/floor/plasteel/freezer,/area/ruin/powered/seedvault)
"aw" = (/obj/machinery/vending/hydroseeds,/turf/open/floor/plasteel/freezer,/area/ruin/powered/seedvault)
"ax" = (/obj/machinery/reagentgrinder{pixel_y = 5},/obj/structure/table/glass,/obj/item/reagent_containers/glass/beaker/bluespace,/obj/item/reagent_containers/glass/beaker/bluespace,/obj/item/reagent_containers/glass/beaker/bluespace,/obj/item/reagent_containers/glass/beaker/bluespace,/turf/open/floor/plasteel/freezer,/area/ruin/powered/seedvault)
"ay" = (/obj/structure/sink{dir = 4; pixel_x = 11},/turf/open/floor/plasteel/freezer,/area/ruin/powered/seedvault)
"az" = (/obj/machinery/door/airlock/external,/obj/effect/mapping_helpers/airlock/cyclelink_helper{dir = 4},/turf/open/floor/plasteel/freezer,/area/ruin/powered/seedvault)
"aB" = (/obj/structure/disposalpipe/trunk,/obj/machinery/disposal/bin,/turf/open/floor/plasteel/freezer,/area/ruin/powered/seedvault)
"aC" = (/obj/machinery/seed_extractor,/turf/open/floor/plasteel/freezer,/area/ruin/powered/seedvault)
"aD" = (/obj/machinery/biogenerator,/turf/open/floor/plasteel/freezer,/area/ruin/powered/seedvault)
"aE" = (/obj/machinery/chem_dispenser/mutagensaltpeter,/turf/open/floor/plasteel/freezer,/area/ruin/powered/seedvault)
"aF" = (/obj/structure/disposalpipe/segment,/turf/open/floor/plasteel/freezer,/area/ruin/powered/seedvault)
"aG" = (/obj/structure/closet/crate/hydroponics,/obj/item/clothing/under/rank/hydroponics,/obj/item/clothing/under/rank/hydroponics,/obj/item/clothing/under/rank/hydroponics,/obj/item/clothing/under/rank/hydroponics,/turf/open/floor/plasteel/freezer,/area/ruin/powered/seedvault)
"aH" = (/obj/machinery/chem_master/condimaster,/turf/open/floor/plasteel/freezer,/area/ruin/powered/seedvault)
"aI" = (/obj/structure/table/wood,/obj/item/reagent_containers/glass/bucket,/obj/item/reagent_containers/glass/bucket,/obj/item/reagent_containers/glass/bucket,/obj/item/reagent_containers/glass/bucket,/turf/open/floor/plasteel/freezer,/area/ruin/powered/seedvault)
"aJ" = (/obj/item/storage/toolbox/syndicate,/obj/structure/table/wood,/turf/open/floor/plasteel/freezer,/area/ruin/powered/seedvault)
"aL" = (/obj/structure/disposalpipe/segment{dir = 5},/turf/open/floor/plating/asteroid/basalt/lava_land_surface,/area/lavaland/surface/outdoors)
"aM" = (/obj/structure/disposalpipe/trunk{dir = 8},/turf/open/floor/plating/asteroid/basalt/lava_land_surface,/area/lavaland/surface/outdoors)
"aN" = (/obj/structure/table/wood,/obj/item/storage/box/disks_plantgene,/obj/machinery/light{dir = 1},/turf/open/floor/plasteel/freezer,/area/ruin/powered/seedvault)
"aO" = (/obj/machinery/light{dir = 1},/turf/open/floor/plasteel/freezer,/area/ruin/powered/seedvault)
"aP" = (/obj/machinery/hydroponics/constructable,/obj/machinery/light{dir = 1},/turf/open/floor/plasteel/freezer,/area/ruin/powered/seedvault)
"aQ" = (/turf/closed/wall/r_wall,/area/ruin/powered/seedvault)
"aR" = (/obj/machinery/light{dir = 8},/turf/open/floor/plasteel/freezer,/area/ruin/powered/seedvault)
"aS" = (/obj/machinery/light{dir = 4},/turf/open/floor/plasteel/freezer,/area/ruin/powered/seedvault)
"aT" = (/obj/machinery/atmospherics/components/unary/outlet_injector/on/layer3{dir = 4; icon_state = "inje_map-3"; volume_rate = 200},/turf/open/floor/plating/asteroid/basalt/lava_land_surface,/area/ruin/powered/seedvault)
"aV" = (/obj/structure/disposalpipe/segment,/turf/closed/wall/r_wall,/area/ruin/powered/seedvault)
"aX" = (/obj/machinery/hydroponics/constructable,/obj/machinery/light,/turf/open/floor/plasteel/freezer,/area/ruin/powered/seedvault)
"bl" = (/obj/machinery/atmospherics/components/unary/vent_scrubber/on/layer3{dir = 1},/turf/open/floor/plasteel/freezer,/area/ruin/powered/seedvault)
"cb" = (/obj/machinery/atmospherics/components/unary/vent_scrubber/on/layer3{dir = 8},/turf/open/floor/plasteel/freezer,/area/ruin/powered/seedvault)
"gY" = (/obj/structure/closet/crate/hydroponics,/obj/item/cultivator,/obj/item/cultivator,/obj/item/cultivator,/obj/item/cultivator,/obj/item/shovel/spade,/obj/item/shovel/spade,/obj/item/shovel/spade,/obj/item/shovel/spade,/obj/item/hatchet,/obj/item/hatchet,/obj/item/hatchet,/obj/item/hatchet,/turf/open/floor/plasteel/freezer,/area/ruin/powered/seedvault)
"jc" = (/obj/machinery/atmospherics/pipe/simple/scrubbers/hidden/layer3{dir = 4},/turf/open/floor/plasteel/freezer,/area/ruin/powered/seedvault)
"jC" = (/obj/machinery/atmospherics/pipe/simple/scrubbers/hidden/layer3,/obj/machinery/light{dir = 4},/obj/machinery/atmospherics/pipe/simple/supply/hidden/layer1,/turf/open/floor/plasteel/freezer,/area/ruin/powered/seedvault)
"oN" = (/obj/machinery/atmospherics/pipe/manifold/scrubbers/hidden/layer3{dir = 4},/obj/machinery/atmospherics/pipe/manifold/supply/hidden/layer1{dir = 4},/turf/open/floor/plasteel/freezer,/area/ruin/powered/seedvault)
"qS" = (/obj/machinery/door/airlock,/obj/machinery/atmospherics/pipe/simple/scrubbers/hidden/layer3,/obj/machinery/atmospherics/pipe/simple/supply/hidden/layer1,/turf/open/floor/plasteel/freezer,/area/ruin/powered/seedvault)
"xR" = (/obj/machinery/atmospherics/pipe/simple/scrubbers/hidden/layer3{dir = 6},/obj/machinery/atmospherics/pipe/simple/supply/hidden/layer1{dir = 10},/turf/open/floor/plasteel/freezer,/area/ruin/powered/seedvault)
"Ay" = (/obj/machinery/light{dir = 8},/obj/machinery/atmospherics/pipe/simple/scrubbers/hidden/layer3{dir = 4},/obj/machinery/atmospherics/pipe/simple/supply/hidden/layer1{dir = 8},/turf/open/floor/plasteel/freezer,/area/ruin/powered/seedvault)
"Db" = (/obj/machinery/atmospherics/pipe/simple/scrubbers/hidden/layer3{dir = 4},/obj/machinery/atmospherics/pipe/simple/supply/hidden/layer1{dir = 8},/turf/open/floor/plasteel/freezer,/area/ruin/powered/seedvault)
"Dm" = (/obj/machinery/atmospherics/pipe/simple/scrubbers/hidden/layer3,/obj/machinery/atmospherics/components/unary/vent_pump/on/layer1{dir = 1},/turf/open/floor/plasteel/freezer,/area/ruin/powered/seedvault)
"HR" = (/obj/machinery/atmospherics/components/binary/valve,/turf/open/floor/plasteel/freezer,/area/ruin/powered/seedvault)
"Ia" = (/obj/machinery/atmospherics/pipe/simple/scrubbers/hidden/layer3{dir = 5},/turf/closed/wall/r_wall,/area/ruin/powered/seedvault)
"Le" = (/obj/machinery/door/airlock,/obj/machinery/atmospherics/pipe/manifold/scrubbers/hidden/layer3{dir = 1},/obj/machinery/atmospherics/pipe/manifold/supply/hidden/layer1{dir = 8},/turf/open/floor/plasteel/freezer,/area/ruin/powered/seedvault)
"LP" = (/obj/machinery/vending/hydronutrients,/obj/machinery/atmospherics/pipe/simple/scrubbers/hidden/layer3,/obj/machinery/atmospherics/pipe/simple/supply/hidden/layer1,/turf/open/floor/plasteel/freezer,/area/ruin/powered/seedvault)
"LW" = (/obj/machinery/atmospherics/pipe/layer_manifold,/turf/open/floor/plasteel/freezer,/area/ruin/powered/seedvault)
"Qb" = (/obj/machinery/atmospherics/pipe/simple/scrubbers/hidden/layer3{dir = 4},/obj/machinery/atmospherics/pipe/simple/supply/hidden/layer1{dir = 8},/turf/closed/wall/r_wall,/area/ruin/powered/seedvault)
"Wv" = (/obj/machinery/atmospherics/components/unary/vent_pump/on/layer1{dir = 1},/obj/machinery/atmospherics/pipe/simple/scrubbers/hidden/layer3{dir = 5},/turf/open/floor/plasteel/freezer,/area/ruin/powered/seedvault)
"Xd" = (/obj/machinery/atmospherics/pipe/simple/scrubbers/hidden/layer3{dir = 10},/turf/closed/wall/r_wall,/area/ruin/powered/seedvault)
"Xg" = (/obj/machinery/atmospherics/pipe/simple/scrubbers/hidden/layer3,/obj/machinery/atmospherics/pipe/simple/supply/hidden/layer1,/turf/open/floor/plasteel/freezer,/area/ruin/powered/seedvault)
"YG" = (/obj/machinery/atmospherics/components/unary/vent_pump/on/layer1{dir = 4},/turf/open/floor/plasteel/freezer,/area/ruin/powered/seedvault)

(1,1,1) = {"
aaaaababaaaaaaababaaaaabaaaaaaabaaaaaaaa
aaaaaaaaaaaaaaaaaaaaaaaaaaaaaaaaaaaaaaaa
aaaaaaaaaQaQaQaQaQaQaQaQaQaQababaaaaaaaa
aaaQaQaQaQadaNaeafagahaOaiaQaQajaaabaaab
aaaQacaQakahYGxRcbahahahahaiaQaQaaababab
aaaQHRaQaQaQaQqSaQaQaQaQaQaQaQajaaababab
aTXdLWaQangYaPXgapapaqaParasaQaQaaabaaaa
aQIaLeQbAyDbDboNahahahahahaSaQajaaababab
aQatjCaQauahapLPanawaxahahayaQaQaQababab
aQatDmalahahahXgahahahahapahazahamababab
aQatblalahahahWvjcjccbahapahazahamababab
aQataSaQauahapaBaCaDaEahahayaQaQaQababab
aQaQaQaQaRahahaFahahahahahaSaQajabababab
aaaaaQaQauaGaXaFakapaHaXaIaJaQaQabababab
aaaaaaaQaQaQaQaVaQaQaQaQaQaQaQajababaaaa
aaaaaaaaaaaaaaaLaMabaaaaaaaaaaaaaaaaaaaa
aaaaaaaaaaaaaaaaaaaaaaaaaaaaaaaaaaaaaaaa
aaaaaaaaaaaaaaaaaaaaaaaaaaaaaaaaaaaaabab
ababaaaaaaaaaaaaaaaaaaaaaaaaaaaaabababab
abababaaaaaaaaaaaaaaaaaaaaaaaaaaabababaa
"}
