//MAP CONVERTED BY dmm2tgm.py THIS HEADER COMMENT PREVENTS RECONVERSION, DO NOT REMOVE
"a" = (
/turf/closed/mineral/volcanic/lava_land_surface,
/area/lavaland/surface/outdoors)
"b" = (
/turf/closed/wall/mineral/sandstone,
/area/ruin/powered)
"c" = (
/turf/closed/wall/mineral/iron,
/area/ruin/powered)
"d" = (
/obj/item/clothing/head/helmet/space/orange,
/obj/item/clothing/mask/breath,
/turf/open/floor/plating/asteroid/basalt,
/area/ruin/powered)
"e" = (
/obj/item/clothing/suit/space/orange,
/turf/open/floor/plating/asteroid/basalt,
/area/ruin/powered)
"f" = (
/turf/open/floor/plating/asteroid/basalt,
/area/ruin/powered)
"g" = (
/turf/open/floor/plating/asteroid{
	name = "dirt"
	},
/area/ruin/powered)
"h" = (
/obj/item/shovel,
/turf/open/floor/plating/asteroid{
	name = "dirt"
	},
/area/ruin/powered)
"i" = (
/obj/item/reagent_containers/cup/bucket,
/turf/open/floor/plating/asteroid{
	name = "dirt"
	},
/area/ruin/powered)
"j" = (
/obj/structure/sink/puddle,
/turf/open/floor/plating/asteroid{
	name = "dirt"
	},
/area/ruin/powered)
"k" = (
/obj/structure/glowshroom/single,
/turf/open/floor/plating/asteroid{
	name = "dirt"
	},
/area/ruin/powered)
"m" = (
/obj/structure/rack,
/obj/item/seeds/reishi,
/obj/item/seeds/plump,
/obj/item/seeds/plump,
/obj/item/food/grown/mushroom/glowshroom,
/turf/open/floor/plating/asteroid/basalt,
/area/ruin/powered)
"n" = (
/obj/machinery/hydroponics/soil,
/turf/open/floor/plating,
/area/ruin/powered)
"o" = (
/turf/open/floor/plating,
/area/ruin/powered)
"p" = (
/obj/structure/rack,
/obj/item/storage/bag/plants/portaseeder,
/obj/item/storage/bag/ore,
/obj/item/storage/firstaid/regular,
/turf/open/floor/plating/asteroid/basalt,
/area/ruin/powered)
"q" = (
/obj/structure/glowshroom/single,
/turf/open/floor/plating,
/area/ruin/powered)
"r" = (
/obj/structure/rack,
/obj/item/pickaxe/emergency,
/obj/item/tank/internals/oxygen,
/turf/open/floor/plating/asteroid/basalt,
/area/ruin/powered)
"s" = (
/turf/open/floor/plating/asteroid/basalt/lava_land_surface,
/area/lavaland/surface/outdoors)
"t" = (
/turf/closed/wall/mineral/titanium/survival/pod,
/area/ruin/powered)
"u" = (
/obj/structure/bed/pod,
/obj/item/bedsheet/black,
/turf/open/floor/plating,
/area/ruin/powered)
"v" = (
/obj/structure/fans,
/turf/open/floor/pod/dark,
/area/ruin/powered)
"w" = (
/obj/machinery/smartfridge/survival_pod/preloaded,
/turf/open/floor/pod/dark,
/area/ruin/powered)
"x" = (
/obj/effect/mob_spawn/human/hermit,
/turf/open/floor/pod/dark,
/area/ruin/powered)
"y" = (
/turf/open/floor/pod/dark,
/area/ruin/powered)
"z" = (
/obj/machinery/light/small{
	dir = 4
	},
/obj/structure/tubes,
/turf/open/floor/plating,
/area/ruin/powered)
"A" = (
/obj/structure/table,
/obj/item/knife/combat/survival,
/turf/open/floor/plating,
/area/ruin/powered)
"B" = (
/obj/structure/table/survival_pod,
/turf/open/floor/pod/dark,
/area/ruin/powered)
"C" = (
/obj/structure/tubes,
/obj/item/crowbar,
/obj/effect/decal/cleanable/blood/drip,
/turf/open/floor/pod/dark,
/area/ruin/powered)
"D" = (
/obj/effect/decal/cleanable/blood/footprints{
	dir = 1
	},
/obj/machinery/door/airlock/survival_pod/glass,
/obj/structure/fans/tiny,
/turf/open/floor/pod/dark,
/area/ruin/powered)
"E" = (
/obj/structure/shuttle/engine/propulsion/burst{
	dir = 8
	},
/turf/closed/wall/mineral/titanium/interior,
/area/ruin/powered)
"F" = (
/turf/closed/wall/mineral/titanium,
/area/ruin/powered)
"G" = (
/turf/closed/wall/mineral/titanium/interior,
/area/ruin/powered)
"H" = (
/obj/machinery/door/airlock/titanium{
	name = "Escape Pod Airlock"
	},
/turf/open/floor/mineral/titanium/blue,
/area/ruin/powered)
"I" = (
/obj/structure/chair{
	dir = 4
	},
/turf/open/floor/mineral/titanium/blue,
/area/ruin/powered)
"J" = (
/turf/open/floor/mineral/titanium/blue,
/area/ruin/powered)
"M" = (
/obj/item/stack/sheet/iron/twenty,
/obj/item/storage/toolbox/emergency,
/turf/open/floor/plating/asteroid{
	name = "dirt"
	},
/area/ruin/powered)
"P" = (
/turf/closed/wall/rust,
/area/ruin/powered)
"Q" = (
/obj/effect/spawner/structure/window/reinforced/shuttle,
/turf/open/floor/pod/dark,
/area/ruin/powered)
"W" = (
/obj/machinery/portable_atmospherics/canister/oxygen,
/turf/open/floor/plating/asteroid/basalt,
/area/ruin/powered)

(1,1,1) = {"
a
a
a
a
a
a
a
a
s
s
s
s
s
s
s
s
"}
(2,1,1) = {"
a
a
a
a
a
a
a
a
a
a
s
s
s
s
s
s
"}
(3,1,1) = {"
a
a
a
a
a
a
a
a
a
a
s
s
s
s
s
s
"}
(4,1,1) = {"
a
a
a
a
a
a
a
a
a
a
a
s
s
s
s
s
"}
(5,1,1) = {"
a
a
a
a
a
c
b
b
t
t
t
t
t
s
s
s
"}
(6,1,1) = {"
a
a
a
a
c
c
n
n
t
v
x
B
t
s
s
s
"}
(7,1,1) = {"
a
a
a
b
c
m
o
o
t
w
y
y
D
s
s
s
"}
(8,1,1) = {"
a
c
c
c
c
f
o
q
o
o
z
C
Q
s
s
s
"}
(9,1,1) = {"
c
c
f
i
g
f
f
o
o
o
t
t
F
s
s
s
"}
(10,1,1) = {"
b
d
g
j
g
g
f
f
u
o
A
b
a
s
s
s
"}
(11,1,1) = {"
b
e
h
g
M
P
p
r
c
P
c
b
a
a
s
s
"}
(12,1,1) = {"
c
c
f
k
W
c
c
b
c
a
a
a
a
E
H
E
"}
(13,1,1) = {"
a
c
P
P
P
c
a
a
a
a
a
a
a
F
I
J
"}
(14,1,1) = {"
a
a
a
a
a
a
a
a
a
a
a
a
a
F
I
J
"}
(15,1,1) = {"
a
a
a
a
a
a
a
a
a
a
a
a
a
G
J
J
"}
(16,1,1) = {"
a
a
a
a
a
a
a
a
a
a
a
a
a
a
a
a
"}
