//MAP CONVERTED BY dmm2tgm.py THIS HEADER COMMENT PREVENTS RECONVERSION, DO NOT REMOVE
"aa" = (
/turf/template_noop,
/area/template_noop)
"ab" = (
/turf/closed/wall/mineral/titanium/survival,
/area/ruin/powered/golem_ship)
"ad" = (
/obj/structure/sign/mining,
/turf/closed/wall/mineral/titanium/survival,
/area/ruin/powered/golem_ship)
"ae" = (
/obj/machinery/light/small/broken{
	dir = 8;
	icon_state = "bulb-broken"
	},
/turf/template_noop,
/area/ruin/powered/golem_ship)
"af" = (
/turf/open/floor/plating,
/area/ruin/powered/golem_ship)
"ag" = (
/obj/structure/frame/machine,
/turf/open/floor/plating,
/area/ruin/powered/golem_ship)
"ah" = (
/obj/machinery/light/small{
	dir = 4;
	icon_state = "bulb"
	},
/turf/template_noop,
/area/ruin/powered/golem_ship)
"ai" = (
/obj/structure/ore_box,
/obj/effect/decal/cleanable/cobweb/cobweb2,
/turf/open/floor/plating,
/area/ruin/powered/golem_ship)
"aj" = (
/obj/machinery/light{
	dir = 1
	},
/obj/effect/decal/cleanable/oil,
/obj/effect/decal/cleanable/cobweb,
/obj/structure/table/reinforced,
/obj/item/storage/bag/plants,
/turf/open/floor/pod/dark,
/area/ruin/powered/golem_ship)
"ak" = (
/obj/effect/decal/cleanable/dirt,
/obj/structure/closet/golem_mining,
/turf/open/floor/pod/dark,
/area/ruin/powered/golem_ship)
"an" = (
/obj/structure/statue/gold/rd,
/obj/machinery/light/broken{
	dir = 1;
	icon_state = "tube-broken"
	},
/turf/open/floor/pod/dark,
/area/ruin/powered/golem_ship)
"ar" = (
/obj/machinery/light{
	dir = 1
	},
/obj/structure/table/reinforced,
/obj/effect/decal/cleanable/dirt,
/obj/effect/decal/cleanable/blood/gibs/up,
/obj/effect/decal/cleanable/cobweb/cobweb2,
/obj/item/areaeditor/blueprints{
	desc = "Use to build new structures in the wastes.";
	name = "land claim"
	},
/obj/item/disk/design_disk/golem_shell,
/turf/open/floor/pod/dark,
/area/ruin/powered/golem_ship)
"as" = (
/obj/structure/fans/tiny,
/obj/machinery/door/airlock/survival_pod,
/obj/effect/mapping_helpers/airlock/cyclelink_helper,
/obj/effect/decal/cleanable/cobweb,
/turf/open/floor/pod,
/area/ruin/powered/golem_ship)
"at" = (
/obj/structure/fans/tiny,
/obj/machinery/door/airlock/survival_pod,
/obj/effect/mapping_helpers/airlock/cyclelink_helper,
/turf/open/floor/pod,
/area/ruin/powered/golem_ship)
"au" = (
/obj/effect/decal/cleanable/dirt/dust,
/obj/effect/decal/cleanable/oil,
/obj/machinery/shower{
	pixel_y = 12
	},
/turf/open/floor/plating,
/area/ruin/powered/golem_ship)
"av" = (
/obj/effect/decal/cleanable/glass,
/turf/open/floor/plating,
/area/ruin/powered/golem_ship)
"aw" = (
/obj/effect/decal/cleanable/dirt/dust,
/obj/effect/decal/cleanable/glass,
/obj/effect/decal/cleanable/blood/drip,
/turf/open/floor/plating,
/area/ruin/powered/golem_ship)
"ax" = (
/obj/effect/decal/cleanable/dirt/dust,
/obj/effect/decal/cleanable/blood/drip,
/turf/open/floor/plating,
/area/ruin/powered/golem_ship)
"ay" = (
/obj/effect/decal/cleanable/blood/old,
/turf/open/floor/plating,
/area/ruin/powered/golem_ship)
"az" = (
/obj/structure/window/reinforced/survival_pod{
	dir = 8;
	icon_state = "pwindow"
	},
/obj/machinery/atmospherics/components/unary/shuttle/heater{
	dir = 8
	},
/turf/open/floor/plating,
/area/ruin/powered/golem_ship)
"aA" = (
/turf/template_noop,
/area/ruin/powered/golem_ship)
"aB" = (
/obj/effect/decal/cleanable/dirt,
/turf/open/floor/pod/dark,
/area/ruin/powered/golem_ship)
"aC" = (
/obj/effect/decal/cleanable/dirt,
/obj/effect/decal/cleanable/blood/old,
/turf/open/floor/pod,
/area/ruin/powered/golem_ship)
"aD" = (
/obj/effect/decal/cleanable/dirt,
/obj/effect/decal/cleanable/glass,
/turf/open/floor/pod,
/area/ruin/powered/golem_ship)
"aE" = (
/obj/structure/reagent_dispensers/fueltank,
/turf/open/floor/plating,
/area/ruin/powered/golem_ship)
"aF" = (
/obj/structure/ore_box,
/turf/open/floor/plating,
/area/ruin/powered/golem_ship)
"aG" = (
/obj/effect/decal/cleanable/dirt,
/obj/effect/decal/cleanable/oil,
/turf/open/floor/pod,
/area/ruin/powered/golem_ship)
"aH" = (
/obj/effect/decal/cleanable/dirt,
/obj/effect/decal/cleanable/shreds,
/turf/open/floor/pod,
/area/ruin/powered/golem_ship)
"aI" = (
/obj/effect/decal/cleanable/blood/drip,
/turf/open/floor/pod,
/area/ruin/powered/golem_ship)
"aJ" = (
/obj/effect/decal/cleanable/dirt,
/turf/open/floor/pod,
/area/ruin/powered/golem_ship)
"aK" = (
/obj/machinery/door/airlock/survival_pod,
/turf/open/floor/pod,
/area/ruin/powered/golem_ship)
"aL" = (
/turf/open/floor/pod,
/area/ruin/powered/golem_ship)
"aM" = (
/obj/machinery/door/airlock/survival_pod/glass,
/turf/open/floor/pod,
/area/ruin/powered/golem_ship)
"aN" = (
/obj/effect/decal/cleanable/dirt/dust,
/turf/open/floor/plating,
/area/ruin/powered/golem_ship)
"aO" = (
/obj/effect/decal/cleanable/shreds,
/obj/structure/cable{
	icon_state = "4-8"
	},
/turf/open/floor/plating,
/area/ruin/powered/golem_ship)
"aP" = (
/obj/effect/decal/cleanable/oil,
/turf/open/floor/plating,
/area/ruin/powered/golem_ship)
"aQ" = (
/obj/effect/decal/cleanable/dirt,
/obj/structure/table/reinforced,
/obj/item/stack/sheet/cotton/cloth/five,
/obj/item/knife/combat/survival,
/turf/open/floor/pod/dark,
/area/ruin/powered/golem_ship)
"aR" = (
/obj/effect/decal/cleanable/dirt,
/obj/structure/table/reinforced,
/obj/item/storage/firstaid/fire,
/obj/item/storage/firstaid/fire{
	pixel_x = 4;
	pixel_y = 4
	},
/turf/open/floor/pod/dark,
/area/ruin/powered/golem_ship)
"aS" = (
/obj/effect/decal/cleanable/dirt,
/obj/structure/closet/firecloset,
/turf/open/floor/pod/dark,
/area/ruin/powered/golem_ship)
"aT" = (
/obj/effect/decal/cleanable/dirt,
/obj/structure/table/reinforced,
/obj/item/bedsheet/rd/royal_cape{
	layer = 3;
	pixel_x = 5;
	pixel_y = 9
	},
/obj/item/book/manual/wiki/research_and_development{
	name = "Sacred Text of the Liberator";
	pixel_x = -5;
	pixel_y = 3
	},
/turf/open/floor/pod/dark,
/area/ruin/powered/golem_ship)
"aU" = (
/obj/machinery/light/small{
	dir = 8;
	icon_state = "bulb"
	},
/turf/open/floor/pod,
/area/ruin/powered/golem_ship)
"aV" = (
/obj/machinery/light/small{
	dir = 4;
	icon_state = "bulb"
	},
/obj/structure/extinguisher_cabinet{
	pixel_x = 22
	},
/obj/structure/cable{
	icon_state = "1-2"
	},
/turf/open/floor/pod,
/area/ruin/powered/golem_ship)
"aW" = (
/obj/structure/table/reinforced,
/obj/item/clothing/head/costume/pirate/bandana,
/obj/item/clothing/head/costume/pirate/bandana,
/obj/item/clothing/head/costume/pirate/bandana,
/obj/item/clothing/head/costume/crown,
/turf/open/floor/plating,
/area/ruin/powered/golem_ship)
"aX" = (
/obj/machinery/light,
/obj/structure/table/reinforced,
/obj/item/storage/bag/trash,
/obj/item/soap/nanotrasen,
/obj/item/soap/nanotrasen,
/turf/open/floor/plating,
/area/ruin/powered/golem_ship)
"aZ" = (
/obj/machinery/power/port_gen/pacman,
/obj/effect/decal/cleanable/dirt/dust,
/obj/structure/cable,
/turf/open/floor/plating,
/area/ruin/powered/golem_ship)
"ba" = (
/obj/effect/decal/cleanable/dirt/dust,
/obj/machinery/light/built,
/obj/structure/cable,
/obj/structure/frame/machine,
/turf/open/floor/plating,
/area/ruin/powered/golem_ship)
"bb" = (
/obj/structure/shuttle/engine/huge{
	dir = 4;
	icon_state = "huge_engine"
	},
/turf/open/floor/plating,
/area/ruin/powered/golem_ship)
"bc" = (
/obj/structure/fans/tiny,
/obj/machinery/door/airlock/survival_pod,
/obj/effect/mapping_helpers/airlock/cyclelink_helper{
	dir = 1;
	icon_state = "airlock_cyclelink_helper"
	},
/turf/open/floor/pod,
/area/ruin/powered/golem_ship)
"bd" = (
/obj/machinery/light/built{
	dir = 4;
	icon_state = "tube-empty"
	},
/turf/template_noop,
/area/ruin/powered/golem_ship)
"be" = (
/obj/structure/frame/machine,
/obj/effect/decal/cleanable/dirt,
/obj/effect/decal/cleanable/cobweb,
/turf/open/floor/pod/dark,
/area/ruin/powered/golem_ship)
"bf" = (
/obj/structure/frame/machine,
/obj/effect/decal/cleanable/dirt,
/turf/open/floor/pod/dark,
/area/ruin/powered/golem_ship)
"bi" = (
/obj/effect/decal/cleanable/dirt,
/obj/effect/decal/cleanable/oil,
/turf/open/floor/plating,
/area/ruin/powered/golem_ship)
"bj" = (
/turf/open/floor/pod/dark,
/area/ruin/powered/golem_ship)
"bk" = (
/obj/effect/decal/cleanable/dirt,
/obj/effect/decal/cleanable/blood/drip,
/turf/open/floor/pod/dark,
/area/ruin/powered/golem_ship)
"bl" = (
/obj/effect/decal/cleanable/dirt,
/obj/effect/decal/cleanable/greenglow,
/turf/open/floor/plating,
/area/ruin/powered/golem_ship)
"bm" = (
/obj/effect/decal/cleanable/dirt,
/turf/open/floor/plating,
/area/ruin/powered/golem_ship)
"bn" = (
/obj/effect/decal/cleanable/dirt,
/obj/effect/decal/cleanable/robot_debris,
/obj/effect/decal/cleanable/ash,
/turf/open/floor/plating,
/area/ruin/powered/golem_ship)
"bo" = (
/obj/effect/decal/cleanable/dirt,
/obj/effect/decal/cleanable/glass,
/turf/open/floor/pod/dark,
/area/ruin/powered/golem_ship)
"bp" = (
/obj/machinery/vendor/mining/golem,
/obj/effect/decal/cleanable/dirt,
/turf/open/floor/plating,
/area/ruin/powered/golem_ship)
"bq" = (
/obj/machinery/light{
	dir = 8
	},
/turf/template_noop,
/area/ruin/powered/golem_ship)
"br" = (
/obj/effect/decal/cleanable/vomit/old,
/turf/open/floor/carpet/purple,
/area/ruin/powered/golem_ship)
"bs" = (
/obj/structure/chair/office{
	dir = 1;
	icon_state = "officechair_dark"
	},
/obj/machinery/light{
	dir = 4;
	icon_state = "tube"
	},
/obj/effect/decal/cleanable/dirt,
/turf/open/floor/carpet/purple,
/area/ruin/powered/golem_ship)
"bt" = (
/obj/effect/mob_spawn/human/golem/adamantine,
/obj/machinery/light{
	dir = 8
	},
/turf/open/floor/carpet/purple,
/area/ruin/powered/golem_ship)
"bu" = (
/obj/effect/decal/cleanable/dirt,
/obj/effect/decal/cleanable/cobweb/cobweb2,
/obj/effect/mob_spawn/human/golem/adamantine,
/turf/open/floor/carpet/purple,
/area/ruin/powered/golem_ship)
"bv" = (
/obj/effect/decal/cleanable/glass,
/obj/machinery/light/broken{
	dir = 8;
	icon_state = "tube-broken"
	},
/obj/structure/cable{
	icon_state = "1-2"
	},
/turf/open/floor/pod/dark,
/area/ruin/powered/golem_ship)
"bx" = (
/obj/effect/decal/cleanable/dirt,
/obj/effect/decal/cleanable/glass,
/obj/structure/table/reinforced,
/turf/open/floor/pod/dark,
/area/ruin/powered/golem_ship)
"by" = (
/obj/effect/decal/cleanable/dirt,
/turf/open/floor/carpet/purple,
/area/ruin/powered/golem_ship)
"bA" = (
/obj/structure/frame/machine,
/obj/effect/decal/cleanable/dirt,
/turf/open/floor/plating,
/area/ruin/powered/golem_ship)
"bB" = (
/obj/machinery/mineral/ore_redemption,
/turf/open/floor/plating,
/area/ruin/powered/golem_ship)
"bC" = (
/obj/effect/decal/cleanable/blood/tracks{
	dir = 9;
	icon_state = "tracks"
	},
/turf/open/floor/pod/dark,
/area/ruin/powered/golem_ship)
"bD" = (
/obj/machinery/door/airlock/survival_pod,
/obj/effect/mapping_helpers/airlock/cyclelink_helper{
	dir = 4
	},
/obj/effect/decal/cleanable/blood/tracks{
	dir = 8;
	icon_state = "tracks"
	},
/turf/open/floor/pod,
/area/ruin/powered/golem_ship)
"bE" = (
/obj/machinery/light/small{
	dir = 1
	},
/obj/effect/decal/cleanable/dirt,
/obj/effect/decal/cleanable/blood/tracks{
	dir = 8;
	icon_state = "tracks"
	},
/turf/open/floor/pod,
/area/ruin/powered/golem_ship)
"bF" = (
/obj/structure/fans/tiny,
/obj/machinery/door/airlock/survival_pod,
/obj/effect/mapping_helpers/airlock/cyclelink_helper{
	dir = 8
	},
/obj/effect/decal/cleanable/blood/tracks{
	dir = 8;
	icon_state = "tracks"
	},
/obj/effect/decal/cleanable/cobweb/cobweb2,
/turf/open/floor/pod,
/area/ruin/powered/golem_ship)
"bG" = (
/obj/machinery/computer/shuttle_flight{
	dir = 4;
	icon_state = "computer-0"
	},
/obj/effect/decal/cleanable/dirt,
/turf/open/floor/pod/dark,
/area/ruin/powered/golem_ship)
"bH" = (
/obj/structure/chair/office{
	dir = 8;
	icon_state = "officechair_dark"
	},
/turf/open/floor/carpet/purple,
/area/ruin/powered/golem_ship)
"bL" = (
/obj/effect/decal/cleanable/dirt,
/obj/effect/decal/cleanable/blood/old,
/obj/structure/table/reinforced,
/obj/item/scalpel,
/obj/item/retractor,
/obj/item/hemostat,
/turf/open/floor/pod/dark,
/area/ruin/powered/golem_ship)
"bM" = (
/obj/structure/extinguisher_cabinet{
	pixel_x = 22
	},
/obj/effect/decal/cleanable/dirt,
/turf/open/floor/pod/dark,
/area/ruin/powered/golem_ship)
"bN" = (
/obj/effect/decal/cleanable/glass,
/obj/structure/table/reinforced,
/turf/open/floor/pod/dark,
/area/ruin/powered/golem_ship)
"bO" = (
/obj/effect/decal/cleanable/dirt,
/obj/effect/decal/cleanable/blood/drip,
/turf/open/floor/carpet/purple,
/area/ruin/powered/golem_ship)
"bQ" = (
/obj/item/resonator,
/obj/effect/decal/cleanable/shreds,
/turf/open/floor/carpet/purple,
/area/ruin/powered/golem_ship)
"bR" = (
/obj/machinery/modular_fabricator/autolathe,
/obj/effect/decal/cleanable/dirt,
/turf/open/floor/plating,
/area/ruin/powered/golem_ship)
"bS" = (
/obj/effect/decal/cleanable/dirt,
/obj/effect/decal/cleanable/ash,
/turf/open/floor/plating,
/area/ruin/powered/golem_ship)
"bT" = (
/obj/effect/decal/cleanable/dirt/dust,
/turf/open/floor/pod,
/area/ruin/powered/golem_ship)
"bU" = (
/obj/item/resonator/upgraded,
/turf/open/floor/plating,
/area/ruin/powered/golem_ship)
"bV" = (
/obj/machinery/door/airlock/survival_pod,
/obj/effect/mapping_helpers/airlock/cyclelink_helper{
	dir = 4
	},
/turf/open/floor/pod,
/area/ruin/powered/golem_ship)
"bW" = (
/obj/effect/decal/cleanable/vomit/old,
/obj/machinery/light/small/broken,
/turf/open/floor/pod,
/area/ruin/powered/golem_ship)
"bX" = (
/obj/structure/fans/tiny,
/obj/machinery/door/airlock/survival_pod,
/obj/effect/mapping_helpers/airlock/cyclelink_helper{
	dir = 8
	},
/turf/open/floor/pod,
/area/ruin/powered/golem_ship)
"bY" = (
/obj/structure/chair/office,
/obj/effect/decal/cleanable/glass,
/obj/machinery/light/broken{
	dir = 4;
	icon_state = "tube-broken"
	},
/turf/open/floor/carpet/purple,
/area/ruin/powered/golem_ship)
"bZ" = (
/obj/item/resonator,
/turf/open/floor/carpet/purple,
/area/ruin/powered/golem_ship)
"ca" = (
/obj/machinery/light{
	dir = 8
	},
/turf/open/floor/pod/dark,
/area/ruin/powered/golem_ship)
"cb" = (
/obj/effect/decal/cleanable/blood/drip,
/obj/effect/decal/cleanable/greenglow,
/turf/open/floor/pod,
/area/ruin/powered/golem_ship)
"cd" = (
/obj/machinery/light{
	dir = 4;
	icon_state = "tube"
	},
/turf/template_noop,
/area/ruin/powered/golem_ship)
"ce" = (
/obj/machinery/computer/monitor/secret{
	dir = 1;
	icon_state = "computer-0"
	},
/obj/effect/decal/cleanable/dirt,
/turf/open/floor/pod/dark,
/area/ruin/powered/golem_ship)
"cf" = (
/obj/effect/mob_spawn/human/golem/adamantine,
/turf/open/floor/carpet/purple,
/area/ruin/powered/golem_ship)
"cg" = (
/obj/structure/frame/computer{
	dir = 1;
	icon_state = "0"
	},
/turf/open/floor/plating,
/area/ruin/powered/golem_ship)
"ch" = (
/obj/effect/decal/cleanable/dirt,
/obj/effect/decal/cleanable/glass,
/turf/open/floor/plating,
/area/ruin/powered/golem_ship)
"ci" = (
/obj/machinery/light/broken{
	dir = 8;
	icon_state = "tube-broken"
	},
/turf/template_noop,
/area/ruin/powered/golem_ship)
"cj" = (
/obj/machinery/door/airlock/survival_pod,
/obj/effect/mapping_helpers/airlock/cyclelink_helper,
/obj/effect/decal/cleanable/cobweb/cobweb2,
/turf/open/floor/pod,
/area/ruin/powered/golem_ship)
"cl" = (
/obj/effect/decal/cleanable/dirt,
/obj/effect/decal/cleanable/oil,
/turf/open/floor/pod/dark,
/area/ruin/powered/golem_ship)
"cn" = (
/obj/effect/decal/cleanable/glass,
/turf/open/floor/pod/dark,
/area/ruin/powered/golem_ship)
"co" = (
/obj/machinery/light/small{
	dir = 8;
	icon_state = "bulb"
	},
/obj/structure/extinguisher_cabinet{
	pixel_x = -22
	},
/turf/open/floor/pod,
/area/ruin/powered/golem_ship)
"cp" = (
/obj/machinery/light/small/broken{
	dir = 4;
	icon_state = "bulb-broken"
	},
/turf/open/floor/pod,
/area/ruin/powered/golem_ship)
"cq" = (
/obj/effect/decal/cleanable/dirt,
/obj/structure/reagent_dispensers/watertank,
/turf/open/floor/plating,
/area/ruin/powered/golem_ship)
"cr" = (
/obj/machinery/light/broken{
	dir = 1;
	icon_state = "tube-broken"
	},
/obj/structure/reagent_dispensers/watertank,
/turf/open/floor/plating,
/area/ruin/powered/golem_ship)
"ct" = (
/obj/effect/decal/cleanable/dirt,
/obj/structure/rack,
/obj/item/storage/toolbox/mechanical,
/obj/item/storage/belt/utility,
/obj/item/storage/box/lights/mixed,
/turf/open/floor/plating,
/area/ruin/powered/golem_ship)
"cu" = (
/obj/effect/decal/cleanable/dirt,
/obj/machinery/light/broken{
	dir = 1;
	icon_state = "tube-broken"
	},
/obj/structure/reagent_dispensers/fueltank,
/turf/open/floor/plating,
/area/ruin/powered/golem_ship)
"cv" = (
/obj/structure/rack,
/obj/item/shovel/spade,
/obj/item/cultivator,
/turf/open/floor/plating,
/area/ruin/powered/golem_ship)
"cw" = (
/obj/structure/table/optable,
/obj/item/surgical_drapes,
/obj/effect/decal/cleanable/blood/gibs/old,
/turf/open/floor/pod/dark,
/area/ruin/powered/golem_ship)
"cx" = (
/obj/effect/decal/cleanable/blood/old,
/turf/open/floor/pod,
/area/ruin/powered/golem_ship)
"cy" = (
/obj/effect/decal/cleanable/dirt,
/obj/effect/decal/cleanable/glass,
/obj/effect/decal/cleanable/blood/old,
/turf/open/floor/pod,
/area/ruin/powered/golem_ship)
"cA" = (
/obj/structure/table/reinforced,
/obj/machinery/light/built,
/turf/open/floor/pod/dark,
/area/ruin/powered/golem_ship)
"cB" = (
/obj/structure/table/reinforced,
/obj/effect/decal/cleanable/dirt,
/obj/machinery/reagentgrinder,
/turf/open/floor/pod/dark,
/area/ruin/powered/golem_ship)
"cE" = (
/obj/machinery/light,
/turf/open/floor/pod/dark,
/area/ruin/powered/golem_ship)
"cF" = (
/obj/machinery/light,
/obj/effect/decal/cleanable/dirt,
/obj/effect/decal/cleanable/oil,
/turf/open/floor/pod/dark,
/area/ruin/powered/golem_ship)
"cG" = (
/obj/structure/fans/tiny,
/obj/machinery/door/airlock/survival_pod,
/obj/effect/mapping_helpers/airlock/cyclelink_helper{
	dir = 1;
	icon_state = "airlock_cyclelink_helper"
	},
/obj/effect/decal/cleanable/cobweb,
/turf/open/floor/pod,
/area/ruin/powered/golem_ship)
"cH" = (
/obj/effect/decal/cleanable/blood/drip,
/turf/open/floor/plating,
/area/ruin/powered/golem_ship)
"cI" = (
/obj/effect/decal/cleanable/shreds,
/obj/effect/decal/cleanable/blood/drip,
/turf/open/floor/plating,
/area/ruin/powered/golem_ship)
"cJ" = (
/obj/machinery/light/small{
	dir = 8;
	icon_state = "bulb"
	},
/turf/template_noop,
/area/ruin/powered/golem_ship)
"cK" = (
/obj/machinery/light/small/broken{
	dir = 4;
	icon_state = "bulb-broken"
	},
/turf/template_noop,
/area/ruin/powered/golem_ship)
"cT" = (
/obj/effect/decal/cleanable/dirt,
/obj/structure/chair/stool,
/turf/open/floor/pod/dark,
/area/ruin/powered/golem_ship)
"eo" = (
/obj/structure/window/shuttle/survival_pod/spawner,
/turf/open/floor/plating,
/area/ruin/powered/golem_ship)
"gg" = (
/obj/effect/decal/cleanable/dirt,
/obj/effect/decal/cleanable/oil,
/obj/structure/cable{
	icon_state = "2-4"
	},
/turf/open/floor/plating,
/area/ruin/powered/golem_ship)
"gm" = (
/obj/effect/decal/cleanable/dirt,
/obj/effect/decal/cleanable/blood/old,
/obj/item/crowbar,
/turf/open/floor/pod,
/area/ruin/powered/golem_ship)
"gw" = (
/obj/effect/decal/cleanable/dirt,
/obj/structure/table/reinforced,
/obj/item/circular_saw,
/obj/item/cautery,
/obj/item/surgicaldrill,
/turf/open/floor/pod/dark,
/area/ruin/powered/golem_ship)
"iN" = (
/obj/machinery/door/airlock/survival_pod/glass,
/obj/structure/cable{
	icon_state = "4-8"
	},
/turf/open/floor/pod,
/area/ruin/powered/golem_ship)
"jC" = (
/obj/effect/decal/cleanable/dirt,
/obj/effect/decal/cleanable/blood/old,
/obj/machinery/light{
	dir = 4;
	icon_state = "tube"
	},
/turf/open/floor/pod/dark,
/area/ruin/powered/golem_ship)
"jK" = (
/obj/effect/spawner/randomarcade{
	dir = 1
	},
/turf/open/floor/pod/dark,
/area/ruin/powered/golem_ship)
"jN" = (
/obj/effect/decal/cleanable/oil,
/obj/structure/cable{
	icon_state = "2-8"
	},
/turf/open/floor/plating,
/area/ruin/powered/golem_ship)
"kb" = (
/obj/effect/decal/cleanable/dirt,
/obj/structure/closet/emcloset,
/turf/open/floor/pod/dark,
/area/ruin/powered/golem_ship)
"kO" = (
/obj/effect/decal/cleanable/dirt/dust,
/obj/structure/cable{
	icon_state = "4-8"
	},
/turf/open/floor/plating,
/area/ruin/powered/golem_ship)
"kT" = (
/obj/structure/table/reinforced,
/obj/item/storage/firstaid/brute,
/obj/item/storage/firstaid/brute{
	pixel_x = 4;
	pixel_y = 4
	},
/turf/open/floor/pod/dark,
/area/ruin/powered/golem_ship)
"lx" = (
/obj/structure/cable{
	icon_state = "4-8"
	},
/turf/open/floor/pod/dark,
/area/ruin/powered/golem_ship)
"mn" = (
/obj/effect/decal/cleanable/dirt,
/obj/effect/decal/cleanable/blood/drip,
/obj/structure/cable{
	icon_state = "1-8"
	},
/turf/open/floor/pod/dark,
/area/ruin/powered/golem_ship)
"se" = (
/obj/effect/decal/cleanable/dirt,
/obj/structure/sink{
	dir = 4;
	pixel_x = 11
	},
/turf/open/floor/pod/dark,
/area/ruin/powered/golem_ship)
"sA" = (
/obj/structure/cable{
	icon_state = "2-8"
	},
/obj/structure/cable{
	icon_state = "4-8"
	},
/turf/open/floor/plating,
/area/ruin/powered/golem_ship)
"ti" = (
/obj/effect/decal/cleanable/dirt,
/obj/machinery/power/apc/auto_name/directional/west,
/obj/effect/mapping_helpers/apc/discharged,
/turf/open/floor/pod/dark,
/area/ruin/powered/golem_ship)
"uc" = (
/obj/structure/frame/machine,
/turf/open/floor/pod/dark,
/area/ruin/powered/golem_ship)
"xx" = (
/obj/machinery/door/airlock/survival_pod,
/obj/effect/mapping_helpers/airlock/cyclelink_helper{
	dir = 1;
	icon_state = "airlock_cyclelink_helper"
	},
/turf/open/floor/pod,
/area/ruin/powered/golem_ship)
"zp" = (
/obj/effect/decal/cleanable/dirt,
/obj/item/stack/cable_coil/red,
/turf/open/floor/plating,
/area/ruin/powered/golem_ship)
"zy" = (
/obj/machinery/computer/operating,
/turf/open/floor/pod/dark,
/area/ruin/powered/golem_ship)
"CX" = (
/obj/machinery/door/airlock/survival_pod,
/obj/effect/mapping_helpers/airlock/cyclelink_helper{
	dir = 1;
	icon_state = "airlock_cyclelink_helper"
	},
/obj/structure/cable{
	icon_state = "1-2"
	},
/turf/open/floor/pod,
/area/ruin/powered/golem_ship)
"Ec" = (
/obj/effect/decal/cleanable/cobweb,
/obj/effect/mob_spawn/human/golem/adamantine,
/obj/machinery/light{
	dir = 8
	},
/turf/open/floor/carpet/purple,
/area/ruin/powered/golem_ship)
"Es" = (
/obj/item/stack/sheet/mineral/plasma/five,
/turf/open/floor/pod,
/area/ruin/powered/golem_ship)
"HR" = (
/obj/structure/chair/stool,
/turf/open/floor/pod/dark,
/area/ruin/powered/golem_ship)
"JJ" = (
/obj/item/storage/toolbox/mechanical,
/obj/structure/cable{
	icon_state = "4-8"
	},
/obj/structure/cable{
	icon_state = "2-8"
	},
/turf/open/floor/plating,
/area/ruin/powered/golem_ship)
"JV" = (
/obj/effect/decal/cleanable/dirt,
/obj/item/resonator,
/turf/open/floor/carpet/purple,
/area/ruin/powered/golem_ship)
"KR" = (
/obj/structure/cable{
	icon_state = "2-4"
	},
/turf/open/floor/pod,
/area/ruin/powered/golem_ship)
"Qs" = (
/obj/effect/decal/cleanable/dirt,
/obj/structure/frame/machine,
/turf/open/floor/plating,
/area/ruin/powered/golem_ship)
"Rr" = (
/obj/effect/decal/cleanable/dirt,
/obj/effect/spawner/randomarcade{
	dir = 1
	},
/turf/open/floor/pod/dark,
/area/ruin/powered/golem_ship)
"TF" = (
/obj/effect/decal/cleanable/dirt,
/obj/structure/table/reinforced,
/obj/item/storage/firstaid,
/obj/item/storage/firstaid{
	pixel_y = 4;
	pixel_x = 4
	},
/turf/open/floor/pod/dark,
/area/ruin/powered/golem_ship)
"UI" = (
/obj/machinery/door/airlock/survival_pod,
/obj/effect/mapping_helpers/airlock/cyclelink_helper,
/turf/open/floor/pod,
/area/ruin/powered/golem_ship)
"VW" = (
/obj/structure/cable{
	icon_state = "4-8"
	},
/turf/open/floor/plating,
/area/ruin/powered/golem_ship)

(1,1,1) = {"
aa
ab
ab
ab
ab
ab
aa
aa
aa
aa
aa
aa
aa
ab
ab
ab
ab
ab
aa
"}
(2,1,1) = {"
aa
ab
aj
aB
aQ
ab
aa
aa
aa
aa
aa
aa
aa
ab
uc
uc
cA
ab
aa
"}
(3,1,1) = {"
aa
eo
ak
aC
aR
ab
bd
eo
eo
eo
eo
eo
cd
ab
cl
cx
cB
eo
aa
"}
(4,1,1) = {"
aa
eo
ak
aD
kT
ab
ad
eo
bx
bG
bN
eo
ad
ab
bo
aL
aB
eo
aa
"}
(5,1,1) = {"
aa
eo
ak
aG
TF
ab
be
br
by
bH
bO
by
bf
ab
cn
aL
bj
eo
aa
"}
(6,1,1) = {"
aa
ad
an
aH
aS
ab
bf
bs
aC
aL
bT
bY
ce
ab
gw
aL
cE
ad
aa
"}
(7,1,1) = {"
aa
eo
ak
aI
kb
ab
ab
ab
ab
aM
ab
ab
ab
ab
bL
aJ
bj
eo
aa
"}
(8,1,1) = {"
aa
eo
ak
aD
HR
jK
ab
Ec
bZ
aL
bQ
bt
ab
cw
bj
cy
bj
eo
aa
"}
(9,1,1) = {"
aa
eo
ak
aJ
cT
Rr
ab
bu
JV
gm
bZ
cf
ab
zy
bo
aL
cl
eo
aa
"}
(10,1,1) = {"
aa
ab
ar
aB
aT
ab
ab
ab
ab
aM
ab
ab
ab
ab
se
aB
cF
ab
aa
"}
(11,1,1) = {"
aa
ab
ab
aK
ab
ab
gg
bv
ti
aB
aB
ca
af
ab
ab
aK
ab
ab
aa
"}
(12,1,1) = {"
aa
ae
as
aL
aU
xx
lx
aJ
bA
aJ
bR
cb
bj
UI
co
aH
cG
cJ
aa
"}
(13,1,1) = {"
aa
ah
at
KR
aV
CX
mn
aJ
aL
aJ
aJ
aL
aB
cj
cp
aJ
bc
cK
aa
"}
(14,1,1) = {"
aa
ab
ab
iN
ab
ab
bl
aJ
aP
aJ
bS
aL
cg
ab
ab
aM
ab
ab
aa
"}
(15,1,1) = {"
ab
ab
au
VW
aW
ab
bm
aL
av
aL
bA
aL
bm
ab
cq
af
cH
ab
ab
"}
(16,1,1) = {"
ab
aF
af
kO
aX
ab
bn
aI
aD
aJ
bT
aL
aP
ab
cr
bi
Qs
ag
ab
"}
(17,1,1) = {"
ab
aF
av
aO
aN
ab
aB
aL
bB
Es
bU
bT
bj
ab
cv
bm
cI
af
ab
"}
(18,1,1) = {"
eo
aF
aw
sA
aZ
ab
bo
aB
bC
jC
aB
bj
bk
ab
ct
cH
ag
af
eo
"}
(19,1,1) = {"
ab
aF
ax
JJ
ba
ab
bp
ab
bD
ab
bV
ab
ch
ab
cu
af
zp
af
ab
"}
(20,1,1) = {"
ab
ai
ay
jN
aZ
ab
ad
ab
bE
bM
bW
ab
ad
ab
aE
bm
bi
ag
ab
"}
(21,1,1) = {"
ab
ab
az
az
az
ab
bq
ab
bF
ab
bX
ab
ci
ab
az
az
az
ab
ab
"}
(22,1,1) = {"
aa
ab
af
af
bb
ab
aa
aa
aa
aa
aa
aa
aa
ab
af
af
bb
ab
aa
"}
(23,1,1) = {"
aa
aa
af
af
af
aa
aa
aa
aa
aa
aa
aa
aa
aa
af
af
af
aa
aa
"}
(24,1,1) = {"
aa
aa
aA
aA
aA
aa
aa
aa
aa
aa
aa
aa
aa
aa
aA
aA
aA
aa
aa
"}
