//MAP CONVERTED BY dmm2tgm.py THIS HEADER COMMENT PREVENTS RECONVERSION, DO NOT REMOVE
"a" = (
/turf/template_noop,
/area/template_noop)
"b" = (
/turf/open/floor/plating/asteroid/basalt/lava_land_surface,
/area/lavaland/surface/outdoors)
"c" = (
/obj/structure/sign/mining/survival{
	pixel_y = 32;
	dir = 1
	},
/turf/open/floor/plating/asteroid/basalt/lava_land_surface,
/area/lavaland/surface/outdoors)
"d" = (
/turf/closed/wall/mineral/titanium/survival/pod,
/area/ruin/powered)
"e" = (
/obj/structure/sign/mining/survival{
	dir = 4;
	pixel_x = 32
	},
/turf/open/floor/plating/asteroid/basalt/lava_land_surface,
/area/lavaland/surface/outdoors)
"f" = (
/obj/structure/fans{
	dir = 1
	},
/turf/open/floor/pod/dark,
/area/ruin/powered)
"g" = (
/obj/machinery/smartfridge/survival_pod/empty{
	dir = 1
	},
/turf/open/floor/pod/dark,
/area/ruin/powered)
"h" = (
/obj/item/gps/computer{
	dir = 1
	},
/obj/structure/tubes{
	dir = 1
	},
/turf/open/floor/pod/dark,
/area/ruin/powered)
"i" = (
/obj/structure/sign/mining/survival{
	dir = 8;
	pixel_x = -32
	},
/turf/open/floor/plating/asteroid/basalt/lava_land_surface,
/area/lavaland/surface/outdoors)
"j" = (
/obj/effect/decal/cleanable/blood/drip{
	dir = 4
	},
/turf/open/floor/plating/asteroid/basalt/lava_land_surface,
/area/lavaland/surface/outdoors)
"k" = (
/obj/machinery/sleeper/survival_pod{
	dir = 1
	},
/turf/open/floor/pod/dark,
/area/ruin/powered)
"l" = (
/obj/item/pickaxe{
	dir = 1
	},
/obj/effect/decal/cleanable/blood{
	dir = 4
	},
/turf/open/floor/pod/dark,
/area/ruin/powered)
"m" = (
/obj/structure/bed/pod{
	dir = 1
	},
/obj/item/bedsheet/black{
	dir = 1
	},
/obj/structure/tubes{
	dir = 1
	},
/obj/machinery/light/small{
	dir = 4
	},
/turf/open/floor/pod/dark,
/area/ruin/powered)
"n" = (
/obj/effect/decal/cleanable/blood{
	dir = 4
	},
/turf/open/floor/plating/asteroid/basalt/lava_land_surface,
/area/lavaland/surface/outdoors)
"o" = (
/obj/effect/decal/cleanable/blood{
	dir = 4
	},
/mob/living/simple_animal/hostile/asteroid/goliath/beast{
	health = 0
	},
/turf/open/floor/plating/asteroid/basalt/lava_land_surface,
/area/lavaland/surface/outdoors)
"p" = (
/obj/structure/table/survival_pod{
	dir = 1
	},
/obj/item/kitchen/knife/combat/survival{
	dir = 1
	},
/turf/open/floor/pod/dark,
/area/ruin/powered)
"q" = (
/obj/effect/mob_spawn/human/miner/explorer{
	brute_damage = 150;
	oxy_damage = 50;
	dir = 1
	},
/obj/effect/decal/cleanable/blood{
	dir = 4
	},
/obj/effect/decal/cleanable/blood/drip{
	dir = 4
	},
/obj/effect/decal/cleanable/blood/footprints{
	dir = 8
	},
/turf/open/floor/pod/dark,
/area/ruin/powered)
"r" = (
/obj/structure/tubes{
	dir = 1
	},
/obj/item/crowbar{
	dir = 1
	},
/obj/effect/decal/cleanable/blood/drip{
	dir = 4
	},
/turf/open/floor/pod/dark,
/area/ruin/powered)
"s" = (
/obj/effect/decal/cleanable/blood/footprints{
	dir = 4
	},
/turf/open/floor/plating/asteroid/basalt/lava_land_surface,
/area/lavaland/surface/outdoors)
"t" = (
/obj/effect/decal/cleanable/blood/footprints{
	dir = 8
	},
/obj/machinery/door/airlock/survival_pod/glass{
	dir = 1
	},
/turf/open/floor/pod/dark,
/area/ruin/powered)
"u" = (
/obj/effect/decal/cleanable/blood/footprints{
	dir = 1
	},
/obj/effect/decal/cleanable/blood/drip{
	dir = 4
	},
/turf/open/floor/plating/asteroid/basalt/lava_land_surface,
/area/lavaland/surface/outdoors)
"v" = (
/obj/effect/decal/cleanable/blood/footprints{
	dir = 1
	},
/obj/effect/decal/cleanable/blood/footprints{
	dir = 4
	},
/turf/open/floor/plating/asteroid/basalt/lava_land_surface,
/area/lavaland/surface/outdoors)
"w" = (
/obj/structure/sign/mining/survival{
	pixel_y = -32;
	dir = 1
	},
/turf/open/floor/plating/asteroid/basalt/lava_land_surface,
/area/lavaland/surface/outdoors)
"x" = (
/obj/effect/decal/cleanable/blood/drip{
	dir = 4
	},
/obj/effect/decal/cleanable/blood/footprints{
	dir = 8
	},
/turf/open/floor/plating/asteroid/basalt/lava_land_surface,
/area/lavaland/surface/outdoors)
"y" = (
/obj/structure/sign/mining{
	pixel_y = -32;
	dir = 1
	},
/obj/effect/decal/cleanable/blood/footprints{
	dir = 1
	},
/turf/open/floor/plating/asteroid/basalt/lava_land_surface,
/area/lavaland/surface/outdoors)
"z" = (
/obj/effect/decal/cleanable/blood/footprints{
	dir = 1
	},
/turf/open/floor/plating/asteroid/basalt/lava_land_surface,
/area/lavaland/surface/outdoors)
"A" = (
/obj/effect/decal/cleanable/blood/footprints{
	dir = 4
	},
/obj/effect/decal/cleanable/blood/drip{
	dir = 4
	},
/turf/open/floor/plating/asteroid/basalt/lava_land_surface,
/area/lavaland/surface/outdoors)

(1,1,1) = {"
a
a
a
b
b
b
b
b
a
a
a"}(2,1,1) = {"
a
a
b
b
e
b
e
b
b
a
a"}(3,1,1) = {"
a
a
b
d
d
d
d
d
b
a
a"}(4,1,1) = {"
b
b
w
d
p
k
f
d
c
b
a"}(5,1,1) = {"
b
b
x
t
q
l
g
d
b
b
a"}(6,1,1) = {"
b
b
y
d
r
m
h
d
c
b
b"}(7,1,1) = {"
j
j
z
d
d
d
d
d
b
b
a"}(8,1,1) = {"
b
b
A
u
i
b
i
b
b
a
a"}(9,1,1) = {"
a
a
a
v
s
n
j
b
b
a
a"}(10,1,1) = {"
a
a
a
b
j
o
a
a
a
a
a"}