//MAP CONVERTED BY dmm2tgm.py THIS HEADER COMMENT PREVENTS RECONVERSION, DO NOT REMOVE
"aa" = (
/turf/closed/mineral/volcanic/lava_land_surface,
/area/lavaland/surface/outdoors)
"ab" = (
/turf/open/floor/plating/asteroid/basalt/lava_land_surface,
/area/lavaland/surface/outdoors)
"ah" = (
/turf/open/floor/plasteel/freezer,
/area/ruin/powered/seedvault)
"ai" = (
/obj/structure/closet/crate/hydroponics,
/obj/structure/beebox,
/obj/item/melee/flyswatter,
/obj/item/honey_frame,
/obj/item/honey_frame,
/obj/item/honey_frame,
/obj/item/queen_bee/bought,
/obj/item/clothing/head/beekeeper_head,
/obj/item/clothing/suit/beekeeper_suit,
/turf/open/floor/plasteel/freezer,
/area/ruin/powered/seedvault)
"aj" = (
/obj/structure/shuttle/engine/propulsion{
	dir = 8
	},
/turf/open/floor/plating/asteroid/basalt/lava_land_surface,
/area/lavaland/surface/outdoors)
"ak" = (
/obj/structure/closet/crate,
/obj/effect/spawner/lootdrop/seed_vault,
/turf/open/floor/plasteel/freezer,
/area/ruin/powered/seedvault)
"al" = (
/obj/machinery/door/airlock,
/turf/open/floor/plasteel/freezer,
/area/ruin/powered/seedvault)
"am" = (
/obj/machinery/door/airlock/external,
/obj/structure/fans/tiny,
/obj/effect/mapping_helpers/airlock/cyclelink_helper{
	dir = 8
	},
/turf/open/floor/plasteel/freezer,
/area/ruin/powered/seedvault)
"an" = (
/obj/machinery/smartfridge,
/turf/open/floor/plasteel/freezer,
/area/ruin/powered/seedvault)
"ao" = (
/obj/structure/closet/crate/hydroponics,
/obj/item/cultivator,
/obj/item/cultivator,
/obj/item/cultivator,
/obj/item/cultivator,
/obj/item/shovel/spade,
/obj/item/shovel/spade,
/obj/item/shovel/spade,
/obj/item/shovel/spade,
/obj/item/hatchet,
/obj/item/hatchet,
/obj/item/hatchet,
/obj/item/hatchet,
/turf/open/floor/plasteel/freezer,
/area/ruin/powered/seedvault)
"ap" = (
/obj/machinery/hydroponics/constructable,
/turf/open/floor/plasteel/freezer,
/area/ruin/powered/seedvault)
"aq" = (
/obj/item/hatchet,
/obj/item/storage/bag/plants,
/obj/item/reagent_containers/glass/bucket,
/obj/structure/table/wood,
/turf/open/floor/plasteel/freezer,
/area/ruin/powered/seedvault)
"ar" = (
/obj/structure/table/wood,
/obj/item/storage/bag/plants,
/obj/item/storage/bag/plants,
/obj/item/storage/bag/plants,
/obj/item/storage/bag/plants,
/turf/open/floor/plasteel/freezer,
/area/ruin/powered/seedvault)
"as" = (
/obj/structure/table/wood,
/obj/item/gun/energy/floragun,
/obj/item/gun/energy/floragun,
/obj/item/gun/energy/floragun,
/obj/item/gun/energy/floragun,
/obj/item/storage/box/disks_plantgene,
/turf/open/floor/plasteel/freezer,
/area/ruin/powered/seedvault)
"at" = (
/obj/effect/mob_spawn/human/seed_vault,
/turf/open/floor/plasteel/freezer,
/area/ruin/powered/seedvault)
"au" = (
/obj/structure/sink{
	dir = 8;
	pixel_x = -12;
	pixel_y = 2
	},
/turf/open/floor/plasteel/freezer,
/area/ruin/powered/seedvault)
"av" = (
/obj/machinery/vending/hydronutrients,
/turf/open/floor/plasteel/freezer,
/area/ruin/powered/seedvault)
"aw" = (
/obj/machinery/vending/hydroseeds,
/turf/open/floor/plasteel/freezer,
/area/ruin/powered/seedvault)
"ax" = (
/obj/machinery/reagentgrinder{
	pixel_y = 5
	},
/obj/structure/table/glass,
/obj/item/reagent_containers/glass/beaker/bluespace,
/obj/item/reagent_containers/glass/beaker/bluespace,
/obj/item/reagent_containers/glass/beaker/bluespace,
/obj/item/reagent_containers/glass/beaker/bluespace,
/turf/open/floor/plasteel/freezer,
/area/ruin/powered/seedvault)
"ay" = (
/obj/structure/sink{
	dir = 4;
	pixel_x = 11
	},
/turf/open/floor/plasteel/freezer,
/area/ruin/powered/seedvault)
"az" = (
/obj/machinery/door/airlock/external,
/obj/effect/mapping_helpers/airlock/cyclelink_helper{
	dir = 4
	},
/turf/open/floor/plasteel/freezer,
/area/ruin/powered/seedvault)
"aB" = (
/obj/structure/disposalpipe/trunk,
/obj/machinery/disposal/bin,
/turf/open/floor/plasteel/freezer,
/area/ruin/powered/seedvault)
"aC" = (
/obj/machinery/seed_extractor,
/turf/open/floor/plasteel/freezer,
/area/ruin/powered/seedvault)
"aD" = (
/obj/machinery/biogenerator,
/turf/open/floor/plasteel/freezer,
/area/ruin/powered/seedvault)
"aE" = (
/obj/machinery/chem_dispenser/mutagensaltpeter,
/turf/open/floor/plasteel/freezer,
/area/ruin/powered/seedvault)
"aF" = (
/obj/structure/disposalpipe/segment,
/turf/open/floor/plasteel/freezer,
/area/ruin/powered/seedvault)
"aG" = (
/obj/structure/closet/crate/hydroponics,
/obj/item/clothing/under/rank/civilian/hydroponics,
/obj/item/clothing/under/rank/civilian/hydroponics,
/obj/item/clothing/under/rank/civilian/hydroponics,
/obj/item/clothing/under/rank/civilian/hydroponics,
/turf/open/floor/plasteel/freezer,
/area/ruin/powered/seedvault)
"aH" = (
/obj/machinery/chem_master/condimaster,
/turf/open/floor/plasteel/freezer,
/area/ruin/powered/seedvault)
"aI" = (
/obj/structure/table/wood,
/obj/item/reagent_containers/glass/bucket,
/obj/item/reagent_containers/glass/bucket,
/obj/item/reagent_containers/glass/bucket,
/obj/item/reagent_containers/glass/bucket,
/turf/open/floor/plasteel/freezer,
/area/ruin/powered/seedvault)
"aJ" = (
/obj/item/storage/toolbox/syndicate,
/obj/structure/table/wood,
/turf/open/floor/plasteel/freezer,
/area/ruin/powered/seedvault)
"aL" = (
/obj/structure/disposalpipe/segment{
	dir = 5
	},
/turf/open/floor/plating/asteroid/basalt/lava_land_surface,
/area/lavaland/surface/outdoors)
"aM" = (
/obj/structure/disposalpipe/trunk{
	dir = 8
	},
/turf/open/floor/plating/asteroid/basalt/lava_land_surface,
/area/lavaland/surface/outdoors)
"aO" = (
/obj/machinery/light{
	dir = 1
	},
/turf/open/floor/plasteel/freezer,
/area/ruin/powered/seedvault)
"aP" = (
/obj/machinery/hydroponics/constructable,
/obj/machinery/light{
	dir = 1
	},
/turf/open/floor/plasteel/freezer,
/area/ruin/powered/seedvault)
"aQ" = (
/turf/closed/wall/r_wall,
/area/ruin/powered/seedvault)
"aR" = (
/obj/machinery/light{
	dir = 8
	},
/turf/open/floor/plasteel/freezer,
/area/ruin/powered/seedvault)
"aS" = (
/obj/machinery/light{
	dir = 4
	},
/turf/open/floor/plasteel/freezer,
/area/ruin/powered/seedvault)
"aV" = (
/obj/structure/disposalpipe/segment,
/turf/closed/wall/r_wall,
/area/ruin/powered/seedvault)
"aX" = (
/obj/machinery/hydroponics/constructable,
/obj/machinery/light,
/turf/open/floor/plasteel/freezer,
/area/ruin/powered/seedvault)
"cj" = (
/obj/machinery/plantgenes/seedvault{
	pixel_y = 6
	},
/obj/structure/table/wood,
/obj/machinery/atmospherics/pipe/simple/scrubbers/hidden/layer3{
	dir = 4
	},
/turf/open/floor/plasteel/freezer,
/area/ruin/powered/seedvault)
"dR" = (
/obj/machinery/atmospherics/pipe/simple/supply/hidden/layer1,
/turf/open/floor/plasteel/freezer,
/area/ruin/powered/seedvault)
"eR" = (
/obj/machinery/atmospherics/pipe/simple/supply/hidden/layer1{
	dir = 1
	},
/obj/machinery/atmospherics/pipe/simple/scrubbers/hidden/layer3{
	dir = 1
	},
/turf/open/floor/plasteel/freezer,
/area/ruin/powered/seedvault)
"fb" = (
/obj/machinery/atmospherics/pipe/manifold/scrubbers/hidden/layer3,
/obj/machinery/atmospherics/pipe/manifold/supply/hidden/layer1,
/turf/open/floor/plasteel/freezer,
/area/ruin/powered/seedvault)
"fg" = (
/obj/machinery/atmospherics/components/unary/vent_pump/on/layer1{
	dir = 1
	},
/turf/open/floor/plasteel/freezer,
/area/ruin/powered/seedvault)
"hz" = (
/obj/structure/table/wood,
/obj/item/lighter,
/obj/item/lighter,
/obj/item/storage/fancy/rollingpapers,
/obj/item/storage/fancy/rollingpapers,
/obj/item/storage/fancy/rollingpapers,
/obj/item/storage/fancy/rollingpapers,
/obj/machinery/atmospherics/components/unary/vent_pump/on/layer1{
	dir = 4
	},
/turf/open/floor/plasteel/freezer,
/area/ruin/powered/seedvault)
"hZ" = (
/obj/machinery/light{
	dir = 1
	},
/obj/machinery/atmospherics/pipe/simple/scrubbers/hidden/layer3,
/obj/machinery/atmospherics/components/unary/vent_pump/on/layer1{
	dir = 1
	},
/turf/open/floor/plasteel/freezer,
/area/ruin/powered/seedvault)
"iW" = (
/obj/machinery/atmospherics/components/binary/valve,
/turf/open/floor/plasteel/freezer,
/area/ruin/powered/seedvault)
"ju" = (
/obj/machinery/atmospherics/components/unary/vent_scrubber/on/layer3/lavaland{
	dir = 1
	},
/turf/open/floor/plasteel/freezer,
/area/ruin/powered/seedvault)
"kk" = (
/obj/structure/table/wood,
/obj/item/storage/box/disks_plantgene,
/obj/machinery/light{
	dir = 1
	},
/obj/machinery/atmospherics/pipe/simple/supply/hidden/layer1{
	dir = 8
	},
/turf/open/floor/plasteel/freezer,
/area/ruin/powered/seedvault)
"nD" = (
/obj/machinery/atmospherics/pipe/simple/scrubbers/hidden/layer3{
	dir = 4
	},
/obj/machinery/atmospherics/pipe/simple/supply/hidden/layer1{
	dir = 4
	},
/turf/open/floor/plasteel/freezer,
/area/ruin/powered/seedvault)
"tI" = (
/obj/machinery/atmospherics/pipe/manifold/scrubbers/hidden/layer3{
	dir = 1
	},
/obj/machinery/atmospherics/pipe/manifold/supply/hidden/layer1{
	dir = 1
	},
/turf/open/floor/plasteel/freezer,
/area/ruin/powered/seedvault)
"uQ" = (
/obj/machinery/door/airlock,
/obj/machinery/atmospherics/pipe/simple/supply/hidden/layer1{
	dir = 1
	},
/obj/machinery/atmospherics/pipe/simple/scrubbers/hidden/layer3{
	dir = 1
	},
/turf/open/floor/plasteel/freezer,
/area/ruin/powered/seedvault)
"vj" = (
/obj/machinery/light{
	dir = 8
	},
/obj/machinery/atmospherics/pipe/simple/scrubbers/hidden/layer3{
	dir = 4
	},
/obj/machinery/atmospherics/pipe/simple/supply/hidden/layer1{
	dir = 4
	},
/turf/open/floor/plasteel/freezer,
/area/ruin/powered/seedvault)
"wz" = (
/obj/machinery/atmospherics/pipe/simple/scrubbers/hidden/layer3{
	dir = 10
	},
/turf/closed/wall/r_wall,
/area/ruin/powered/seedvault)
"xN" = (
/obj/structure/table/wood,
/obj/machinery/smartfridge/disks{
	pixel_y = 2
	},
/obj/machinery/atmospherics/components/unary/vent_scrubber/on/layer3/lavaland{
	dir = 8
	},
/turf/open/floor/plasteel/freezer,
/area/ruin/powered/seedvault)
"yB" = (
/obj/machinery/atmospherics/components/unary/outlet_injector/on/layer3{
	dir = 4
	},
/turf/open/floor/plating/asteroid/basalt/lava_land_surface,
/area/lavaland/surface/outdoors)
"AZ" = (
/obj/machinery/atmospherics/pipe/simple/scrubbers/hidden/layer3{
	dir = 4
	},
/obj/machinery/atmospherics/pipe/simple/supply/hidden/layer1{
	dir = 4
	},
/turf/closed/wall/r_wall,
/area/ruin/powered/seedvault)
"Bs" = (
/obj/machinery/light,
/obj/machinery/atmospherics/components/unary/vent_scrubber/on/layer3/lavaland{
	dir = 1
	},
/turf/open/floor/plasteel/freezer,
/area/ruin/powered/seedvault)
"Gb" = (
/obj/machinery/atmospherics/components/unary/tank/air,
/turf/open/floor/plasteel/freezer,
/area/ruin/powered/seedvault)
"GG" = (
/obj/machinery/atmospherics/pipe/simple/scrubbers/hidden/layer3{
	dir = 10
	},
/obj/machinery/atmospherics/pipe/simple/supply/hidden/layer1{
	dir = 10
	},
/turf/open/floor/plasteel/freezer,
/area/ruin/powered/seedvault)
"GU" = (
/obj/machinery/atmospherics/pipe/simple/supply/hidden/layer1,
/obj/machinery/atmospherics/components/unary/vent_scrubber/on/layer3/lavaland{
	dir = 1
	},
/turf/open/floor/plasteel/freezer,
/area/ruin/powered/seedvault)
"Jd" = (
/obj/machinery/atmospherics/pipe/simple/scrubbers/hidden/layer3,
/turf/open/floor/plasteel/freezer,
/area/ruin/powered/seedvault)
"Kt" = (
/obj/machinery/atmospherics/pipe/simple/scrubbers/hidden/layer3{
	dir = 5
	},
/turf/closed/wall/r_wall,
/area/ruin/powered/seedvault)
"Mr" = (
/obj/machinery/atmospherics/pipe/simple/scrubbers/hidden/layer3{
	dir = 1
	},
/obj/machinery/atmospherics/pipe/simple/supply/hidden/layer1{
	dir = 1
	},
/turf/open/floor/plasteel/freezer,
/area/ruin/powered/seedvault)
"Oz" = (
/obj/machinery/atmospherics/pipe/layer_manifold,
/turf/open/floor/plasteel/freezer,
/area/ruin/powered/seedvault)
"PP" = (
/obj/machinery/atmospherics/pipe/simple/scrubbers/hidden/layer3,
/obj/machinery/atmospherics/components/unary/vent_pump/on/layer1{
	dir = 1
	},
/turf/open/floor/plasteel/freezer,
/area/ruin/powered/seedvault)
"Ws" = (
/obj/structure/table/wood,
/obj/item/storage/box/disks_plantgene,
/obj/machinery/atmospherics/pipe/simple/scrubbers/hidden/layer3{
	dir = 6
	},
/obj/machinery/atmospherics/pipe/simple/supply/hidden/layer1{
	dir = 10
	},
/turf/open/floor/plasteel/freezer,
/area/ruin/powered/seedvault)
"Zd" = (
/obj/machinery/door/airlock,
/obj/machinery/atmospherics/pipe/manifold/supply/hidden/layer1{
	dir = 8
	},
/obj/machinery/atmospherics/pipe/manifold/scrubbers/hidden/layer3{
	dir = 1
	},
/turf/open/floor/plasteel/freezer,
/area/ruin/powered/seedvault)

(1,1,1) = {"
aa
aa
aa
aa
aa
aa
yB
aQ
aQ
aQ
aQ
aQ
aQ
aa
aa
aa
aa
aa
ab
ab
"}
(2,1,1) = {"
aa
aa
aa
aQ
aQ
aQ
wz
Kt
at
at
at
at
aQ
aa
aa
aa
aa
aa
ab
ab
"}
(3,1,1) = {"
ab
aa
aa
aQ
Gb
iW
Oz
Zd
hZ
Jd
Jd
Bs
aQ
aQ
aa
aa
aa
ab
aa
ab
"}
(4,1,1) = {"
ab
aa
aa
aQ
aQ
aQ
aQ
AZ
aQ
al
al
aQ
aQ
aQ
aQ
aa
aa
aa
aa
aa
"}
(5,1,1) = {"
aa
aa
aQ
aQ
ak
aQ
an
vj
au
ah
ah
au
aR
au
aQ
aa
aa
aa
aa
aa
"}
(6,1,1) = {"
aa
aa
aQ
hz
ah
aQ
ao
tI
PP
Jd
Jd
ju
ah
aG
aQ
aa
aa
aa
aa
aa
"}
(7,1,1) = {"
aa
aa
aQ
kk
ah
aQ
aP
nD
ap
ah
ah
ap
ah
aX
aQ
aa
aa
aa
aa
aa
"}
(8,1,1) = {"
ab
aa
aQ
Ws
Mr
uQ
eR
fb
av
ah
ah
aB
aF
aF
aV
aL
aa
aa
aa
aa
"}
(9,1,1) = {"
ab
aa
aQ
cj
ah
aQ
ap
nD
an
ah
ah
aC
ah
ak
aQ
aM
aa
aa
aa
aa
"}
(10,1,1) = {"
aa
aa
aQ
xN
ah
aQ
ap
nD
aw
ah
ah
aD
ah
ap
aQ
ab
aa
aa
aa
aa
"}
(11,1,1) = {"
aa
aa
aQ
ah
ah
aQ
aq
nD
ax
ah
ah
aE
ah
aH
aQ
aa
aa
aa
aa
aa
"}
(12,1,1) = {"
ab
aa
aQ
aO
ah
aQ
aP
GG
GU
dR
dR
fg
ah
aX
aQ
aa
aa
aa
aa
aa
"}
(13,1,1) = {"
aa
aa
aQ
ai
ah
aQ
ar
ah
ah
ap
ap
ah
ah
aI
aQ
aa
aa
aa
aa
aa
"}
(14,1,1) = {"
aa
aa
aQ
aQ
ai
aQ
as
aS
ay
ah
ah
ay
aS
aJ
aQ
aa
aa
aa
aa
aa
"}
(15,1,1) = {"
aa
aa
ab
aQ
aQ
aQ
aQ
aQ
aQ
az
az
aQ
aQ
aQ
aQ
aa
aa
aa
aa
aa
"}
(16,1,1) = {"
ab
aa
ab
aj
aQ
aj
aQ
aj
aQ
ah
ah
aQ
aj
aQ
aj
aa
aa
aa
aa
aa
"}
(17,1,1) = {"
aa
aa
aa
aa
aa
aa
aa
aa
aQ
am
am
aQ
ab
ab
ab
aa
aa
aa
ab
ab
"}
(18,1,1) = {"
aa
aa
aa
ab
ab
ab
ab
ab
ab
ab
ab
ab
ab
ab
ab
aa
aa
aa
ab
ab
"}
(19,1,1) = {"
aa
aa
aa
aa
ab
ab
aa
ab
ab
ab
ab
ab
ab
ab
aa
aa
aa
ab
ab
ab
"}
(20,1,1) = {"
aa
aa
aa
ab
ab
ab
aa
ab
ab
ab
ab
ab
ab
ab
aa
aa
aa
ab
ab
aa
"}
