//MAP CONVERTED BY dmm2tgm.py THIS HEADER COMMENT PREVENTS RECONVERSION, DO NOT REMOVE
"a" = (
/obj/effect/turf_decal/stripes/line,
/obj/structure/target_stake,
/obj/machinery/magnetic_module,
/turf/open/floor/holofloor/dark,
/area/template_noop)
"c" = (
/obj/structure/window/reinforced/spawner/directional/west,
/obj/effect/turf_decal/stripes/line{
	dir = 10
	},
/turf/open/floor/holofloor/dark,
/area/template_noop)
"d" = (
/obj/structure/table/reinforced,
/obj/machinery/magnetic_controller{
	autolink = 1
	},
/obj/item/paper/guides/jobs/security/range,
/obj/structure/window/reinforced/spawner/directional/east,
/obj/structure/window/reinforced/spawner/directional/north,
/obj/effect/turf_decal/tile/red/half/contrasted,
/turf/open/floor/holofloor,
/area/template_noop)
"e" = (
/obj/effect/turf_decal/tile/green/anticorner/contrasted{
	dir = 8
	},
/obj/item/target/clown,
/obj/item/target,
/turf/open/floor/holofloor,
/area/template_noop)
"f" = (
/obj/effect/turf_decal/tile/green/half/contrasted{
	dir = 1
	},
/turf/open/floor/holofloor,
/area/template_noop)
"i" = (
/obj/effect/turf_decal/tile/green/half/contrasted{
	dir = 8
	},
/turf/open/floor/holofloor,
/area/template_noop)
"m" = (
/obj/structure/window/reinforced/spawner/directional/east,
/obj/effect/turf_decal/tile/red/half/contrasted,
/turf/open/floor/holofloor,
/area/template_noop)
"p" = (
/obj/structure/rack,
/obj/item/gun/energy/laser/practice,
/obj/item/clothing/ears/earmuffs,
/obj/effect/turf_decal/tile/green/half/contrasted{
	dir = 8
	},
/turf/open/floor/holofloor,
/area/template_noop)
"r" = (
/obj/structure/window/reinforced/spawner/directional/north,
/obj/structure/window/reinforced/spawner/directional/east,
/obj/effect/turf_decal/stripes/line{
	dir = 5
	},
/turf/open/floor/holofloor/dark,
/area/template_noop)
"v" = (
/obj/effect/turf_decal/tile/red/half/contrasted{
	dir = 1
	},
/turf/open/floor/holofloor,
/area/template_noop)
"w" = (
/obj/structure/table/reinforced,
/obj/machinery/recharger,
/obj/structure/window/reinforced/spawner/directional/west,
/obj/structure/window/reinforced/spawner/directional/north,
/obj/effect/turf_decal/tile/red/half/contrasted{
	dir = 1
	},
/turf/open/floor/holofloor,
/area/template_noop)
"x" = (
/obj/effect/turf_decal/tile/red/half/contrasted,
/turf/open/floor/holofloor,
/area/template_noop)
"z" = (
/obj/effect/turf_decal/tile/red{
	dir = 1
	},
/turf/open/floor/holofloor,
/area/template_noop)
"A" = (
/obj/structure/window/reinforced/spawner/directional/east,
/obj/effect/turf_decal/stripes/line{
	dir = 6
	},
/turf/open/floor/holofloor/dark,
/area/template_noop)
"B" = (
/obj/structure/window/reinforced/spawner/directional/north,
/obj/effect/turf_decal/stripes/line{
	dir = 1
	},
/turf/open/floor/holofloor/dark,
/area/template_noop)
"H" = (
/obj/effect/turf_decal/tile/green/anticorner/contrasted,
/obj/item/target/syndicate,
/obj/item/target,
/turf/open/floor/holofloor,
/area/template_noop)
"I" = (
/obj/effect/turf_decal/tile/red/half/contrasted{
	dir = 4
	},
/turf/open/floor/holofloor,
/area/template_noop)
"O" = (
/obj/structure/window/reinforced/spawner/directional/west,
/obj/effect/turf_decal/tile/red/half/contrasted{
	dir = 1
	},
/turf/open/floor/holofloor,
/area/template_noop)
"Q" = (
/turf/open/floor/holofloor,
/area/template_noop)
"T" = (
/obj/effect/turf_decal/tile/red{
	dir = 4
	},
/turf/open/floor/holofloor,
/area/template_noop)
"V" = (
/obj/structure/window/reinforced/spawner/directional/north,
/obj/structure/window/reinforced/spawner/directional/west,
/obj/effect/turf_decal/stripes/line{
	dir = 9
	},
/turf/open/floor/holofloor/dark,
/area/template_noop)
"X" = (
/obj/effect/turf_decal/tile/green/half/contrasted,
/turf/open/floor/holofloor,
/area/template_noop)

(1,1,1) = {"
f
f
f
f
f
f
e
"}
(2,1,1) = {"
x
x
x
x
x
T
i
"}
(3,1,1) = {"
V
c
O
O
w
I
p
"}
(4,1,1) = {"
B
a
Q
Q
Q
I
p
"}
(5,1,1) = {"
r
A
m
m
d
I
p
"}
(6,1,1) = {"
v
v
v
v
v
z
i
"}
(7,1,1) = {"
X
X
X
X
X
X
H
"}
