//MAP CONVERTED BY dmm2tgm.py THIS HEADER COMMENT PREVENTS RECONVERSION, DO NOT REMOVE
"c" = (
/obj/machinery/computer/arcade/orion_trail,
/turf/open/floor/holofloor/dark,
/area/template_noop)
"e" = (
/obj/effect/turf_decal/siding/wideplating/dark{
	dir = 6
	},
/obj/item/kirbyplants/random,
/turf/open/floor/holofloor/dark,
/area/template_noop)
"i" = (
/obj/effect/spawner/random/entertainment/arcade,
/obj/effect/turf_decal/siding/wideplating/dark{
	dir = 10
	},
/turf/open/floor/holofloor/dark,
/area/template_noop)
"j" = (
/obj/effect/turf_decal/siding/wideplating/dark{
	dir = 8
	},
/obj/structure/table,
/turf/open/floor/holofloor/dark,
/area/template_noop)
"t" = (
/obj/effect/turf_decal/siding/wideplating/dark{
	dir = 5
	},
/obj/structure/table,
/obj/item/toy/batong,
/turf/open/floor/holofloor/dark,
/area/template_noop)
"y" = (
/obj/effect/spawner/random/entertainment/arcade,
/obj/effect/turf_decal/siding/wideplating/dark{
	dir = 9
	},
/turf/open/floor/holofloor/dark,
/area/template_noop)
"B" = (
/obj/machinery/computer/arcade/amputation,
/obj/effect/turf_decal/siding/wideplating/dark,
/turf/open/floor/holofloor/dark,
/area/template_noop)
"I" = (
/obj/effect/turf_decal/siding/wideplating/dark{
	dir = 4
	},
/obj/structure/table,
/obj/item/toy/cattoy{
	pixel_y = 21
	},
/obj/item/toy/katana{
	pixel_y = 17
	},
/obj/item/toy/nuke{
	pixel_y = 4
	},
/turf/open/floor/holofloor/dark,
/area/template_noop)
"J" = (
/obj/structure/reagent_dispensers/water_cooler,
/obj/effect/turf_decal/siding/wideplating/dark{
	dir = 4
	},
/turf/open/floor/holofloor/dark,
/area/template_noop)
"M" = (
/obj/effect/turf_decal/siding/wideplating/dark{
	dir = 9
	},
/obj/item/kirbyplants/random,
/turf/open/floor/holofloor/dark,
/area/template_noop)
"N" = (
/obj/machinery/computer/arcade/amputation,
/obj/effect/turf_decal/siding/wideplating/dark{
	dir = 1
	},
/turf/open/floor/holofloor/dark,
/area/template_noop)
"P" = (
/obj/machinery/computer/arcade/battle,
/obj/effect/turf_decal/siding/wideplating/dark{
	dir = 6
	},
/turf/open/floor/holofloor/dark,
/area/template_noop)
"R" = (
/obj/machinery/computer/arcade/battle,
/obj/effect/turf_decal/siding/wideplating/dark{
	dir = 5
	},
/turf/open/floor/holofloor/dark,
/area/template_noop)
"U" = (
/turf/open/floor/eighties,
/area/template_noop)
"W" = (
/obj/machinery/computer/arcade/orion_trail,
/obj/effect/turf_decal/siding/wideplating/dark,
/obj/effect/turf_decal/siding/wideplating/dark{
	dir = 1
	},
/turf/open/floor/holofloor/dark,
/area/template_noop)
"Y" = (
/obj/effect/turf_decal/siding/wideplating/dark{
	dir = 10
	},
/obj/item/kirbyplants/random,
/turf/open/floor/holofloor/dark,
/area/template_noop)

(1,1,1) = {"
J
e
U
U
U
t
I
"}
(2,1,1) = {"
U
U
U
U
U
U
U
"}
(3,1,1) = {"
i
U
U
c
U
U
y
"}
(4,1,1) = {"
B
U
U
W
U
U
N
"}
(5,1,1) = {"
P
U
U
c
U
U
R
"}
(6,1,1) = {"
U
U
U
U
U
U
U
"}
(7,1,1) = {"
j
Y
U
U
U
M
j
"}
