//MAP CONVERTED BY dmm2tgm.py THIS HEADER COMMENT PREVENTS RECONVERSION, DO NOT REMOVE
"a" = (
/obj/effect/turf_decal/tile/yellow/half/contrasted{
	dir = 1
	},
/turf/open/floor/holofloor,
/area/template_noop)
"d" = (
/obj/structure/window/reinforced{
	dir = 8
	},
/obj/structure/table/glass,
/obj/item/clothing/glasses/blindfold,
/obj/item/clothing/glasses/blindfold{
	pixel_y = 4
	},
/obj/effect/decal/cleanable/dirt,
/turf/open/floor/holofloor,
/area/template_noop)
"f" = (
/obj/structure/window{
	dir = 1
	},
/obj/structure/toilet{
	dir = 8
	},
/obj/structure/window{
	dir = 8
	},
/turf/open/floor/holofloor/dark,
/area/template_noop)
"h" = (
/obj/effect/decal/cleanable/dirt,
/turf/open/floor/holofloor,
/area/template_noop)
"i" = (
/obj/machinery/door/window/brigdoor{
	dir = 4
	},
/obj/effect/decal/cleanable/blood/tracks{
	dir = 4
	},
/obj/effect/decal/cleanable/blood/footprints{
	dir = 4
	},
/obj/effect/turf_decal/tile/red{
	dir = 4
	},
/obj/structure/window/reinforced{
	dir = 1
	},
/turf/open/floor/holofloor/dark,
/area/template_noop)
"j" = (
/turf/open/floor/holofloor,
/area/template_noop)
"k" = (
/obj/structure/toilet{
	dir = 4
	},
/obj/structure/window{
	dir = 4
	},
/turf/open/floor/holofloor/dark,
/area/template_noop)
"l" = (
/obj/effect/holodeck_effect/mobspawner/psycho,
/obj/machinery/door/window{
	dir = 8
	},
/obj/effect/decal/cleanable/blood,
/turf/open/floor/holofloor/dark,
/area/template_noop)
"m" = (
/obj/structure/bed{
	dir = 8
	},
/obj/structure/window{
	dir = 8
	},
/obj/structure/window,
/turf/open/floor/holofloor/dark,
/area/template_noop)
"n" = (
/obj/structure/window{
	dir = 8
	},
/obj/structure/table,
/obj/item/assembly/flash,
/obj/effect/turf_decal/tile/blue/anticorner/contrasted{
	dir = 1
	},
/obj/item/clothing/glasses/blindfold,
/obj/item/clothing/mask/muzzle,
/obj/item/healthanalyzer{
	pixel_x = 1;
	pixel_y = 6
	},
/obj/item/screwdriver{
	pixel_x = 1;
	pixel_y = 5
	},
/obj/item/reagent_containers/glass/beaker,
/turf/open/floor/holofloor,
/area/template_noop)
"o" = (
/obj/effect/decal/cleanable/blood/old,
/obj/effect/turf_decal/tile/blue/half/contrasted{
	dir = 4
	},
/obj/structure/table/optable,
/turf/open/floor/holofloor,
/area/template_noop)
"p" = (
/obj/structure/window/reinforced,
/obj/structure/window/reinforced{
	dir = 4
	},
/obj/effect/decal/cleanable/blood,
/obj/effect/turf_decal/tile/red/opposingcorners{
	dir = 4
	},
/turf/open/floor/holofloor/dark,
/area/template_noop)
"r" = (
/obj/structure/toilet{
	dir = 8
	},
/obj/structure/window{
	dir = 8
	},
/turf/open/floor/holofloor/dark,
/area/template_noop)
"s" = (
/obj/structure/window{
	dir = 4
	},
/obj/effect/decal/cleanable/blood/old,
/obj/structure/curtain,
/obj/effect/turf_decal/tile/blue/anticorner/contrasted,
/turf/open/floor/holofloor,
/area/template_noop)
"x" = (
/obj/structure/window,
/obj/structure/toilet{
	dir = 4
	},
/obj/structure/window{
	dir = 4
	},
/turf/open/floor/holofloor/dark,
/area/template_noop)
"A" = (
/obj/effect/turf_decal/tile/red{
	dir = 4
	},
/obj/structure/window/reinforced{
	dir = 1
	},
/obj/machinery/igniter,
/obj/effect/holodeck_effect/mobspawner/psycho,
/turf/open/floor/holofloor/dark,
/area/template_noop)
"B" = (
/obj/structure/bed{
	dir = 4
	},
/obj/effect/decal/cleanable/vomit,
/obj/structure/window{
	dir = 4
	},
/turf/open/floor/holofloor/dark,
/area/template_noop)
"C" = (
/obj/effect/decal/cleanable/blood/drip,
/obj/effect/turf_decal/tile/yellow/half/contrasted,
/turf/open/floor/holofloor,
/area/template_noop)
"D" = (
/obj/structure/window{
	dir = 4
	},
/obj/machinery/computer/operating,
/obj/effect/turf_decal/tile/blue/anticorner/contrasted{
	dir = 4
	},
/turf/open/floor/holofloor,
/area/template_noop)
"F" = (
/obj/structure/window/reinforced,
/obj/effect/decal/cleanable/blood/drip,
/obj/effect/turf_decal/tile/red{
	dir = 8
	},
/turf/open/floor/holofloor/dark,
/area/template_noop)
"G" = (
/obj/structure/bed{
	dir = 8
	},
/obj/effect/decal/cleanable/vomit,
/obj/structure/window{
	dir = 8
	},
/turf/open/floor/holofloor/dark,
/area/template_noop)
"H" = (
/obj/effect/decal/cleanable/blood/drip,
/obj/effect/turf_decal/tile/red{
	dir = 8
	},
/obj/effect/turf_decal/tile/red/opposingcorners{
	dir = 4
	},
/obj/effect/decal/cleanable/blood,
/obj/structure/window/reinforced{
	dir = 1
	},
/obj/machinery/door/window/brigdoor{
	dir = 8
	},
/turf/open/floor/holofloor/dark,
/area/template_noop)
"K" = (
/obj/effect/holodeck_effect/mobspawner/psycho,
/obj/machinery/door/window{
	dir = 4
	},
/obj/effect/decal/cleanable/blood,
/turf/open/floor/holofloor/dark,
/area/template_noop)
"L" = (
/obj/structure/bed{
	dir = 4
	},
/obj/structure/window{
	dir = 4
	},
/obj/structure/window{
	dir = 1
	},
/turf/open/floor/holofloor/dark,
/area/template_noop)
"M" = (
/obj/effect/decal/cleanable/dirt/dust,
/obj/effect/turf_decal/tile/yellow/half/contrasted{
	dir = 1
	},
/turf/open/floor/holofloor,
/area/template_noop)
"P" = (
/obj/structure/window/reinforced,
/obj/structure/window/reinforced{
	dir = 8
	},
/obj/effect/turf_decal/tile/red{
	dir = 8
	},
/turf/open/floor/holofloor/dark,
/area/template_noop)
"R" = (
/obj/structure/window/reinforced{
	dir = 4
	},
/obj/structure/table/glass,
/obj/item/reagent_containers/syringe,
/obj/item/reagent_containers/syringe,
/obj/item/reagent_containers/syringe,
/obj/effect/decal/cleanable/dirt,
/obj/item/wirecutters{
	pixel_x = -4;
	pixel_y = 8
	},
/turf/open/floor/holofloor,
/area/template_noop)
"S" = (
/obj/effect/decal/cleanable/blood/drip,
/obj/structure/table/glass,
/obj/item/clothing/mask/muzzle{
	pixel_x = -26;
	pixel_y = -2
	},
/obj/effect/decal/cleanable/dirt,
/obj/effect/decal/cleanable/dirt,
/obj/item/clothing/suit/straight_jacket{
	pixel_x = 3;
	pixel_y = 1
	},
/obj/item/hatchet{
	pixel_x = 9;
	pixel_y = 6
	},
/obj/item/lighter{
	pixel_x = -9;
	pixel_y = -4
	},
/turf/open/floor/holofloor,
/area/template_noop)
"T" = (
/obj/effect/decal/cleanable/dirt,
/obj/structure/curtain,
/obj/effect/turf_decal/tile/blue/half/contrasted{
	dir = 8
	},
/turf/open/floor/holofloor,
/area/template_noop)
"V" = (
/obj/effect/turf_decal/tile/yellow/half/contrasted,
/turf/open/floor/holofloor,
/area/template_noop)
"W" = (
/obj/structure/window{
	dir = 8
	},
/obj/structure/curtain,
/obj/effect/turf_decal/tile/blue/anticorner/contrasted{
	dir = 8
	},
/turf/open/floor/holofloor,
/area/template_noop)
"Y" = (
/obj/effect/decal/cleanable/dirt/dust,
/obj/effect/decal/cleanable/blood/drip,
/obj/effect/decal/cleanable/blood/tracks{
	dir = 4
	},
/obj/effect/turf_decal/tile/yellow/half/contrasted,
/turf/open/floor/holofloor,
/area/template_noop)

(1,1,1) = {"
B
K
x
j
L
K
k
"}
(2,1,1) = {"
M
M
a
j
M
a
a
"}
(3,1,1) = {"
h
d
H
P
n
W
j
"}
(4,1,1) = {"
h
S
A
F
o
T
j
"}
(5,1,1) = {"
h
R
i
p
D
s
j
"}
(6,1,1) = {"
V
C
Y
C
V
V
V
"}
(7,1,1) = {"
r
l
m
j
f
l
G
"}
