//MAP CONVERTED BY dmm2tgm.py THIS HEADER COMMENT PREVENTS RECONVERSION, DO NOT REMOVE
"a" = (
/turf/open/floor/holofloor/plating,
/area/template_noop)
"H" = (
/obj/effect/holodeck_effect/mobspawner,
/turf/open/floor/holofloor/plating,
/area/template_noop)

(1,1,1) = {"
a
a
a
a
a
a
a
"}
(2,1,1) = {"
a
H
a
a
H
a
a
"}
(3,1,1) = {"
a
a
a
a
a
H
a
"}
(4,1,1) = {"
a
a
H
H
a
H
a
"}
(5,1,1) = {"
a
a
a
a
a
H
a
"}
(6,1,1) = {"
a
H
a
a
H
a
a
"}
(7,1,1) = {"
a
a
a
a
a
a
a
"}
