//MAP CONVERTED BY dmm2tgm.py THIS HEADER COMMENT PREVENTS RECONVERSION, DO NOT REMOVE
"b" = (
/turf/open/floor/pod,
/area/exploration_away/always_powered)
"e" = (
/turf/open/lava/smooth/airless,
/area/exploration_away/outside)
"h" = (
/obj/structure/tubes,
/obj/structure/chair/comfy/black{
	dir = 8
	},
/turf/open/floor/pod,
/area/exploration_away/always_powered)
"k" = (
/turf/closed/mineral/random/high_chance,
/area/exploration_away/outside)
"n" = (
/turf/open/floor/plating/asteroid,
/area/exploration_away/outside)
"o" = (
/obj/effect/landmark/exploration_objective_spawn,
/turf/open/floor/pod,
/area/exploration_away/always_powered)
"s" = (
/obj/structure/fans,
/turf/open/floor/pod,
/area/exploration_away/always_powered)
"y" = (
/obj/machinery/light/small{
	dir = 1
	},
/turf/open/floor/pod,
/area/exploration_away/always_powered)
"B" = (
/obj/structure/bed/pod,
/obj/item/bedsheet/black,
/turf/open/floor/pod,
/area/exploration_away/always_powered)
"C" = (
/obj/machinery/stasis/survival_pod,
/obj/machinery/vending/wallmed/survival_pod{
	pixel_x = -24
	},
/turf/open/floor/pod,
/area/exploration_away/always_powered)
"E" = (
/obj/structure/fans/tiny,
/obj/item/clothing/shoes/workboots/mining,
/obj/machinery/door/airlock/survival_pod/glass,
/turf/open/floor/pod,
/area/exploration_away/always_powered)
"I" = (
/obj/effect/landmark/exploration_loot,
/turf/open/floor/plating/asteroid,
/area/exploration_away/outside)
"M" = (
/obj/item/gps/computer,
/turf/open/floor/pod,
/area/exploration_away/always_powered)
"R" = (
/obj/structure/table/survival_pod,
/obj/item/instrument/guitar,
/obj/machinery/light/small/broken,
/turf/open/floor/pod,
/area/exploration_away/always_powered)
"S" = (
/obj/item/pickaxe/diamond,
/turf/open/floor/pod,
/area/exploration_away/always_powered)
"U" = (
/turf/template_noop,
/area/exploration_away/outside)
"Y" = (
/obj/machinery/smartfridge/survival_pod,
/turf/open/floor/pod,
/area/exploration_away/always_powered)

(1,1,1) = {"
U
U
U
U
U
U
U
U
U
U
U
U
k
k
k
U
U
U
U
U
U
U
U
U
"}
(2,1,1) = {"
U
U
U
U
U
U
U
U
U
U
k
k
k
k
k
k
U
U
U
U
U
U
U
U
"}
(3,1,1) = {"
U
U
U
U
U
U
U
U
U
k
k
k
k
k
k
k
k
U
U
U
U
U
U
U
"}
(4,1,1) = {"
U
U
U
U
U
U
U
U
k
k
k
e
e
e
k
k
k
U
U
U
U
U
U
U
"}
(5,1,1) = {"
U
U
U
U
U
U
U
U
k
k
e
e
e
e
e
k
k
k
U
U
U
U
U
U
"}
(6,1,1) = {"
U
U
U
U
U
U
U
k
k
e
e
e
e
e
e
e
k
k
U
U
U
U
U
U
"}
(7,1,1) = {"
U
U
U
U
U
U
k
k
k
e
n
n
n
n
e
k
k
k
k
U
U
U
U
U
"}
(8,1,1) = {"
U
U
U
U
U
k
k
k
k
n
n
n
n
n
n
k
k
k
k
U
U
U
U
U
"}
(9,1,1) = {"
U
U
U
U
k
k
k
k
n
n
e
e
e
e
n
n
k
k
k
k
U
U
U
U
"}
(10,1,1) = {"
U
U
U
U
k
k
k
k
n
n
e
e
e
k
k
E
k
k
k
k
U
U
U
U
"}
(11,1,1) = {"
U
U
U
k
k
k
n
n
n
n
e
e
e
k
s
b
C
R
k
k
k
U
U
U
"}
(12,1,1) = {"
U
U
k
k
k
n
n
k
k
n
n
e
e
k
Y
b
b
b
k
k
k
U
U
U
"}
(13,1,1) = {"
U
k
k
k
n
n
k
k
k
n
n
e
e
k
M
b
o
b
k
k
k
U
U
U
"}
(14,1,1) = {"
k
k
k
n
n
k
k
k
k
n
n
n
e
k
k
y
b
h
k
k
k
U
U
U
"}
(15,1,1) = {"
k
k
k
I
n
k
k
k
k
n
n
n
k
k
k
S
B
k
k
k
k
U
U
U
"}
(16,1,1) = {"
U
U
k
k
k
k
k
k
U
U
U
U
U
k
k
k
k
k
k
k
k
k
U
U
"}
(17,1,1) = {"
U
U
U
U
U
U
U
U
U
U
U
U
U
U
U
U
k
k
k
k
k
k
U
U
"}
(18,1,1) = {"
U
U
U
U
U
U
U
U
U
U
U
U
U
U
U
U
U
U
k
k
k
k
U
U
"}
(19,1,1) = {"
U
U
U
U
U
U
U
U
U
U
U
U
U
U
U
U
U
U
k
k
k
k
U
U
"}
(20,1,1) = {"
U
U
U
U
U
U
U
U
U
U
U
U
U
U
U
U
U
U
U
k
k
k
k
U
"}
(21,1,1) = {"
U
U
U
U
U
U
U
U
U
U
U
U
U
U
U
U
U
U
U
U
k
k
k
U
"}
(22,1,1) = {"
U
U
U
U
U
U
U
U
U
U
U
U
U
U
U
U
U
U
U
U
k
k
k
k
"}
(23,1,1) = {"
U
U
U
U
U
U
U
U
U
U
U
U
U
U
U
U
U
U
U
U
k
k
k
k
"}
(24,1,1) = {"
U
U
U
U
U
U
U
U
U
U
U
U
U
U
U
U
U
U
U
U
U
k
k
k
"}
