//MAP CONVERTED BY dmm2tgm.py THIS HEADER COMMENT PREVENTS RECONVERSION, DO NOT REMOVE
"a" = (
/obj/machinery/atmospherics/pipe/simple/scrubbers/visible/layer4{
	dir = 10
	},
/obj/machinery/atmospherics/components/unary/vent_pump/on/layer2,
/obj/structure/lattice/catwalk/over,
/obj/machinery/shower{
	dir = 8;
	name = "emergency shower";
	pixel_y = 6
	},
/obj/structure/sign/directions/engineering{
	desc = "A handy sign praising the engineering department.";
	icon_state = "safety";
	name = "engineering plaque";
	pixel_y = 32
	},
/obj/effect/decal/cleanable/dirt,
/turf/open/floor/plating,
/area/template_noop)
"e" = (
/obj/machinery/atmospherics/pipe/simple/supply/visible/layer2{
	dir = 6
	},
/obj/structure/disposalpipe/trunk,
/obj/machinery/disposal/deliveryChute,
/obj/structure/railing{
	dir = 4
	},
/obj/structure/sign/departments/minsky/engineering/atmospherics{
	pixel_y = 32
	},
/obj/effect/decal/cleanable/dirt,
/turf/open/floor/plating,
/area/template_noop)
"f" = (
/obj/structure/lattice/catwalk/over,
/obj/machinery/atmospherics/pipe/simple/supply/visible/layer2{
	dir = 4
	},
/obj/machinery/atmospherics/pipe/simple/supply/visible/layer2,
/obj/machinery/atmospherics/components/binary/volume_pump/on/layer4{
	dir = 4
	},
/obj/machinery/atmospherics/pipe/simple/cyan/visible{
	dir = 4
	},
/obj/structure/disposalpipe/segment{
	dir = 9
	},
/obj/effect/mob_spawn/human/engineer{
	name = "Insane Atmospherics Technician"
	},
/obj/effect/decal/cleanable/dirt,
/turf/open/floor/plating,
/area/template_noop)
"m" = (
/obj/machinery/atmospherics/pipe/manifold/scrubbers/visible/layer4{
	dir = 4
	},
/obj/machinery/portable_atmospherics/canister/oxygen,
/obj/structure/extinguisher_cabinet{
	pixel_x = 27
	},
/obj/machinery/atmospherics/components/unary/portables_connector/visible{
	dir = 8
	},
/obj/machinery/atmospherics/pipe/simple/green/visible,
/obj/structure/railing{
	dir = 1
	},
/obj/effect/decal/cleanable/dirt,
/turf/open/floor/plating,
/area/template_noop)
"n" = (
/obj/structure/lattice/catwalk/over,
/obj/machinery/atmospherics/pipe/manifold4w/scrubbers/visible/layer4,
/obj/machinery/atmospherics/pipe/manifold/supply/visible/layer2,
/obj/machinery/atmospherics/pipe/simple/cyan/visible{
	dir = 9
	},
/obj/machinery/atmospherics/pipe/simple/green/visible{
	dir = 6
	},
/obj/item/pipe_dispenser,
/obj/effect/decal/cleanable/dirt,
/turf/open/floor/plating,
/area/template_noop)
"w" = (
/obj/machinery/atmospherics/pipe/simple/scrubbers/visible/layer4{
	dir = 9
	},
/obj/machinery/atmospherics/pipe/simple/green/visible{
	dir = 9
	},
/obj/structure/disposalpipe/trunk{
	dir = 8
	},
/obj/structure/disposaloutlet{
	dir = 8
	},
/obj/structure/sign/departments/minsky/engineering/atmospherics{
	pixel_y = -32
	},
/obj/effect/decal/cleanable/dirt,
/turf/open/floor/plating,
/area/template_noop)
"x" = (
/obj/structure/lattice/catwalk/over,
/obj/machinery/atmospherics/pipe/layer_manifold/visible,
/obj/machinery/atmospherics/pipe/simple/scrubbers/visible/layer4{
	dir = 4
	},
/obj/machinery/atmospherics/pipe/simple/cyan/visible{
	dir = 8
	},
/obj/effect/decal/cleanable/dirt,
/turf/open/floor/plating,
/area/template_noop)
"y" = (
/obj/machinery/atmospherics/pipe/manifold/supply/visible/layer2{
	dir = 4
	},
/obj/machinery/airalarm/directional/east,
/obj/machinery/atmospherics/components/binary/pump/on/layer4,
/obj/machinery/atmospherics/pipe/simple/cyan/visible{
	dir = 10
	},
/obj/structure/closet/crate,
/obj/structure/railing{
	dir = 9
	},
/obj/item/storage/box/survival/engineer,
/obj/item/holosign_creator/atmos,
/obj/effect/decal/cleanable/dirt,
/turf/open/floor/plating,
/area/template_noop)
"H" = (
/obj/structure/lattice/catwalk/over,
/obj/machinery/atmospherics/pipe/manifold4w/supply/visible/layer2,
/obj/machinery/atmospherics/pipe/manifold/scrubbers/visible/layer4,
/obj/machinery/atmospherics/pipe/simple/cyan/visible{
	dir = 6
	},
/obj/machinery/atmospherics/pipe/simple/purple/visible{
	dir = 9
	},
/obj/structure/disposalpipe/segment{
	dir = 6
	},
/obj/item/book/manual/wiki/atmospherics,
/obj/effect/decal/cleanable/dirt,
/turf/open/floor/plating,
/area/template_noop)
"J" = (
/obj/structure/lattice/catwalk/over,
/obj/machinery/atmospherics/pipe/manifold/supply/visible/layer2{
	dir = 4
	},
/obj/machinery/atmospherics/pipe/simple/scrubbers/visible/layer4{
	dir = 6
	},
/obj/machinery/atmospherics/pipe/simple/green/visible{
	dir = 6
	},
/obj/structure/disposalpipe/segment{
	dir = 4
	},
/obj/structure/holosign/barrier/atmos,
/obj/effect/decal/cleanable/dirt,
/turf/open/floor/plating,
/area/template_noop)
"L" = (
/obj/machinery/atmospherics/pipe/simple/supply/visible/layer2{
	dir = 5
	},
/obj/machinery/portable_thermomachine,
/obj/structure/disposalpipe/segment{
	dir = 5
	},
/obj/structure/sign/poster/official/moth7{
	pixel_y = -32
	},
/obj/effect/decal/cleanable/dirt,
/turf/open/floor/plating,
/area/template_noop)
"O" = (
/obj/machinery/atmospherics/components/unary/vent_scrubber/on/layer4{
	dir = 4
	},
/obj/machinery/atmospherics/components/binary/pump/on/layer2{
	dir = 1
	},
/obj/item/wrench,
/obj/machinery/light{
	dir = 8
	},
/obj/machinery/atmospherics/pipe/simple/cyan/visible{
	dir = 5
	},
/obj/effect/spawner/lootdrop/crate_spawner,
/obj/structure/disposalpipe/segment,
/obj/structure/railing{
	dir = 1
	},
/obj/structure/sign/poster/contraband/atmosia_independence{
	pixel_x = -32
	},
/obj/effect/decal/cleanable/dirt,
/turf/open/floor/plating,
/area/template_noop)
"U" = (
/obj/machinery/atmospherics/pipe/simple/scrubbers/visible/layer4{
	dir = 6
	},
/obj/effect/spawner/lootdrop/crate_spawner,
/obj/machinery/atmospherics/components/binary/volume_pump/on/layer2,
/obj/machinery/atmospherics/pipe/simple/purple/visible{
	dir = 6
	},
/obj/structure/disposalpipe/segment{
	dir = 5
	},
/obj/structure/railing{
	dir = 4
	},
/obj/item/radio/headset/headset_eng,
/obj/structure/sign/poster/official/moth5{
	pixel_x = -32
	},
/obj/effect/decal/cleanable/dirt,
/turf/open/floor/plating,
/area/template_noop)
"V" = (
/obj/structure/lattice/catwalk/over,
/obj/item/clothing/mask/gas{
	pixel_x = 8;
	pixel_y = -7
	},
/obj/machinery/atmospherics/pipe/layer_manifold/visible,
/obj/machinery/atmospherics/pipe/layer_manifold/visible{
	dir = 4
	},
/obj/structure/disposalpipe/segment{
	dir = 10
	},
/obj/item/lighter{
	pixel_x = -5;
	pixel_y = -6
	},
/obj/item/clothing/mask/cigarette{
	starts_lit = 1;
	pixel_x = -7
	},
/obj/effect/decal/cleanable/dirt,
/turf/open/floor/plating,
/area/template_noop)
"Y" = (
/obj/structure/lattice/catwalk/over,
/obj/machinery/atmospherics/pipe/simple/supply/visible/layer2{
	dir = 9
	},
/obj/machinery/atmospherics/pipe/manifold/scrubbers/visible/layer4{
	dir = 8
	},
/obj/machinery/atmospherics/components/binary/dp_vent_pump/high_volume/on,
/obj/effect/decal/cleanable/dirt,
/turf/open/floor/plating,
/area/template_noop)

(1,1,1) = {"
e
U
H
O
L
"}
(2,1,1) = {"
Y
V
f
x
J
"}
(3,1,1) = {"
a
y
n
m
w
"}
