//MAP CONVERTED BY dmm2tgm.py THIS HEADER COMMENT PREVENTS RECONVERSION, DO NOT REMOVE
"h" = (
/obj/structure/closet/crate/coffin,
/obj/effect/decal/cleanable/dirt,
/obj/effect/turf_decal/delivery,
/obj/effect/turf_decal/stripes/corner{
	dir = 8
	},
/obj/effect/turf_decal/tile/neutral/half/contrasted{
	dir = 1
	},
/turf/open/floor/iron/dark,
/area/template_noop)
"i" = (
/obj/structure/closet/crate/coffin,
/obj/effect/decal/cleanable/dirt,
/obj/effect/turf_decal/bot,
/obj/effect/turf_decal/tile/neutral/half/contrasted{
	dir = 1
	},
/turf/open/floor/iron/dark,
/area/template_noop)
"n" = (
/obj/structure/table,
/obj/effect/decal/cleanable/cobweb,
/obj/effect/decal/cleanable/dirt,
/obj/item/storage/box/bodybags{
	pixel_y = 5
	},
/obj/item/shovel,
/obj/effect/turf_decal/tile/neutral,
/turf/open/floor/iron/dark,
/area/template_noop)
"t" = (
/obj/structure/closet/crate/coffin,
/obj/effect/decal/cleanable/dirt,
/obj/effect/turf_decal/bot,
/obj/effect/turf_decal/tile/neutral/half/contrasted,
/turf/open/floor/iron/dark,
/area/template_noop)
"u" = (
/obj/effect/decal/cleanable/blood/old,
/turf/open/floor/wood,
/area/template_noop)
"w" = (
/obj/item/radio/intercom{
	pixel_x = 28;
	pixel_y = 22
	},
/turf/open/floor/wood{
	broken = 1
	},
/area/template_noop)
"y" = (
/turf/closed/wall,
/area/template_noop)
"B" = (
/obj/structure/closet/crate/coffin,
/obj/effect/decal/cleanable/dirt,
/obj/effect/turf_decal/delivery,
/obj/effect/decal/cleanable/blood/old,
/obj/effect/turf_decal/tile/neutral/half/contrasted,
/turf/open/floor/iron/dark,
/area/template_noop)
"D" = (
/obj/structure/closet/crate/coffin,
/obj/effect/decal/cleanable/dirt,
/obj/effect/turf_decal/delivery,
/obj/effect/turf_decal/stripes/corner,
/obj/effect/turf_decal/tile/neutral/half/contrasted,
/turf/open/floor/iron/dark,
/area/template_noop)
"G" = (
/obj/structure/closet/crate/coffin,
/obj/effect/decal/cleanable/dirt,
/obj/effect/turf_decal/bot,
/obj/effect/decal/cleanable/blood/old,
/obj/structure/noticeboard{
	dir = 8;
	pixel_x = 32
	},
/obj/machinery/light/small{
	dir = 4
	},
/obj/effect/turf_decal/tile/neutral/half/contrasted{
	dir = 1
	},
/turf/open/floor/iron/dark,
/area/template_noop)
"J" = (
/obj/effect/turf_decal/stripes/line,
/obj/effect/decal/cleanable/blood/old,
/turf/open/floor/wood{
	broken = 1
	},
/area/template_noop)
"R" = (
/turf/open/floor/wood,
/area/template_noop)
"U" = (
/obj/structure/closet/crate/coffin,
/obj/effect/decal/cleanable/dirt,
/obj/effect/turf_decal/bot,
/obj/machinery/light/small{
	dir = 8
	},
/obj/effect/turf_decal/tile/neutral/half/contrasted,
/turf/open/floor/iron/dark,
/area/template_noop)
"X" = (
/obj/structure/closet/cardboard,
/obj/effect/decal/cleanable/dirt,
/obj/effect/decal/cleanable/blood/old,
/obj/effect/turf_decal/tile/neutral/half/contrasted{
	dir = 8
	},
/turf/open/floor/iron/dark,
/area/template_noop)
"Z" = (
/obj/structure/closet/crate/coffin,
/obj/effect/decal/cleanable/cobweb/cobweb2,
/obj/effect/decal/cleanable/dirt,
/obj/effect/turf_decal/delivery,
/obj/effect/turf_decal/tile/neutral/half/contrasted{
	dir = 1
	},
/turf/open/floor/iron/dark,
/area/template_noop)

(1,1,1) = {"
n
B
t
U
D
"}
(2,1,1) = {"
X
w
R
u
J
"}
(3,1,1) = {"
y
Z
i
G
h
"}
