//MAP CONVERTED BY dmm2tgm.py THIS HEADER COMMENT PREVENTS RECONVERSION, DO NOT REMOVE
"b" = (
/turf/open/floor/wood,
/area/template_noop)
"c" = (
/obj/effect/decal/cleanable/cobweb/cobweb2,
/obj/effect/turf_decal/stripes/corner,
/obj/machinery/photocopier,
/obj/item/newspaper{
	pixel_x = 4;
	pixel_y = 4
	},
/obj/item/newspaper,
/turf/open/floor/wood{
	broken = 1
	},
/area/template_noop)
"f" = (
/obj/effect/spawner/random/unsorted/trap,
/turf/open/floor/wood,
/area/template_noop)
"g" = (
/obj/structure/chair/office{
	dir = 8
	},
/obj/effect/trap/nexus/trickyspawner/shitsec,
/turf/open/floor/carpet/green,
/area/template_noop)
"i" = (
/obj/effect/decal/cleanable/blood/old,
/obj/effect/decal/remains/human,
/obj/item/clothing/neck/tie/detective,
/turf/open/floor/carpet/green,
/area/template_noop)
"j" = (
/obj/effect/turf_decal/stripes/corner{
	dir = 4
	},
/obj/machinery/light/small{
	dir = 4
	},
/turf/open/floor/carpet/green,
/area/template_noop)
"l" = (
/obj/effect/turf_decal/stripes/line{
	dir = 4
	},
/obj/effect/decal/cleanable/blood/old,
/obj/effect/spawner/random/unsorted/trap,
/turf/open/floor/carpet/green,
/area/template_noop)
"u" = (
/obj/structure/closet/secure_closet/personal/cabinet,
/obj/item/clothing/suit/jacket{
	desc = "All the class of a trenchcoat without the security fibers.";
	icon_state = "greydet";
	name = "trenchcoat"
	},
/obj/item/clothing/suit/jacket{
	desc = "All the class of a trenchcoat without the security fibers.";
	icon_state = "detective";
	name = "trenchcoat"
	},
/obj/item/clothing/head/fedora,
/obj/item/clothing/head/fedora{
	icon_state = "detective"
	},
/obj/effect/decal/cleanable/dirt,
/obj/effect/turf_decal/tile/neutral/half/contrasted,
/turf/open/floor/iron/dark,
/area/template_noop)
"x" = (
/obj/structure/filingcabinet,
/obj/effect/turf_decal/bot_white,
/obj/effect/decal/cleanable/dirt,
/obj/effect/turf_decal/tile/neutral/half/contrasted{
	dir = 4
	},
/turf/open/floor/iron/dark,
/area/template_noop)
"H" = (
/obj/effect/decal/cleanable/dirt,
/obj/effect/turf_decal/tile/neutral/half/contrasted{
	dir = 4
	},
/turf/open/floor/iron/dark,
/area/template_noop)
"T" = (
/obj/structure/frame/computer{
	anchored = 1;
	dir = 4;
	icon_state = "0"
	},
/obj/effect/turf_decal/bot_white,
/obj/structure/noticeboard{
	dir = 4;
	pixel_x = -27
	},
/obj/effect/decal/cleanable/dirt,
/obj/effect/turf_decal/tile/neutral/half/contrasted,
/turf/open/floor/iron/dark,
/area/template_noop)
"X" = (
/obj/structure/frame/computer{
	anchored = 1;
	dir = 4;
	icon_state = "0"
	},
/obj/effect/turf_decal/bot_white,
/obj/machinery/newscaster{
	pixel_x = -30
	},
/obj/effect/decal/cleanable/dirt,
/obj/effect/turf_decal/tile/neutral/half/contrasted,
/turf/open/floor/iron/dark,
/area/template_noop)
"Y" = (
/obj/effect/turf_decal/bot_white,
/obj/effect/decal/cleanable/dirt,
/obj/effect/turf_decal/tile/neutral/half/contrasted,
/turf/open/floor/iron/dark,
/area/template_noop)
"Z" = (
/obj/structure/table/wood,
/obj/item/storage/box/evidence{
	pixel_y = 4
	},
/obj/item/taperecorder{
	pixel_x = 4;
	pixel_y = 4
	},
/obj/item/grenade/flashbang,
/obj/effect/decal/cleanable/dirt,
/obj/effect/turf_decal/tile/neutral{
	dir = 4
	},
/turf/open/floor/iron/dark,
/area/template_noop)

(1,1,1) = {"
u
X
Y
T
Z
"}
(2,1,1) = {"
f
b
g
i
H
"}
(3,1,1) = {"
c
b
l
j
x
"}
