//MAP CONVERTED BY dmm2tgm.py THIS HEADER COMMENT PREVENTS RECONVERSION, DO NOT REMOVE
"a" = (
/obj/structure/closet/l3closet,
/obj/effect/turf_decal/delivery,
/obj/effect/decal/cleanable/dirt,
/turf/open/floor/iron,
/area/template_noop)
"b" = (
/obj/effect/decal/cleanable/dirt,
/turf/open/floor/iron,
/area/template_noop)
"c" = (
/obj/machinery/shower{
	dir = 8
	},
/turf/open/floor/noslip/standard,
/area/template_noop)
"d" = (
/obj/machinery/light/small{
	brightness = 3;
	dir = 8
	},
/obj/machinery/iv_drip,
/turf/open/floor/iron,
/area/template_noop)
"e" = (
/obj/structure/sink{
	dir = 4;
	pixel_x = 11
	},
/obj/effect/decal/cleanable/dirt,
/turf/open/floor/iron,
/area/template_noop)
"f" = (
/obj/effect/turf_decal/stripes/line{
	dir = 9
	},
/turf/open/floor/iron/white,
/area/template_noop)
"g" = (
/obj/effect/turf_decal/stripes/line{
	dir = 1
	},
/obj/effect/trap/nexus/trickyspawner/catbutcher,
/obj/effect/spawner/random/unsorted/trap,
/turf/open/floor/iron/white,
/area/template_noop)
"h" = (
/obj/effect/turf_decal/stripes/line{
	dir = 5
	},
/obj/effect/decal/cleanable/dirt,
/turf/open/floor/iron/white,
/area/template_noop)
"i" = (
/obj/structure/table/optable,
/obj/effect/turf_decal/stripes/corner{
	dir = 1
	},
/obj/effect/decal/cleanable/blood/old,
/obj/effect/mob_spawn/human/corpse/charredskeleton,
/turf/open/floor/iron/white,
/area/template_noop)
"j" = (
/obj/effect/decal/cleanable/dirt,
/turf/open/floor/iron/white,
/area/template_noop)
"k" = (
/obj/structure/table/glass,
/obj/item/surgical_drapes,
/obj/item/scalpel,
/obj/item/hemostat,
/obj/effect/turf_decal/stripes/corner{
	dir = 4
	},
/obj/effect/decal/cleanable/dirt,
/turf/open/floor/iron/white,
/area/template_noop)
"l" = (
/obj/effect/decal/cleanable/dirt,
/obj/structure/frame/computer{
	icon_state = "0";
	dir = 4
	},
/turf/open/floor/iron/white,
/area/template_noop)
"m" = (
/turf/open/floor/iron/white,
/area/template_noop)
"n" = (
/obj/structure/closet/crate/freezer,
/obj/effect/decal/cleanable/blood/old,
/obj/item/organ/eyes,
/obj/item/organ/eyes/apid,
/obj/item/organ/eyes/moth,
/obj/item/organ/eyes/robotic,
/obj/effect/spawner/random/medical/teratoma/major,
/turf/open/floor/iron/white,
/area/template_noop)

(1,1,1) = {"
a
d
f
i
l
"}
(2,1,1) = {"
b
b
g
j
m
"}
(3,1,1) = {"
c
e
h
k
n
"}
