//MAP CONVERTED BY dmm2tgm.py THIS HEADER COMMENT PREVENTS RECONVERSION, DO NOT REMOVE
"a" = (
/obj/machinery/vending/autodrobe,
/turf/open/floor/mineral/bananium,
/area/template_noop)
"b" = (
/turf/open/floor/mineral/bananium,
/area/template_noop)
"c" = (
/obj/structure/dresser,
/obj/item/flashlight/lamp/bananalamp{
	pixel_x = -2;
	pixel_y = 17
	},
/turf/open/floor/mineral/bananium,
/area/template_noop)
"d" = (
/obj/structure/closet/crate/wooden/toy,
/turf/open/floor/mineral/bananium,
/area/template_noop)
"e" = (
/obj/effect/spawner/random/unsorted/trap/clowntrap,
/turf/open/floor/mineral/bananium,
/area/template_noop)
"f" = (
/turf/closed/wall/mineral/bananium,
/area/template_noop)
"g" = (
/turf/open/floor/carpet/orange,
/area/template_noop)
"h" = (
/obj/machinery/light/small{
	dir = 1
	},
/mob/living/simple_animal/cluwne{
	name = "Hank"
	},
/turf/open/floor/carpet/orange,
/area/template_noop)
"i" = (
/obj/structure/bed,
/obj/item/bedsheet/clown,
/obj/machinery/light_switch{
	pixel_x = 20
	},
/turf/open/floor/carpet/orange,
/area/template_noop)
"j" = (
/obj/machinery/door/airlock/bananium/glass,
/obj/effect/trap/trigger/random,
/turf/open/floor/iron/stairs/old,
/area/template_noop)

(1,1,1) = {"
a
b
b
j
g
"}
(2,1,1) = {"
b
e
b
f
h
"}
(3,1,1) = {"
c
d
b
f
i
"}
