//MAP CONVERTED BY dmm2tgm.py THIS HEADER COMMENT PREVENTS RECONVERSION, DO NOT REMOVE
"a" = (
/obj/effect/decal/cleanable/blood/gibs/old{
	dir = 4
	},
/obj/item/ammo_casing/spent{
	dir = 1
	},
/turf/open/floor/plating,
/area/template_noop)
"b" = (
/obj/effect/decal/cleanable/blood/footprints{
	dir = 4
	},
/obj/effect/decal/cleanable/blood/old{
	dir = 4
	},
/obj/effect/spawner/lootdrop/trap{
	dir = 1
	},
/turf/open/floor/plating,
/area/template_noop)
"c" = (
/turf/open/floor/plating,
/area/template_noop)
"d" = (
/turf/open/floor/plating{
	icon_state = "panelscorched"
	},
/area/template_noop)
"e" = (
/obj/effect/decal/cleanable/blood/tracks{
	dir = 4
	},
/obj/item/ammo_casing/spent{
	dir = 1
	},
/turf/open/floor/plating{
	icon_state = "platingdmg2"
	},
/area/template_noop)
"f" = (
/turf/open/floor/plating{
	icon_state = "platingdmg1"
	},
/area/template_noop)
"g" = (
/obj/item/ammo_casing/shotgun/improvised{
	dir = 1
	},
/obj/effect/spawner/lootdrop/trap{
	dir = 1
	},
/turf/open/floor/plating,
/area/template_noop)
"h" = (
/obj/item/clothing/suit/armor/reactive/table{
	name = "reactive tableport armor";
	tele_range = 2;
	dir = 1
	},
/obj/item/gun/ballistic/shotgun/doublebarrel/improvised{
	dir = 1
	},
/obj/effect/mob_spawn/human/corpse/assistant{
	dir = 1
	},
/obj/effect/decal/cleanable/blood/gibs/core{
	dir = 4
	},
/obj/effect/decal/cleanable/blood/old{
	dir = 4
	},
/obj/effect/trap/nexus/trickyspawner/shitsec{
	dir = 1
	},
/turf/open/floor/plating{
	icon_state = "platingdmg1"
	},
/area/template_noop)
"i" = (
/obj/item/trash/raisins{
	dir = 1
	},
/obj/effect/spawner/lootdrop/trap{
	dir = 1
	},
/turf/open/floor/plating,
/area/template_noop)
"j" = (
/obj/item/trash/syndi_cakes{
	dir = 1
	},
/turf/open/floor/plating{
	icon_state = "panelscorched"
	},
/area/template_noop)
"k" = (
/obj/effect/decal/cleanable/blood/gibs/up{
	dir = 4
	},
/turf/open/floor/plating,
/area/template_noop)
"l" = (
/obj/effect/spawner/lootdrop/trap{
	dir = 1
	},
/turf/open/floor/plating,
/area/template_noop)
"T" = (
/obj/effect/decal/cleanable/blood/old{
	dir = 4
	},
/turf/open/floor/plating{
	icon_state = "panelscorched"
	},
/area/template_noop)

(1,1,1) = {"
c
j
g
d
a"}(2,1,1) = {"
l
T
h
e
b"}(3,1,1) = {"
k
c
i
f
c"}