//MAP CONVERTED BY dmm2tgm.py THIS HEADER COMMENT PREVENTS RECONVERSION, DO NOT REMOVE
"a" = (
/obj/machinery/vending/autodrobe{
	dir = 1
	},
/turf/open/floor/mineral/bananium,
/area/template_noop)
"b" = (
/turf/open/floor/mineral/bananium,
/area/template_noop)
"c" = (
/obj/structure/dresser{
	dir = 1
	},
/obj/item/flashlight/lamp/bananalamp{
	pixel_x = -2;
	pixel_y = -17;
	dir = 1
	},
/turf/open/floor/mineral/bananium,
/area/template_noop)
"d" = (
/obj/structure/closet/crate/wooden/toy{
	dir = 1
	},
/turf/open/floor/mineral/bananium,
/area/template_noop)
"e" = (
/obj/effect/spawner/lootdrop/clowntrap{
	dir = 1
	},
/turf/open/floor/mineral/bananium,
/area/template_noop)
"f" = (
/turf/closed/wall/mineral/bananium,
/area/template_noop)
"g" = (
/turf/open/floor/carpet/orange,
/area/template_noop)
"h" = (
/obj/machinery/light/small{
	dir = 2
	},
/mob/living/simple_animal/cluwne{
	name = "Hank"
	},
/turf/open/floor/carpet/orange,
/area/template_noop)
"i" = (
/obj/structure/bed{
	dir = 1
	},
/obj/item/bedsheet/clown{
	dir = 1
	},
/obj/machinery/light_switch{
	pixel_x = 20;
	dir = 1
	},
/turf/open/floor/carpet/orange,
/area/template_noop)
"j" = (
/obj/machinery/door/airlock/bananium/glass{
	dir = 1
	},
/obj/effect/trap/trigger/random{
	dir = 1
	},
/turf/open/floor/plasteel/stairs/old,
/area/template_noop)

(1,1,1) = {"
g
j
b
b
a"}(2,1,1) = {"
h
f
b
e
b"}(3,1,1) = {"
i
f
b
d
c"}