"a" = (/obj/structure/table/wood/fancy/royalblue,/obj/item/instrument/violin/golden{pixel_y = 12},/turf/open/floor/mineral/diamond,/area/template_noop)
"b" = (/obj/structure/safe{pixel_x = 4},/obj/item/stack/spacecash/c1000,/obj/item/stack/spacecash/c1000,/obj/item/stack/spacecash/c1000,/obj/item/coin/adamantine,/obj/item/coin/bananium,/obj/item/coin/diamond,/obj/item/coin/mythril,/turf/open/floor/mineral/diamond,/area/template_noop)
"j" = (/turf/open/floor/mineral/diamond,/area/template_noop)
"k" = (/obj/structure/table/wood/fancy/royalblue,/obj/item/clothing/accessory/medal/gold{pixel_y = 5},/turf/open/floor/mineral/diamond,/area/template_noop)
"q" = (/obj/vehicle/ridden/bicycle{can_buckle = 0; dir = 4},/turf/open/floor/mineral/diamond,/area/template_noop)
"y" = (/obj/structure/table/wood/fancy/royalblue,/obj/item/bikehorn/golden{pixel_x = -7; pixel_y = 10},/turf/open/floor/mineral/diamond,/area/template_noop)
"z" = (/obj/structure/table/wood/fancy/royalblue,/obj/item/reagent_containers/food/drinks/trophy/gold_cup{pixel_y = 10},/turf/open/floor/mineral/diamond,/area/template_noop)
"J" = (/obj/structure/table/wood/fancy/royalblue,/obj/item/clothing/glasses/sunglasses/advanced/gar,/turf/open/floor/mineral/diamond,/area/template_noop)
"Q" = (/obj/structure/table/wood/fancy/royalblue,/obj/item/reagent_containers/food/drinks/bottle/lizardwine{pixel_x = -4; pixel_y = 15},/obj/item/reagent_containers/food/drinks/drinkingglass{pixel_x = 5; pixel_y = 4},/obj/item/reagent_containers/food/drinks/bottle/absinthe/premium{pixel_x = -7; pixel_y = 5},/turf/open/floor/mineral/diamond,/area/template_noop)

(1,1,1) = {"
yjk
qjb
jjj
Qjz
ajJ
"}
