//MAP CONVERTED BY dmm2tgm.py THIS HEADER COMMENT PREVENTS RECONVERSION, DO NOT REMOVE
"a" = (
/obj/effect/decal/cleanable/dirt,
/obj/item/stack/cable_coil/random/five,
/turf/open/floor/iron,
/area/template_noop)
"b" = (
/obj/effect/decal/cleanable/dirt,
/obj/effect/decal/cleanable/blood/old,
/turf/open/floor/iron,
/area/template_noop)
"c" = (
/obj/structure/extinguisher_cabinet{
	dir = 4;
	pixel_x = 24
	},
/obj/effect/decal/cleanable/dirt,
/obj/item/clothing/glasses/welding,
/turf/open/floor/iron,
/area/template_noop)
"d" = (
/obj/effect/turf_decal/bot,
/obj/structure/mecha_wreckage/durand,
/obj/effect/decal/cleanable/dirt,
/turf/open/floor/iron,
/area/template_noop)
"e" = (
/obj/effect/decal/cleanable/dirt,
/obj/effect/decal/cleanable/oil,
/turf/open/floor/iron,
/area/template_noop)
"f" = (
/obj/effect/turf_decal/stripes/line,
/obj/effect/decal/cleanable/dirt,
/obj/effect/decal/cleanable/oil,
/turf/open/floor/iron,
/area/template_noop)
"g" = (
/obj/effect/turf_decal/stripes/line,
/obj/effect/decal/cleanable/dirt,
/turf/open/floor/iron,
/area/template_noop)
"h" = (
/obj/structure/table,
/obj/item/stock_parts/capacitor{
	pixel_y = -4
	},
/obj/item/stock_parts/scanning_module{
	pixel_x = 3;
	pixel_y = 5
	},
/obj/effect/decal/cleanable/dirt,
/turf/open/floor/iron/white,
/area/template_noop)
"i" = (
/obj/effect/decal/cleanable/dirt,
/turf/open/floor/iron/white,
/area/template_noop)
"j" = (
/obj/structure/reagent_dispensers/fueltank,
/obj/effect/decal/cleanable/dirt,
/turf/open/floor/iron/white,
/area/template_noop)
"k" = (
/obj/structure/table,
/obj/item/weldingtool,
/obj/item/crowbar,
/obj/effect/decal/cleanable/dirt,
/turf/open/floor/iron/white,
/area/template_noop)
"l" = (
/obj/structure/closet,
/obj/effect/spawner/random/maintenance/four,
/obj/effect/decal/cleanable/dirt,
/turf/open/floor/iron/white,
/area/template_noop)
"m" = (
/obj/effect/decal/cleanable/dirt,
/obj/machinery/light/small{
	brightness = 3;
	dir = 8
	},
/obj/effect/decal/cleanable/blood/old,
/turf/open/floor/iron,
/area/template_noop)

(1,1,1) = {"
a
m
f
h
k
"}
(2,1,1) = {"
b
d
g
i
i
"}
(3,1,1) = {"
c
e
g
j
l
"}
