//MAP CONVERTED BY dmm2tgm.py THIS HEADER COMMENT PREVENTS RECONVERSION, DO NOT REMOVE
"a" = (
/turf/template_noop,
/area/template_noop)
"b" = (
/obj/machinery/shuttle/engine/plasma{
	dir = 4
	},
/turf/closed/wall/mineral/titanium,
/area/shuttle/transport)
"c" = (
/turf/closed/wall/mineral/titanium,
/area/shuttle/transport)
"d" = (
/obj/structure/window/shuttle,
/obj/structure/grille,
/turf/open/floor/plating,
/area/shuttle/transport)
"e" = (
/obj/effect/spawner/structure/window/shuttle,
/turf/open/floor/plating,
/area/shuttle/transport)
"f" = (
/obj/machinery/atmospherics/pipe/simple/supplymain/hidden{
	dir = 9
	},
/turf/closed/wall/mineral/titanium,
/area/shuttle/transport)
"j" = (
/obj/structure/chair/fancy/shuttle,
/turf/open/floor/mineral/titanium/blue,
/area/shuttle/transport)
"k" = (
/obj/structure/fans/tiny,
/obj/machinery/door/airlock/titanium,
/turf/open/floor/mineral/titanium/blue,
/area/shuttle/transport)
"l" = (
/turf/open/floor/mineral/titanium/blue,
/area/shuttle/transport)
"m" = (
/obj/machinery/door/airlock/titanium,
/obj/structure/fans/tiny,
/obj/docking_port/mobile{
	dir = 8;
	dwidth = 2;
	faction_type = /datum/faction/nanotrasen/central_command;
	height = 12;
	id = "ferry";
	name = "ferry shuttle";
	port_direction = 2;
	width = 5
	},
/turf/open/floor/mineral/titanium/blue,
/area/shuttle/transport)
"o" = (
/obj/machinery/atmospherics/components/unary/shuttle/engine_heater{
	dir = 4
	},
/turf/closed/wall/mineral/titanium,
/area/shuttle/transport)
"q" = (
/obj/structure/chair/fancy/shuttle{
	dir = 1
	},
/turf/open/floor/mineral/titanium/blue,
/area/shuttle/transport)
"r" = (
/obj/machinery/computer/shuttle_flight/ferry/request{
	dir = 8
	},
/obj/machinery/atmospherics/pipe/manifold/supplymain/hidden{
	dir = 4
	},
/turf/open/floor/mineral/titanium/blue,
/area/shuttle/transport)
"s" = (
/obj/structure/closet/crate,
/obj/machinery/atmospherics/pipe/manifold/supplymain/hidden{
	dir = 4
	},
/turf/open/floor/mineral/titanium/blue,
/area/shuttle/transport)
"t" = (
/obj/machinery/atmospherics/components/unary/shuttle/engine_heater{
	dir = 4
	},
/turf/closed/wall/mineral/titanium/interior,
/area/shuttle/transport)
"B" = (
/obj/structure/closet/crate,
/obj/machinery/atmospherics/pipe/simple/supplymain/hidden{
	dir = 4
	},
/turf/open/floor/mineral/titanium/blue,
/area/shuttle/transport)
"C" = (
/obj/structure/chair/fancy/shuttle{
	dir = 4
	},
/turf/open/floor/mineral/titanium/blue,
/area/shuttle/transport)
"F" = (
/obj/machinery/atmospherics/pipe/simple/supplymain/hidden{
	dir = 4
	},
/obj/structure/chair/fancy/shuttle{
	dir = 4
	},
/turf/open/floor/mineral/titanium/blue,
/area/shuttle/transport)
"K" = (
/obj/machinery/atmospherics/pipe/manifold/supplymain/hidden{
	dir = 8
	},
/turf/open/floor/mineral/titanium/blue,
/area/shuttle/transport)
"O" = (
/obj/machinery/atmospherics/pipe/simple/supplymain/hidden{
	dir = 10
	},
/turf/closed/wall/mineral/titanium,
/area/shuttle/transport)
"R" = (
/obj/machinery/computer/locator{
	dir = 8
	},
/turf/open/floor/mineral/titanium/blue,
/area/shuttle/transport)
"V" = (
/obj/machinery/atmospherics/components/unary/portables_connector{
	dir = 1
	},
/obj/machinery/portable_atmospherics/canister/toxins{
	filled = 1;
	starter_temp = 50
	},
/obj/effect/mapping_helpers/auto_wrench,
/turf/open/floor/mineral/titanium/blue,
/area/shuttle/transport)
"Y" = (
/obj/machinery/atmospherics/pipe/manifold/supplymain/hidden{
	dir = 1
	},
/turf/open/floor/mineral/titanium/blue,
/area/shuttle/transport)
"Z" = (
/obj/machinery/atmospherics/pipe/simple/supplymain/hidden{
	dir = 10
	},
/turf/open/floor/mineral/titanium/blue,
/area/shuttle/transport)

(1,1,1) = {"
a
b
k
b
a
"}
(2,1,1) = {"
b
t
l
t
b
"}
(3,1,1) = {"
o
F
l
B
o
"}
(4,1,1) = {"
O
r
K
s
f
"}
(5,1,1) = {"
d
C
Y
V
d
"}
(6,1,1) = {"
c
R
Z
V
c
"}
(7,1,1) = {"
c
l
l
l
c
"}
(8,1,1) = {"
c
j
l
q
c
"}
(9,1,1) = {"
e
j
l
q
e
"}
(10,1,1) = {"
c
j
l
q
c
"}
(11,1,1) = {"
c
j
l
q
c
"}
(12,1,1) = {"
c
d
m
d
c
"}
