//MAP CONVERTED BY dmm2tgm.py THIS HEADER COMMENT PREVENTS RECONVERSION, DO NOT REMOVE
"d" = (
/obj/effect/decal/cleanable/dirt/dust,
/obj/effect/spawner/structure/window/hollow/survival_pod/directional{
	dir = 8
	},
/turf/open/floor/plating,
/area/shuttle/mining)
"f" = (
/obj/effect/decal/cleanable/dirt/dust,
/obj/effect/decal/cleanable/dirt/dust,
/obj/structure/shuttle/engine/heater{
	dir = 4
	},
/obj/effect/spawner/structure/window/survival_pod,
/turf/open/floor/plating,
/area/shuttle/mining)
"g" = (
/obj/structure/shuttle/engine/heater{
	dir = 4
	},
/obj/effect/spawner/structure/window/survival_pod,
/turf/open/floor/plating,
/area/shuttle/mining)
"i" = (
/turf/closed/wall/mineral/titanium/survival,
/area/shuttle/mining)
"k" = (
/obj/machinery/computer/shuttle_flight/mining{
	dir = 4
	},
/obj/machinery/requests_console{
	department = "Cargo Bay";
	departmentType = 2;
	pixel_x = -1;
	pixel_y = -35
	},
/obj/machinery/light,
/turf/open/floor/pod/dark,
/area/shuttle/mining)
"p" = (
/obj/structure/chair/fancy/shuttle{
	dir = 8
	},
/obj/effect/turf_decal/box/white,
/turf/open/floor/pod/light,
/area/shuttle/mining)
"q" = (
/obj/effect/spawner/structure/window/hollow/survival_pod/directional{
	dir = 1
	},
/turf/open/floor/plating,
/area/shuttle/mining)
"t" = (
/obj/effect/decal/cleanable/dirt/dust,
/obj/effect/decal/cleanable/dirt/dust,
/obj/structure/closet/crate/miningcar{
	pixel_x = 1;
	pixel_y = 2
	},
/obj/machinery/camera/autoname{
	dir = 1;
	network = list("ss13","cargo")
	},
/obj/item/storage/pod{
	pixel_x = 38;
	unlocked = 1
	},
/obj/effect/turf_decal/loading_area{
	dir = 4
	},
/obj/effect/turf_decal/stripes/line{
	dir = 8
	},
/turf/open/floor/plasteel/tech/grid,
/area/shuttle/mining)
"A" = (
/obj/structure/table/reinforced,
/obj/machinery/newscaster{
	pixel_y = 34
	},
/obj/item/storage/firstaid/regular{
	pixel_x = -5;
	pixel_y = 8
	},
/obj/item/storage/toolbox/emergency,
/obj/machinery/light{
	dir = 1
	},
/turf/open/floor/pod/dark,
/area/shuttle/mining)
"D" = (
/obj/effect/decal/cleanable/dirt/dust,
/obj/structure/shuttle/engine/propulsion/burst{
	dir = 4
	},
/turf/open/floor/plating/airless,
/area/shuttle/mining)
"G" = (
/obj/structure/shuttle/engine/propulsion/burst{
	dir = 4
	},
/turf/open/floor/plating/airless,
/area/shuttle/mining)
"I" = (
/turf/closed/wall/mineral/titanium/survival/nodiagonal,
/area/shuttle/mining)
"J" = (
/obj/docking_port/mobile{
	dir = 8;
	dwidth = 3;
	height = 5;
	id = "mining";
	name = "mining shuttle";
	port_direction = 4;
	width = 7
	},
/obj/machinery/door/airlock/survival_pod/glass{
	dir = 4
	},
/obj/structure/fans/tiny,
/turf/open/floor/plating,
/area/shuttle/mining)
"K" = (
/obj/effect/decal/cleanable/dirt/dust,
/turf/closed/wall/mineral/titanium/survival/nodiagonal,
/area/shuttle/mining)
"Q" = (
/obj/effect/decal/cleanable/dirt/dust,
/obj/structure/chair/fancy/shuttle{
	dir = 8
	},
/obj/effect/turf_decal/box,
/turf/open/floor/pod/light,
/area/shuttle/mining)
"S" = (
/obj/effect/decal/cleanable/dirt/dust,
/turf/closed/wall/mineral/titanium/survival,
/area/shuttle/mining)
"U" = (
/obj/effect/spawner/structure/window/hollow/survival_pod/directional{
	dir = 8
	},
/turf/open/floor/plating,
/area/shuttle/mining)
"Y" = (
/obj/structure/ore_box,
/obj/item/shovel{
	pixel_x = 4;
	pixel_y = -1
	},
/obj/effect/turf_decal/loading_area{
	dir = 4
	},
/obj/effect/turf_decal/stripes/line{
	dir = 8
	},
/turf/open/floor/plasteel/tech/grid,
/area/shuttle/mining)

(1,1,1) = {"
i
U
d
S
"}
(2,1,1) = {"
S
A
k
S
"}
(3,1,1) = {"
q
p
Q
J
"}
(4,1,1) = {"
g
Y
t
f
"}
(5,1,1) = {"
D
I
K
G
"}
