//MAP CONVERTED BY dmm2tgm.py THIS HEADER COMMENT PREVENTS RECONVERSION, DO NOT REMOVE
"a" = (
/turf/closed/mineral/random/high_chance,
/area/exploration_away/outside)
"p" = (
/turf/template_noop,
/area/template_noop)

(1,1,1) = {"
p
p
p
a
p
p
p
p
p
p
p
p
p
p
p
p
p
p
p
p
p
p
"}
(2,1,1) = {"
p
p
a
a
a
p
p
p
p
p
p
p
p
p
p
p
p
p
p
p
p
p
"}
(3,1,1) = {"
p
a
a
a
a
a
p
p
p
p
p
p
p
p
p
p
p
p
p
p
p
p
"}
(4,1,1) = {"
a
a
a
a
a
p
p
p
p
p
a
a
a
p
p
p
p
p
p
p
p
p
"}
(5,1,1) = {"
a
a
a
a
a
p
p
p
p
p
a
a
a
a
p
p
p
p
p
p
p
p
"}
(6,1,1) = {"
p
a
a
p
p
p
p
p
p
p
p
a
a
a
p
p
p
p
p
p
p
p
"}
(7,1,1) = {"
p
p
p
p
p
p
p
p
p
p
p
a
a
a
a
p
p
p
p
p
p
p
"}
(8,1,1) = {"
p
p
p
p
p
p
p
p
p
p
p
a
a
a
a
p
p
p
a
a
p
p
"}
(9,1,1) = {"
p
p
p
p
p
p
p
p
p
p
p
a
a
a
a
a
p
a
a
a
a
p
"}
(10,1,1) = {"
p
p
p
p
p
p
p
p
p
p
a
a
a
a
a
a
a
a
a
a
a
p
"}
(11,1,1) = {"
p
p
p
p
p
p
p
p
p
a
a
a
a
a
a
a
a
a
a
a
a
a
"}
(12,1,1) = {"
p
p
p
p
p
a
a
a
p
a
a
a
a
a
p
p
a
a
a
a
a
a
"}
(13,1,1) = {"
p
p
p
a
a
a
a
a
a
a
a
a
a
a
p
p
a
a
a
a
a
a
"}
(14,1,1) = {"
p
p
p
a
a
a
a
a
a
a
a
a
p
p
p
p
p
a
a
a
a
a
"}
(15,1,1) = {"
p
p
p
p
a
a
a
a
a
a
a
p
p
p
p
p
p
p
a
a
p
p
"}
(16,1,1) = {"
p
p
p
p
a
a
a
a
a
a
p
p
p
p
p
p
p
p
a
a
p
p
"}
(17,1,1) = {"
p
p
p
p
p
p
a
a
a
p
p
p
p
p
p
p
p
p
p
p
p
p
"}
(18,1,1) = {"
p
p
p
p
p
p
p
p
p
p
p
p
p
p
a
a
p
p
p
p
p
p
"}
(19,1,1) = {"
p
p
p
p
p
p
p
p
p
p
p
p
p
a
a
a
p
p
p
p
p
p
"}
(20,1,1) = {"
p
p
p
p
p
p
p
p
p
p
p
p
a
a
a
a
a
p
p
p
p
p
"}
(21,1,1) = {"
p
p
p
p
p
p
p
p
p
p
p
p
a
a
a
a
a
a
a
a
p
p
"}
(22,1,1) = {"
p
p
p
p
p
p
p
p
p
p
p
p
p
a
a
a
a
a
a
p
p
p
"}
