//MAP CONVERTED BY dmm2tgm.py THIS HEADER COMMENT PREVENTS RECONVERSION, DO NOT REMOVE
"a" = (
/turf/open/floor/holofloor/monotile/dark,
/area/template_noop)
"b" = (
/obj/effect/turf_decal/caution/stand_clear/white,
/obj/structure/closet/crate,
/obj/item/bodypart/r_arm/robot,
/obj/item/bodypart/r_arm/robot,
/obj/item/bodypart/r_arm/robot,
/obj/item/bodypart/r_arm/robot,
/obj/item/bodypart/r_arm/robot,
/obj/item/bodypart/r_arm/robot,
/obj/item/bodypart/r_arm/robot,
/obj/item/bodypart/r_arm/robot,
/turf/open/floor/holofloor/monotile/steel,
/area/template_noop)
"c" = (
/obj/structure/table/reinforced,
/obj/item/reagent_containers/glass/bucket,
/obj/item/reagent_containers/glass/bucket,
/obj/item/reagent_containers/glass/bucket,
/obj/item/reagent_containers/glass/bucket,
/obj/item/screwdriver,
/turf/open/floor/holofloor/monotile/dark,
/area/template_noop)
"d" = (
/obj/structure/table/reinforced,
/obj/item/clothing/head/hardhat/red,
/obj/item/clothing/head/hardhat/red,
/obj/item/clothing/head/hardhat/red,
/obj/item/extinguisher,
/obj/item/extinguisher,
/obj/item/extinguisher,
/turf/open/floor/holofloor/monotile/dark,
/area/template_noop)
"e" = (
/obj/machinery/atmospherics/components/unary/vent_scrubber/on/layer4,
/turf/open/floor/holofloor/monotile/dark,
/area/template_noop)
"f" = (
/obj/effect/turf_decal/caution/stand_clear/white,
/obj/machinery/atmospherics/pipe/simple/scrubbers/hidden/layer4,
/obj/machinery/atmospherics/pipe/simple/supply/hidden/layer2,
/turf/open/floor/holofloor/monotile/steel,
/area/template_noop)
"h" = (
/obj/effect/decal/cleanable/dirt,
/turf/open/floor/holofloor/monotile/steel,
/area/template_noop)
"i" = (
/obj/machinery/atmospherics/pipe/simple/scrubbers/hidden/layer4{
	dir = 6
	},
/obj/machinery/atmospherics/pipe/simple/supply/hidden/layer2{
	dir = 10
	},
/turf/open/floor/holofloor/monotile/dark,
/area/template_noop)
"j" = (
/obj/structure/table/reinforced,
/obj/item/assembly/prox_sensor{
	pixel_x = 8;
	pixel_y = 10
	},
/obj/item/assembly/prox_sensor{
	pixel_x = -4;
	pixel_y = 8
	},
/obj/item/assembly/prox_sensor{
	pixel_x = 10;
	pixel_y = 3
	},
/obj/item/assembly/prox_sensor{
	pixel_x = 4;
	pixel_y = 6
	},
/obj/item/assembly/flash/handheld/weak{
	pixel_y = 5
	},
/obj/item/assembly/prox_sensor{
	pixel_x = -7;
	pixel_y = 1
	},
/obj/item/assembly/prox_sensor{
	pixel_x = 1;
	pixel_y = -2
	},
/obj/item/assembly/prox_sensor{
	pixel_x = 9;
	pixel_y = -2
	},
/turf/open/floor/holofloor/monotile/dark,
/area/template_noop)
"n" = (
/turf/open/floor/holofloor/monotile/steel,
/area/template_noop)
"s" = (
/obj/effect/turf_decal/bot,
/obj/machinery/atmospherics/pipe/simple/scrubbers/hidden/layer4{
	dir = 9
	},
/obj/item/tank/internals/oxygen,
/obj/item/tank/internals/oxygen,
/obj/item/tank/internals/oxygen,
/obj/item/analyzer,
/obj/item/analyzer,
/obj/item/analyzer,
/turf/open/floor/holofloor/monotile/dark,
/area/template_noop)
"t" = (
/obj/structure/table/reinforced,
/obj/item/bodypart/r_arm/robot,
/obj/item/bodypart/r_arm/robot,
/obj/item/bodypart/r_arm/robot,
/obj/item/bodypart/r_arm/robot,
/obj/item/bodypart/r_arm/robot,
/obj/item/bodypart/r_arm/robot,
/obj/item/assembly/prox_sensor{
	pixel_x = 9;
	pixel_y = -2
	},
/obj/item/assembly/prox_sensor{
	pixel_x = 9;
	pixel_y = -2
	},
/obj/item/assembly/prox_sensor{
	pixel_x = 9;
	pixel_y = -2
	},
/obj/item/assembly/prox_sensor{
	pixel_x = 9;
	pixel_y = -2
	},
/obj/item/assembly/prox_sensor{
	pixel_x = 9;
	pixel_y = -2
	},
/obj/item/assembly/prox_sensor{
	pixel_x = 9;
	pixel_y = -2
	},
/obj/item/assembly/prox_sensor{
	pixel_x = 9;
	pixel_y = -2
	},
/turf/open/floor/holofloor/monotile/dark,
/area/template_noop)
"w" = (
/obj/effect/decal/cleanable/oil/streak,
/turf/open/floor/holofloor/monotile/steel,
/area/template_noop)
"G" = (
/obj/structure/rack,
/obj/item/clothing/head/welding{
	pixel_x = -2;
	pixel_y = 3
	},
/obj/item/crowbar,
/obj/item/wrench,
/obj/item/weldingtool,
/turf/open/floor/holofloor/monotile/steel,
/area/template_noop)
"J" = (
/obj/effect/turf_decal/tile/purple/fourcorners,
/turf/open/floor/holofloor/monotile/dark,
/area/template_noop)
"N" = (
/obj/effect/turf_decal/bot,
/obj/effect/decal/cleanable/shreds,
/obj/machinery/atmospherics/pipe/simple/supply/hidden/layer2{
	dir = 5
	},
/obj/item/larryframe,
/obj/item/larryframe,
/obj/item/larryframe,
/obj/item/larryframe,
/turf/open/floor/holofloor/monotile/dark,
/area/template_noop)
"Q" = (
/obj/effect/decal/cleanable/dirt,
/obj/effect/turf_decal/tile/purple/fourcorners,
/turf/open/floor/holofloor/monotile/dark,
/area/template_noop)
"R" = (
/obj/effect/turf_decal/bot,
/obj/item/bot_assembly/firebot,
/turf/open/floor/holofloor/monotile/dark,
/area/template_noop)
"S" = (
/obj/item/stack/package_wrap,
/obj/item/stack/package_wrap,
/obj/item/stack/package_wrap,
/obj/structure/table/reinforced,
/turf/open/floor/holofloor/monotile/steel,
/area/template_noop)
"U" = (
/obj/structure/table/reinforced,
/obj/item/storage/firstaid/regular{
	empty = 1;
	name = "First-Aid (empty)";
	pixel_x = 6;
	pixel_y = 9
	},
/obj/item/storage/firstaid/regular{
	empty = 1;
	name = "First-Aid (empty)";
	pixel_x = 6;
	pixel_y = 6
	},
/obj/item/storage/firstaid/regular{
	empty = 1;
	name = "First-Aid (empty)";
	pixel_x = 6;
	pixel_y = 3
	},
/obj/item/healthanalyzer{
	pixel_x = -2;
	pixel_y = 10
	},
/obj/item/healthanalyzer{
	pixel_x = -1;
	pixel_y = 7
	},
/obj/item/healthanalyzer{
	pixel_y = 2
	},
/turf/open/floor/holofloor/monotile/dark,
/area/template_noop)
"W" = (
/obj/effect/decal/cleanable/dirt,
/obj/machinery/atmospherics/components/unary/vent_pump/on/layer2,
/turf/open/floor/holofloor/monotile/dark,
/area/template_noop)
"X" = (
/obj/effect/turf_decal/bot,
/obj/item/assembly/prox_sensor{
	pixel_x = 4;
	pixel_y = -5
	},
/obj/item/assembly/prox_sensor{
	pixel_x = 4;
	pixel_y = -5
	},
/turf/open/floor/holofloor/monotile/dark,
/area/template_noop)

(1,1,1) = {"
h
S
n
n
G
"}
(2,1,1) = {"
n
R
W
N
n
"}
(3,1,1) = {"
n
a
a
i
f
"}
(4,1,1) = {"
n
X
e
s
n
"}
(5,1,1) = {"
b
w
n
n
n
"}
(6,1,1) = {"
J
J
J
J
Q
"}
(7,1,1) = {"
t
c
U
j
d
"}
