//MAP CONVERTED BY dmm2tgm.py THIS HEADER COMMENT PREVENTS RECONVERSION, DO NOT REMOVE
"a" = (
/obj/structure/railing{
	dir = 1
	},
/obj/effect/turf_decal/siding/wideplating_new,
/turf/open/floor/holofloor,
/area/template_noop)
"b" = (
/obj/effect/turf_decal/tile/green/half/contrasted{
	dir = 8
	},
/obj/effect/turf_decal/siding/dark,
/turf/open/floor/holofloor/dark,
/area/template_noop)
"c" = (
/obj/effect/turf_decal/siding/wideplating_new{
	dir = 4
	},
/obj/structure/closet/crate,
/obj/item/clothing/gloves/boxing/green,
/obj/item/clothing/gloves/boxing,
/turf/open/floor/holofloor,
/area/template_noop)
"d" = (
/obj/effect/turf_decal/tile/green/half/contrasted{
	dir = 4
	},
/obj/effect/turf_decal/siding/dark{
	dir = 1
	},
/turf/open/floor/holofloor/dark,
/area/template_noop)
"e" = (
/obj/structure/railing{
	dir = 8
	},
/obj/effect/turf_decal/siding/wideplating_new{
	dir = 1
	},
/turf/open/floor/holofloor,
/area/template_noop)
"n" = (
/obj/effect/turf_decal/tile/red{
	dir = 1
	},
/obj/effect/turf_decal/tile/green{
	dir = 4
	},
/obj/effect/turf_decal/siding/dark{
	dir = 1
	},
/turf/open/floor/holofloor/dark,
/area/template_noop)
"o" = (
/obj/effect/turf_decal/tile/green/anticorner/contrasted,
/obj/effect/turf_decal/siding/dark{
	dir = 6
	},
/turf/open/floor/holofloor/dark,
/area/template_noop)
"r" = (
/obj/structure/railing/corner{
	dir = 1
	},
/obj/effect/turf_decal/siding/wideplating_new,
/turf/open/floor/holofloor,
/area/template_noop)
"t" = (
/obj/effect/turf_decal/siding/wideplating_new{
	dir = 6
	},
/obj/machinery/light/floor,
/turf/open/floor/holofloor,
/area/template_noop)
"u" = (
/obj/effect/turf_decal/tile/red/half/contrasted{
	dir = 4
	},
/obj/effect/turf_decal/siding/dark{
	dir = 1
	},
/turf/open/floor/holofloor/dark,
/area/template_noop)
"w" = (
/turf/open/floor/holofloor/dark,
/area/template_noop)
"z" = (
/obj/effect/turf_decal/tile/green/anticorner/contrasted{
	dir = 4
	},
/obj/effect/turf_decal/siding/dark{
	dir = 5
	},
/turf/open/floor/holofloor/dark,
/area/template_noop)
"D" = (
/obj/effect/turf_decal/tile/red/half/contrasted{
	dir = 8
	},
/obj/effect/turf_decal/siding/dark,
/turf/open/floor/holofloor/dark,
/area/template_noop)
"E" = (
/obj/effect/turf_decal/tile/red/anticorner/contrasted{
	dir = 8
	},
/obj/effect/turf_decal/siding/dark{
	dir = 10
	},
/turf/open/floor/holofloor/dark,
/area/template_noop)
"F" = (
/obj/effect/turf_decal/siding/wideplating_new{
	dir = 5
	},
/obj/structure/closet/crate,
/obj/item/clothing/mask/luchador,
/obj/item/clothing/mask/luchador,
/obj/item/clothing/mask/luchador/rudos,
/obj/item/clothing/mask/luchador/rudos,
/obj/item/clothing/mask/luchador/tecnicos,
/obj/item/clothing/mask/luchador/tecnicos,
/obj/machinery/light/floor,
/turf/open/floor/holofloor,
/area/template_noop)
"L" = (
/obj/effect/turf_decal/tile/red/anticorner/contrasted{
	dir = 1
	},
/obj/effect/turf_decal/siding/dark{
	dir = 9
	},
/obj/machinery/light/floor,
/turf/open/floor/holofloor/dark,
/area/template_noop)
"M" = (
/obj/effect/turf_decal/tile/red/half/contrasted{
	dir = 1
	},
/obj/effect/turf_decal/siding/dark{
	dir = 8
	},
/turf/open/floor/holofloor/dark,
/area/template_noop)
"O" = (
/obj/effect/turf_decal/tile/green/half/contrasted,
/obj/effect/turf_decal/siding/dark{
	dir = 4
	},
/turf/open/floor/holofloor/dark,
/area/template_noop)
"P" = (
/obj/effect/turf_decal/siding/wideplating_new{
	dir = 4
	},
/turf/open/floor/holofloor,
/area/template_noop)
"R" = (
/obj/structure/railing{
	dir = 8
	},
/turf/open/floor/holofloor,
/area/template_noop)
"U" = (
/obj/effect/turf_decal/tile/red{
	dir = 8
	},
/obj/effect/turf_decal/tile/green,
/obj/effect/turf_decal/siding/dark,
/turf/open/floor/holofloor/dark,
/area/template_noop)
"W" = (
/obj/structure/reagent_dispensers/water_cooler,
/obj/effect/turf_decal/siding/wideplating_new{
	dir = 4
	},
/turf/open/floor/holofloor,
/area/template_noop)
"Z" = (
/obj/structure/railing{
	dir = 1
	},
/obj/effect/turf_decal/siding/wideplating_new{
	dir = 10
	},
/obj/machinery/light/floor,
/turf/open/floor/holofloor,
/area/template_noop)

(1,1,1) = {"
L
M
M
E
Z
"}
(2,1,1) = {"
u
w
w
D
a
"}
(3,1,1) = {"
n
w
w
U
a
"}
(4,1,1) = {"
d
w
w
b
a
"}
(5,1,1) = {"
z
O
O
o
a
"}
(6,1,1) = {"
e
R
R
R
r
"}
(7,1,1) = {"
F
c
W
P
t
"}
