//MAP CONVERTED BY dmm2tgm.py THIS HEADER COMMENT PREVENTS RECONVERSION, DO NOT REMOVE
"a" = (
/obj/effect/turf_decal/tile/neutral/fourcorners,
/turf/open/floor/holofloor/monotile/steel,
/area/template_noop)
"b" = (
/obj/structure/table/reinforced,
/obj/effect/turf_decal/tile/dark_blue/fourcorners,
/obj/effect/turf_decal/stripes/line,
/obj/item/stack/package_wrap,
/obj/item/stack/package_wrap,
/obj/item/stack/package_wrap,
/obj/item/reagent_containers/cup/beaker/large,
/obj/item/reagent_containers/cup/beaker/large,
/turf/open/floor/holofloor/monotile/steel,
/area/template_noop)
"f" = (
/obj/structure/table/reinforced,
/obj/effect/turf_decal/tile/dark_blue/fourcorners,
/obj/effect/turf_decal/stripes/line{
	dir = 4
	},
/obj/item/soap,
/turf/open/floor/holofloor/monotile/steel,
/area/template_noop)
"h" = (
/turf/open/floor/holofloor/monotile/light,
/area/template_noop)
"r" = (
/obj/effect/turf_decal/bot,
/obj/effect/turf_decal/tile/neutral/fourcorners,
/obj/machinery/chem_heater,
/turf/open/floor/holofloor/monotile/steel,
/area/template_noop)
"t" = (
/obj/structure/reagent_dispensers/nutriment/fat/oil,
/obj/effect/turf_decal/tile/dark_blue/fourcorners,
/obj/structure/sign/poster/official/moth1{
	pixel_y = 32
	},
/obj/effect/turf_decal/stripes/corner{
	dir = 8
	},
/turf/open/floor/holofloor/monotile/steel,
/area/template_noop)
"u" = (
/obj/effect/turf_decal/bot,
/obj/effect/turf_decal/tile/dark_blue/fourcorners,
/obj/structure/closet/crate/freezer,
/obj/item/reagent_containers/condiment/flour,
/obj/item/reagent_containers/condiment/flour,
/obj/item/reagent_containers/condiment/flour,
/obj/item/reagent_containers/condiment/flour,
/obj/item/reagent_containers/condiment/flour,
/obj/effect/turf_decal/stripes/line{
	dir = 9
	},
/turf/open/floor/holofloor/monotile/steel,
/area/template_noop)
"v" = (
/obj/structure/table/reinforced,
/obj/machinery/reagentgrinder{
	pixel_x = -1;
	pixel_y = 8
	},
/obj/effect/turf_decal/tile/dark_blue/fourcorners,
/obj/effect/turf_decal/stripes/corner,
/obj/item/food/grown/apple,
/obj/item/food/grown/apple,
/obj/item/food/grown/apple,
/obj/item/food/grown/apple,
/turf/open/floor/holofloor/monotile/steel,
/area/template_noop)
"w" = (
/obj/structure/closet/crate/freezer,
/obj/effect/turf_decal/bot,
/obj/item/food/grown/berries,
/obj/item/food/grown/berries,
/obj/item/food/grown/berries,
/obj/item/food/grown/berries,
/obj/item/food/grown/berries,
/obj/item/food/grown/berries,
/obj/item/food/grown/berries,
/obj/effect/turf_decal/tile/dark_blue/fourcorners,
/obj/effect/turf_decal/stripes/line{
	dir = 10
	},
/turf/open/floor/holofloor/monotile/steel,
/area/template_noop)
"x" = (
/obj/structure/table/reinforced,
/obj/machinery/microwave,
/obj/effect/turf_decal/tile/neutral/fourcorners,
/turf/open/floor/holofloor/monotile/steel,
/area/template_noop)
"B" = (
/obj/effect/turf_decal/tile/dark_blue/fourcorners,
/obj/structure/reagent_dispensers/watertank/high,
/obj/effect/turf_decal/stripes/line{
	dir = 8
	},
/turf/open/floor/holofloor/monotile/steel,
/area/template_noop)
"F" = (
/obj/machinery/light/floor,
/turf/open/floor/holofloor/monotile/light,
/area/template_noop)
"G" = (
/obj/effect/turf_decal/stripes/line{
	dir = 5
	},
/obj/effect/turf_decal/tile/dark_blue/fourcorners,
/obj/structure/closet/crate/freezer,
/obj/item/storage/fancy/egg_box,
/obj/item/storage/fancy/egg_box,
/turf/open/floor/holofloor/monotile/light,
/area/template_noop)
"H" = (
/obj/machinery/deepfryer,
/obj/effect/turf_decal/bot,
/obj/effect/turf_decal/tile/dark_blue/fourcorners,
/obj/effect/turf_decal/stripes/line{
	dir = 8
	},
/turf/open/floor/holofloor/monotile/steel,
/area/template_noop)
"I" = (
/obj/structure/table/reinforced,
/obj/item/reagent_containers/condiment/peppermill{
	pixel_x = -8;
	pixel_y = 11
	},
/obj/item/reagent_containers/condiment/saltshaker{
	pixel_x = -9;
	pixel_y = 5
	},
/obj/effect/turf_decal/tile/neutral/fourcorners,
/obj/item/reagent_containers/condiment/sugar,
/obj/item/reagent_containers/condiment/sugar,
/obj/item/reagent_containers/condiment/sugar,
/obj/item/reagent_containers/condiment/sugar,
/obj/item/reagent_containers/condiment/sugar,
/turf/open/floor/holofloor/monotile/steel,
/area/template_noop)
"J" = (
/obj/effect/turf_decal/caution/stand_clear/white,
/obj/effect/turf_decal/tile/neutral/fourcorners,
/turf/open/floor/holofloor/monotile/steel,
/area/template_noop)
"K" = (
/obj/structure/table/reinforced,
/obj/effect/turf_decal/tile/dark_blue/fourcorners,
/obj/item/clipboard{
	name = "menu"
	},
/obj/item/paper,
/obj/item/hand_labeler,
/obj/effect/turf_decal/stripes/corner{
	dir = 4
	},
/turf/open/floor/holofloor/monotile/steel,
/area/template_noop)
"M" = (
/obj/structure/table/reinforced,
/obj/effect/turf_decal/tile/dark_blue/fourcorners,
/obj/item/food/piedough,
/obj/effect/turf_decal/stripes/line{
	dir = 4
	},
/obj/item/kitchen/rollingpin{
	pixel_x = 3;
	pixel_y = 5
	},
/turf/open/floor/holofloor/monotile/steel,
/area/template_noop)
"N" = (
/obj/effect/turf_decal/tile/dark_blue/fourcorners,
/obj/effect/turf_decal/stripes/line{
	dir = 6
	},
/obj/machinery/oven,
/turf/open/floor/holofloor/monotile/steel,
/area/template_noop)
"P" = (
/obj/structure/table/reinforced,
/obj/effect/turf_decal/tile/dark_blue/fourcorners,
/obj/effect/turf_decal/stripes/line{
	dir = 4
	},
/obj/item/reagent_containers/condiment/enzyme{
	pixel_x = -6;
	pixel_y = 5
	},
/obj/item/toy/figure/chef{
	pixel_x = 6
	},
/turf/open/floor/holofloor/monotile/steel,
/area/template_noop)
"Q" = (
/obj/effect/turf_decal/tile/neutral/fourcorners,
/obj/structure/rack,
/obj/item/knife/kitchen,
/obj/item/knife/kitchen,
/obj/item/lighter,
/obj/effect/turf_decal/tile/dark_blue/fourcorners,
/obj/effect/turf_decal/stripes/line{
	dir = 8
	},
/turf/open/floor/holofloor/monotile/steel,
/area/template_noop)
"V" = (
/obj/effect/turf_decal/bot,
/obj/effect/turf_decal/tile/dark_blue/fourcorners,
/obj/effect/turf_decal/stripes/corner{
	dir = 1
	},
/obj/structure/closet/crate/freezer,
/obj/item/food/meat/slab/meatproduct,
/obj/item/food/meat/slab/meatproduct,
/obj/item/food/meat/slab/meatproduct,
/obj/item/food/meat/slab/meatproduct,
/obj/item/food/meat/slab/meatproduct,
/turf/open/floor/holofloor/monotile/steel,
/area/template_noop)
"W" = (
/obj/effect/turf_decal/tile/neutral/fourcorners,
/turf/open/floor/holofloor/monotile/light,
/area/template_noop)
"Y" = (
/obj/effect/turf_decal/bot,
/obj/effect/turf_decal/tile/dark_blue/fourcorners,
/obj/structure/closet/crate/freezer,
/obj/item/reagent_containers/condiment/milk,
/obj/item/reagent_containers/condiment/milk,
/obj/item/reagent_containers/condiment/milk,
/obj/item/reagent_containers/condiment/milk,
/obj/item/reagent_containers/condiment/soymilk,
/obj/item/reagent_containers/condiment/soymilk,
/obj/effect/turf_decal/stripes/line,
/turf/open/floor/holofloor/monotile/steel,
/area/template_noop)

(1,1,1) = {"
v
M
f
P
K
"}
(2,1,1) = {"
b
F
h
h
G
"}
(3,1,1) = {"
N
h
r
h
a
"}
(4,1,1) = {"
W
h
I
h
J
"}
(5,1,1) = {"
w
h
x
h
a
"}
(6,1,1) = {"
Y
F
h
h
u
"}
(7,1,1) = {"
t
H
B
Q
V
"}
