//MAP CONVERTED BY dmm2tgm.py THIS HEADER COMMENT PREVENTS RECONVERSION, DO NOT REMOVE
"a" = (
/obj/effect/turf_decal/tile/neutral/fourcorners,
/turf/open/floor/holofloor/monotile/steel,
/area/template_noop)
"b" = (
/obj/structure/table/reinforced,
/obj/effect/turf_decal/tile/dark_blue/fourcorners,
/obj/effect/turf_decal/stripes/line,
/obj/item/radio/intercom{
	dir = 1;
	pixel_x = 1;
	pixel_y = 23
	},
/obj/item/stack/package_wrap,
/obj/item/stack/package_wrap,
/obj/item/stack/package_wrap,
/turf/open/floor/holofloor/monotile/steel,
/area/template_noop)
"c" = (
/obj/machinery/atmospherics/pipe/simple/supply/hidden/layer2{
	dir = 5
	},
/turf/open/floor/holofloor/monotile/light,
/area/template_noop)
"d" = (
/obj/effect/turf_decal/tile/dark_blue/fourcorners,
/obj/effect/turf_decal/stripes/line{
	dir = 4
	},
/obj/machinery/smartfridge/food,
/turf/open/floor/holofloor/monotile/steel,
/area/template_noop)
"e" = (
/obj/machinery/atmospherics/components/unary/vent_scrubber/on/layer4,
/turf/open/floor/holofloor/monotile/light,
/area/template_noop)
"f" = (
/obj/structure/table/reinforced,
/obj/effect/turf_decal/tile/dark_blue/fourcorners,
/obj/effect/turf_decal/stripes/line{
	dir = 4
	},
/obj/item/soap,
/turf/open/floor/holofloor/monotile/steel,
/area/template_noop)
"g" = (
/obj/machinery/atmospherics/pipe/simple/scrubbers/hidden/layer4{
	dir = 6
	},
/obj/machinery/atmospherics/pipe/simple/supply/hidden/layer2{
	dir = 10
	},
/turf/open/floor/holofloor/monotile/light,
/area/template_noop)
"h" = (
/turf/open/floor/holofloor/monotile/light,
/area/template_noop)
"l" = (
/obj/effect/turf_decal/bot,
/obj/effect/turf_decal/tile/dark_blue/fourcorners,
/obj/effect/turf_decal/stripes/line{
	dir = 9
	},
/obj/structure/closet/crate/freezer,
/obj/item/reagent_containers/food/condiment/milk,
/obj/item/reagent_containers/food/condiment/milk,
/obj/item/reagent_containers/food/condiment/milk,
/obj/item/reagent_containers/food/condiment/milk,
/obj/item/reagent_containers/food/condiment/milk,
/obj/item/reagent_containers/food/condiment/soymilk,
/obj/item/reagent_containers/food/condiment/soymilk,
/turf/open/floor/holofloor/monotile/steel,
/area/template_noop)
"o" = (
/obj/machinery/atmospherics/pipe/simple/scrubbers/hidden/layer4{
	dir = 8
	},
/turf/open/floor/holofloor/monotile/light,
/area/template_noop)
"q" = (
/obj/machinery/atmospherics/pipe/simple/scrubbers/hidden/layer4{
	dir = 9
	},
/turf/open/floor/holofloor/monotile/light,
/area/template_noop)
"r" = (
/obj/machinery/processor,
/obj/effect/turf_decal/bot,
/obj/effect/turf_decal/tile/neutral/fourcorners,
/turf/open/floor/holofloor/monotile/steel,
/area/template_noop)
"t" = (
/obj/structure/reagent_dispensers/cooking_oil,
/obj/effect/turf_decal/tile/dark_blue/fourcorners,
/obj/effect/turf_decal/stripes/line{
	dir = 8
	},
/obj/structure/sign/poster/official/moth1{
	pixel_y = 32
	},
/turf/open/floor/holofloor/monotile/steel,
/area/template_noop)
"u" = (
/obj/effect/turf_decal/bot,
/obj/effect/turf_decal/tile/dark_blue/fourcorners,
/obj/effect/turf_decal/stripes/line{
	dir = 1
	},
/obj/structure/closet/crate/freezer,
/obj/item/reagent_containers/food/condiment/flour,
/obj/item/reagent_containers/food/condiment/flour,
/obj/item/reagent_containers/food/condiment/flour,
/obj/item/reagent_containers/food/condiment/flour,
/obj/item/reagent_containers/food/condiment/flour,
/obj/item/reagent_containers/food/condiment/rice,
/obj/item/reagent_containers/food/condiment/rice,
/obj/item/reagent_containers/food/condiment/rice,
/turf/open/floor/holofloor/monotile/steel,
/area/template_noop)
"v" = (
/obj/structure/table/reinforced,
/obj/machinery/reagentgrinder{
	pixel_x = -1;
	pixel_y = 8
	},
/obj/effect/turf_decal/tile/dark_blue/fourcorners,
/obj/effect/turf_decal/stripes/corner,
/turf/open/floor/holofloor/monotile/steel,
/area/template_noop)
"x" = (
/obj/structure/table/reinforced,
/obj/machinery/microwave,
/obj/effect/turf_decal/tile/neutral/fourcorners,
/turf/open/floor/holofloor/monotile/steel,
/area/template_noop)
"y" = (
/obj/structure/sink{
	dir = 1;
	pixel_y = 28
	},
/obj/effect/turf_decal/tile/neutral/fourcorners,
/turf/open/floor/holofloor/monotile/steel,
/area/template_noop)
"z" = (
/obj/machinery/atmospherics/components/unary/vent_pump/on/layer2,
/turf/open/floor/holofloor/monotile/light,
/area/template_noop)
"B" = (
/obj/structure/table/reinforced,
/obj/effect/turf_decal/tile/dark_blue/fourcorners,
/obj/effect/turf_decal/stripes/line{
	dir = 8
	},
/turf/open/floor/holofloor/monotile/steel,
/area/template_noop)
"D" = (
/obj/machinery/atmospherics/pipe/simple/scrubbers/hidden/layer4,
/obj/machinery/atmospherics/pipe/simple/supply/hidden/layer2,
/obj/effect/turf_decal/caution/stand_clear/white,
/obj/effect/turf_decal/tile/neutral/fourcorners,
/turf/open/floor/holofloor/monotile/steel,
/area/template_noop)
"H" = (
/obj/machinery/deepfryer,
/obj/effect/turf_decal/bot,
/obj/effect/turf_decal/tile/dark_blue/fourcorners,
/obj/effect/turf_decal/stripes/line{
	dir = 8
	},
/turf/open/floor/holofloor/monotile/steel,
/area/template_noop)
"I" = (
/obj/structure/table/reinforced,
/obj/item/reagent_containers/food/condiment/peppermill{
	pixel_x = -8;
	pixel_y = 11
	},
/obj/item/reagent_containers/food/condiment/saltshaker{
	pixel_x = -9;
	pixel_y = 5
	},
/obj/effect/turf_decal/tile/neutral/fourcorners,
/obj/item/reagent_containers/food/condiment/enzyme,
/turf/open/floor/holofloor/monotile/steel,
/area/template_noop)
"K" = (
/obj/effect/turf_decal/tile/neutral/fourcorners,
/obj/structure/rack,
/obj/item/knife/kitchen,
/turf/open/floor/holofloor/monotile/steel,
/area/template_noop)
"M" = (
/obj/structure/table/reinforced,
/obj/effect/turf_decal/tile/dark_blue/fourcorners,
/obj/item/food/piedough,
/obj/effect/turf_decal/stripes/line{
	dir = 4
	},
/obj/item/kitchen/rollingpin{
	pixel_x = 3;
	pixel_y = 5
	},
/turf/open/floor/holofloor/monotile/steel,
/area/template_noop)
"N" = (
/obj/structure/table/reinforced,
/obj/effect/turf_decal/tile/dark_blue/fourcorners,
/obj/item/toy/figure/chef,
/obj/effect/turf_decal/stripes/line{
	dir = 6
	},
/turf/open/floor/holofloor/monotile/steel,
/area/template_noop)
"Q" = (
/obj/structure/table/reinforced,
/obj/effect/turf_decal/tile/dark_blue/fourcorners,
/obj/item/clipboard{
	name = "menu"
	},
/obj/item/paper,
/obj/effect/turf_decal/stripes/line{
	dir = 8
	},
/obj/item/hand_labeler,
/turf/open/floor/holofloor/monotile/steel,
/area/template_noop)
"V" = (
/obj/effect/turf_decal/bot,
/obj/effect/turf_decal/tile/dark_blue/fourcorners,
/obj/effect/turf_decal/stripes/corner{
	dir = 1
	},
/obj/structure/closet/crate/freezer,
/obj/item/reagent_containers/food/snacks/meat/slab/meatproduct,
/obj/item/reagent_containers/food/snacks/meat/slab/meatproduct,
/obj/item/reagent_containers/food/snacks/meat/slab/meatproduct,
/obj/item/reagent_containers/food/snacks/meat/slab/meatproduct,
/obj/item/reagent_containers/food/snacks/meat/slab/meatproduct,
/turf/open/floor/holofloor/monotile/steel,
/area/template_noop)
"Y" = (
/obj/effect/turf_decal/caution/stand_clear/white,
/obj/effect/turf_decal/tile/neutral/fourcorners,
/turf/open/floor/holofloor/monotile/steel,
/area/template_noop)

(1,1,1) = {"
v
M
f
d
K
"}
(2,1,1) = {"
b
h
z
c
a
"}
(3,1,1) = {"
N
h
r
g
D
"}
(4,1,1) = {"
y
h
I
o
a
"}
(5,1,1) = {"
Y
h
x
o
l
"}
(6,1,1) = {"
a
h
e
q
u
"}
(7,1,1) = {"
t
H
B
Q
V
"}
