//MAP CONVERTED BY dmm2tgm.py THIS HEADER COMMENT PREVENTS RECONVERSION, DO NOT REMOVE
"a" = (
/obj/effect/decal/cleanable/dirt,
/obj/effect/turf_decal/caution,
/turf/open/floor/holofloor/monotile/steel,
/area/template_noop)
"b" = (
/obj/structure/table/reinforced,
/obj/item/pen,
/obj/item/paper{
	name = "plushes 101";
	default_raw_text = "**How to make plushes**<br><br>Step 1: make a plush fabric with 2 sheets of cloth. You can acquire cloth by cutting bedsheets or gauzes with wirecutters, or by weaving cotton with the loom.<br><br>Step 2: stuff the plush fabric with cotton, and you're done!"
	},
/turf/open/floor/holofloor/monotile/dark,
/area/template_noop)
"c" = (
/obj/effect/turf_decal/tile/dark_green/fourcorners,
/turf/open/floor/holofloor/monotile/steel,
/area/template_noop)
"d" = (
/turf/open/floor/holofloor/monotile/steel,
/area/template_noop)
"e" = (
/obj/structure/loom,
/obj/item/stack/sheet/cotton,
/obj/item/stack/sheet/cotton,
/obj/item/stack/sheet/cotton,
/obj/item/stack/sheet/cotton,
/obj/effect/turf_decal/tile/dark_green/fourcorners,
/turf/open/floor/holofloor/monotile/steel,
/area/template_noop)
"n" = (
/obj/machinery/seed_extractor,
/obj/effect/turf_decal/tile/dark_green/fourcorners,
/turf/open/floor/holofloor/monotile/steel,
/area/template_noop)
"o" = (
/obj/structure/table/reinforced,
/obj/item/stack/sheet/cotton/cloth,
/obj/item/stack/sheet/cotton/cloth,
/obj/item/stack/sheet/cotton,
/obj/item/stack/sheet/cotton,
/turf/open/floor/holofloor/monotile/dark,
/area/template_noop)
"w" = (
/obj/effect/turf_decal/loading_area,
/turf/open/floor/holofloor/monotile/dark,
/area/template_noop)
"z" = (
/obj/effect/turf_decal/loading_area,
/obj/effect/decal/cleanable/blood/old,
/turf/open/floor/holofloor/monotile/dark,
/area/template_noop)
"D" = (
/turf/open/floor/holofloor/monotile/dark,
/area/template_noop)
"E" = (
/obj/machinery/hydroponics/constructable,
/obj/item/seeds/cotton,
/obj/effect/turf_decal/tile/dark_green/fourcorners,
/turf/open/floor/holofloor/monotile/steel,
/area/template_noop)
"F" = (
/obj/structure/rack,
/obj/item/bedsheet,
/obj/item/bedsheet,
/obj/item/bedsheet,
/obj/item/bedsheet/cmo,
/obj/item/bedsheet/cmo,
/obj/item/bedsheet/double/blue,
/obj/item/bedsheet/double/blue,
/obj/item/stack/medical/gauze,
/obj/item/stack/medical/gauze,
/obj/item/stack/medical/gauze,
/obj/item/stack/medical/gauze,
/obj/effect/turf_decal/tile/dark_green/fourcorners,
/turf/open/floor/holofloor/monotile/steel,
/area/template_noop)
"L" = (
/obj/structure/reagent_dispensers/watertank/high,
/obj/item/reagent_containers/cup/bucket,
/obj/effect/turf_decal/tile/dark_green/fourcorners,
/turf/open/floor/holofloor/monotile/steel,
/area/template_noop)
"M" = (
/obj/machinery/hydroponics/constructable,
/obj/item/seeds/cotton,
/obj/item/shovel/spade{
	pixel_x = -5;
	pixel_y = -4
	},
/obj/item/cultivator{
	pixel_x = -2;
	pixel_y = -1
	},
/obj/effect/turf_decal/tile/dark_green/fourcorners,
/turf/open/floor/holofloor/monotile/steel,
/area/template_noop)
"O" = (
/obj/machinery/light/floor,
/turf/open/floor/holofloor/monotile/dark,
/area/template_noop)
"P" = (
/obj/structure/closet/crate,
/obj/item/toy/plush/beeplushie,
/obj/effect/turf_decal/delivery,
/obj/effect/turf_decal/tile/dark_green/fourcorners,
/turf/open/floor/holofloor/monotile/steel,
/area/template_noop)
"R" = (
/obj/effect/decal/cleanable/dirt,
/turf/open/floor/holofloor/monotile/dark,
/area/template_noop)
"U" = (
/obj/structure/table/reinforced,
/obj/item/stack/medical/gauze,
/obj/item/stack/medical/gauze,
/obj/item/stack/medical/gauze,
/turf/open/floor/holofloor/monotile/dark,
/area/template_noop)
"W" = (
/obj/structure/closet/crate,
/obj/effect/turf_decal/delivery,
/obj/item/reagent_containers/cup/bottle/nutrient/ez,
/obj/item/reagent_containers/cup/bottle/nutrient/ez,
/obj/item/reagent_containers/cup/bottle/nutrient/ez,
/obj/effect/turf_decal/tile/dark_green/fourcorners,
/turf/open/floor/holofloor/monotile/steel,
/area/template_noop)
"Z" = (
/obj/structure/rack,
/obj/item/wirecutters,
/obj/item/wirecutters,
/obj/item/wirecutters,
/obj/effect/turf_decal/tile/dark_green/fourcorners,
/turf/open/floor/holofloor/monotile/steel,
/area/template_noop)

(1,1,1) = {"
L
E
M
E
Z
"}
(2,1,1) = {"
c
O
D
D
c
"}
(3,1,1) = {"
n
D
z
U
d
"}
(4,1,1) = {"
d
D
w
b
a
"}
(5,1,1) = {"
e
D
w
o
d
"}
(6,1,1) = {"
e
O
D
R
c
"}
(7,1,1) = {"
F
c
W
P
c
"}
