//MAP CONVERTED BY dmm2tgm.py THIS HEADER COMMENT PREVENTS RECONVERSION, DO NOT REMOVE
"a" = (
/turf/closed/wall,
/area/template_noop)
"c" = (
/obj/machinery/atmospherics/pipe/simple/supply/hidden/layer2,
/obj/machinery/atmospherics/pipe/simple/scrubbers/hidden/layer4{
	dir = 6
	},
/turf/open/floor/plasteel,
/area/template_noop)
"e" = (
/obj/item/radio/intercom{
	pixel_x = -28
	},
/turf/open/floor/plating,
/area/template_noop)
"f" = (
/obj/structure/toilet{
	dir = 4
	},
/obj/effect/decal/cleanable/dirt,
/obj/effect/decal/cleanable/greenglow,
/turf/open/floor/plasteel,
/area/template_noop)
"i" = (
/obj/machinery/atmospherics/pipe/simple/supply/hidden/layer2,
/obj/machinery/atmospherics/pipe/simple/scrubbers/hidden/layer4,
/turf/open/floor/plasteel,
/area/template_noop)
"j" = (
/turf/open/floor/plating,
/area/template_noop)
"k" = (
/obj/effect/turf_decal/tile/red/tile_side{
	dir = 8
	},
/turf/open/floor/plasteel,
/area/template_noop)
"m" = (
/turf/open/floor/plasteel,
/area/template_noop)
"o" = (
/obj/structure/closet,
/obj/item/canvas/twentythree_nineteen,
/obj/item/canvas/nineteen_nineteen,
/obj/item/canvas/twentythree_twentythree,
/obj/item/storage/crayons,
/turf/open/floor/plating,
/area/template_noop)
"q" = (
/obj/effect/turf_decal/tile/red/tile_side{
	dir = 10
	},
/obj/machinery/atmospherics/pipe/simple/supply/hidden/layer2,
/turf/open/floor/plasteel,
/area/template_noop)
"r" = (
/obj/effect/decal/cleanable/dirt,
/turf/open/floor/plasteel,
/area/template_noop)
"s" = (
/obj/effect/turf_decal/tile/red/tile_side{
	dir = 5
	},
/obj/machinery/atmospherics/pipe/simple/supply/hidden/layer2,
/turf/open/floor/plasteel,
/area/template_noop)
"u" = (
/obj/structure/table,
/obj/effect/spawner/lootdrop/maintenance/four,
/obj/machinery/light_switch{
	pixel_x = -4;
	pixel_y = -32
	},
/turf/open/floor/plasteel,
/area/template_noop)
"v" = (
/obj/effect/turf_decal/tile/red/tile_side{
	dir = 1
	},
/obj/effect/decal/cleanable/dirt,
/turf/open/floor/plasteel,
/area/template_noop)
"y" = (
/obj/effect/turf_decal/tile/red/tile_side,
/obj/structure/extinguisher_cabinet{
	pixel_x = -24
	},
/turf/open/floor/plasteel,
/area/template_noop)
"z" = (
/obj/item/radio/intercom{
	pixel_x = 29
	},
/turf/open/floor/plasteel,
/area/template_noop)
"A" = (
/obj/effect/turf_decal/tile/red/tile_side{
	dir = 1
	},
/obj/machinery/atmospherics/pipe/simple/supply/hidden/layer2,
/turf/open/floor/plasteel,
/area/template_noop)
"C" = (
/obj/effect/turf_decal/tile/red/tile_side{
	dir = 6
	},
/turf/open/floor/plasteel,
/area/template_noop)
"D" = (
/obj/effect/turf_decal/tile/red/tile_side{
	dir = 1
	},
/turf/open/floor/plasteel,
/area/template_noop)
"E" = (
/obj/machinery/atmospherics/components/unary/vent_pump/on/layer2{
	dir = 8
	},
/turf/open/floor/plasteel,
/area/template_noop)
"G" = (
/obj/effect/turf_decal/tile/red/tile_side{
	dir = 1
	},
/obj/machinery/atmospherics/pipe/simple/supply/hidden/layer2{
	dir = 6
	},
/turf/open/floor/plasteel,
/area/template_noop)
"I" = (
/obj/effect/decal/cleanable/dirt,
/obj/machinery/newscaster{
	pixel_x = 28;
	pixel_y = 1
	},
/turf/open/floor/plasteel,
/area/template_noop)
"J" = (
/obj/machinery/door/airlock/maintenance,
/obj/machinery/atmospherics/pipe/simple/supply/hidden/layer2,
/obj/machinery/atmospherics/pipe/simple/scrubbers/hidden/layer4,
/turf/template_noop,
/area/template_noop)
"Q" = (
/turf/closed/wall/r_wall,
/area/template_noop)
"R" = (
/obj/effect/decal/cleanable/dirt,
/obj/machinery/atmospherics/components/unary/vent_scrubber/on/layer4{
	dir = 8
	},
/turf/open/floor/plasteel,
/area/template_noop)
"S" = (
/obj/effect/turf_decal/tile/red/tile_side,
/turf/open/floor/plasteel,
/area/template_noop)
"U" = (
/obj/effect/spawner/structure/window/reinforced,
/turf/open/floor/plating,
/area/template_noop)
"V" = (
/obj/effect/turf_decal/tile/red/tile_side,
/obj/effect/decal/cleanable/dirt,
/turf/open/floor/plasteel,
/area/template_noop)
"W" = (
/obj/machinery/door/firedoor,
/obj/effect/turf_decal/stripes/closeup,
/turf/open/floor/plasteel/grid/steel,
/area/template_noop)

(1,1,1) = {"
U
r
S
S
S
S
V
y
e
f
a
"}
(2,1,1) = {"
W
m
G
A
s
q
A
A
c
i
J
"}
(3,1,1) = {"
W
j
E
r
k
C
S
S
R
u
a
"}
(4,1,1) = {"
U
r
I
m
m
v
v
D
z
o
Q
"}
(5,1,1) = {"
a
a
a
U
U
U
U
U
a
a
Q
"}
