//MAP CONVERTED BY dmm2tgm.py THIS HEADER COMMENT PREVENTS RECONVERSION, DO NOT REMOVE
"a" = (
/turf/closed/wall,
/area/template_noop)
"b" = (
/obj/machinery/vending/cola/random,
/obj/effect/turf_decal/tile/red,
/obj/effect/turf_decal/tile/yellow{
	dir = 4
	},
/turf/open/floor/plasteel/dark/side{
	dir = 8
	},
/area/template_noop)
"c" = (
/obj/effect/decal/cleanable/dirt,
/obj/machinery/vending/autodrobe/all_access,
/obj/effect/turf_decal/tile/red{
	dir = 1
	},
/obj/effect/turf_decal/tile/yellow{
	dir = 8
	},
/turf/open/floor/plasteel/dark/side{
	dir = 4
	},
/area/template_noop)
"f" = (
/obj/structure/closet,
/obj/effect/decal/cleanable/dirt,
/obj/effect/spawner/lootdrop/maintenance/two,
/turf/open/floor/plating,
/area/template_noop)
"g" = (
/obj/effect/decal/cleanable/dirt,
/obj/machinery/atmospherics/pipe/simple/supply/hidden/layer2{
	dir = 9
	},
/obj/machinery/atmospherics/pipe/simple/scrubbers/hidden/layer4{
	dir = 9
	},
/turf/open/floor/plasteel/dark,
/area/template_noop)
"i" = (
/obj/machinery/atmospherics/pipe/simple/supply/hidden/layer2,
/obj/effect/turf_decal/tile/red/opposingcorners,
/obj/effect/turf_decal/tile/yellow/opposingcorners{
	dir = 1
	},
/turf/open/floor/plasteel,
/area/template_noop)
"k" = (
/obj/machinery/light_switch{
	pixel_x = 22
	},
/obj/machinery/atmospherics/pipe/simple/supply/hidden/layer2,
/obj/machinery/atmospherics/pipe/simple/scrubbers/hidden/layer4,
/turf/open/floor/plasteel/dark,
/area/template_noop)
"l" = (
/turf/template_noop/closed,
/area/template_noop)
"m" = (
/obj/machinery/light{
	dir = 4
	},
/obj/structure/table,
/obj/effect/turf_decal/tile/red{
	dir = 1
	},
/obj/effect/turf_decal/tile/yellow{
	dir = 8
	},
/turf/open/floor/plasteel/dark/side{
	dir = 4
	},
/area/template_noop)
"o" = (
/obj/effect/decal/cleanable/dirt,
/obj/machinery/atmospherics/pipe/simple/supply/hidden/layer2,
/obj/effect/turf_decal/tile/red/opposingcorners,
/obj/effect/turf_decal/tile/yellow/opposingcorners{
	dir = 1
	},
/turf/open/floor/plasteel,
/area/template_noop)
"p" = (
/obj/machinery/atmospherics/pipe/simple/scrubbers/hidden/layer4{
	dir = 6
	},
/obj/machinery/atmospherics/pipe/simple/supply/hidden/layer2{
	dir = 6
	},
/obj/machinery/light/small{
	dir = 1
	},
/obj/effect/decal/cleanable/dirt,
/turf/open/floor/plating,
/area/template_noop)
"q" = (
/obj/item/radio/intercom{
	pixel_x = 29
	},
/obj/machinery/vending/tool,
/obj/effect/turf_decal/tile/red{
	dir = 1
	},
/obj/effect/turf_decal/tile/yellow{
	dir = 8
	},
/turf/open/floor/plasteel/dark/side{
	dir = 4
	},
/area/template_noop)
"s" = (
/obj/effect/decal/cleanable/dirt,
/obj/machinery/atmospherics/pipe/simple/supply/hidden/layer2{
	dir = 5
	},
/obj/effect/turf_decal/tile/red/opposingcorners,
/obj/effect/turf_decal/tile/yellow/opposingcorners{
	dir = 1
	},
/turf/open/floor/plasteel,
/area/template_noop)
"t" = (
/obj/machinery/vending/assist,
/obj/effect/decal/cleanable/dirt,
/obj/machinery/light{
	dir = 8
	},
/obj/effect/turf_decal/tile/red,
/obj/effect/turf_decal/tile/yellow{
	dir = 4
	},
/turf/open/floor/plasteel/dark/side{
	dir = 8
	},
/area/template_noop)
"u" = (
/obj/machinery/door/airlock/maintenance{
	name = "Vending machine Store Backroom"
	},
/obj/machinery/atmospherics/pipe/simple/supply/hidden/layer2{
	dir = 4
	},
/obj/machinery/atmospherics/pipe/simple/scrubbers/hidden/layer4{
	dir = 8
	},
/turf/open/floor/plating,
/area/template_noop)
"y" = (
/obj/machinery/vending/coffee,
/obj/effect/decal/cleanable/dirt,
/obj/effect/turf_decal/tile/red,
/obj/effect/turf_decal/tile/yellow{
	dir = 4
	},
/turf/open/floor/plasteel/dark/side{
	dir = 8
	},
/area/template_noop)
"B" = (
/obj/structure/table,
/obj/item/coin/arcade_token{
	pixel_x = 6
	},
/obj/item/coin/arcade_token{
	pixel_x = -6
	},
/obj/item/coin/arcade_token{
	pixel_y = 6
	},
/obj/effect/turf_decal/tile/red,
/obj/effect/turf_decal/tile/yellow{
	dir = 4
	},
/turf/open/floor/plasteel/dark/side{
	dir = 8
	},
/area/template_noop)
"H" = (
/obj/structure/chair/stool/bar{
	pixel_x = 8
	},
/obj/effect/decal/cleanable/dirt,
/obj/effect/turf_decal/tile/red/opposingcorners,
/obj/effect/turf_decal/tile/yellow/opposingcorners{
	dir = 1
	},
/turf/open/floor/plasteel,
/area/template_noop)
"J" = (
/obj/machinery/door/airlock/maintenance{
	name = "Vending machine Store Maintenance";
	req_access_txt = "12"
	},
/obj/machinery/atmospherics/pipe/simple/supply/hidden/layer2,
/obj/machinery/atmospherics/pipe/simple/scrubbers/hidden/layer4,
/turf/template_noop,
/area/template_noop)
"K" = (
/obj/machinery/atmospherics/components/unary/vent_pump/on/layer2,
/obj/effect/turf_decal/tile/red/opposingcorners,
/obj/effect/turf_decal/tile/yellow/opposingcorners{
	dir = 1
	},
/turf/open/floor/plasteel,
/area/template_noop)
"L" = (
/obj/effect/decal/cleanable/dirt,
/obj/machinery/atmospherics/pipe/simple/supply/hidden/layer2{
	dir = 4
	},
/obj/effect/turf_decal/tile/red/opposingcorners,
/obj/effect/turf_decal/tile/yellow/opposingcorners{
	dir = 1
	},
/turf/open/floor/plasteel,
/area/template_noop)
"M" = (
/obj/structure/extinguisher_cabinet{
	pixel_x = 24
	},
/obj/machinery/atmospherics/components/unary/vent_scrubber/on/layer4,
/obj/machinery/atmospherics/pipe/simple/supply/hidden/layer2{
	dir = 10
	},
/obj/effect/turf_decal/tile/red{
	dir = 1
	},
/obj/effect/turf_decal/tile/yellow{
	dir = 8
	},
/turf/open/floor/plasteel/dark/side{
	dir = 4
	},
/area/template_noop)
"O" = (
/obj/effect/turf_decal/tile/red/opposingcorners,
/obj/effect/turf_decal/tile/yellow/opposingcorners{
	dir = 1
	},
/turf/open/floor/plasteel,
/area/template_noop)
"Q" = (
/obj/effect/decal/cleanable/dirt,
/obj/effect/turf_decal/tile/red/opposingcorners,
/obj/effect/turf_decal/tile/yellow/opposingcorners{
	dir = 1
	},
/turf/open/floor/plasteel,
/area/template_noop)
"R" = (
/obj/machinery/computer/arcade{
	dir = 8
	},
/obj/effect/turf_decal/tile/red{
	dir = 1
	},
/obj/effect/turf_decal/tile/yellow{
	dir = 8
	},
/turf/open/floor/plasteel/dark/side{
	dir = 4
	},
/area/template_noop)
"S" = (
/obj/machinery/vending/snack/random,
/obj/machinery/light{
	dir = 8
	},
/obj/effect/turf_decal/tile/red,
/obj/effect/turf_decal/tile/yellow{
	dir = 4
	},
/turf/open/floor/plasteel/dark/side{
	dir = 8
	},
/area/template_noop)
"U" = (
/obj/effect/spawner/structure/window/reinforced,
/turf/open/floor/plating,
/area/template_noop)
"V" = (
/obj/machinery/vending/cigarette,
/obj/effect/decal/cleanable/dirt,
/obj/effect/turf_decal/tile/red,
/obj/effect/turf_decal/tile/yellow{
	dir = 4
	},
/turf/open/floor/plasteel/dark/side{
	dir = 8
	},
/area/template_noop)
"W" = (
/obj/machinery/door/firedoor,
/obj/effect/turf_decal/stripes/closeup,
/turf/open/floor/plasteel/grid/steel,
/area/template_noop)
"X" = (
/obj/machinery/light{
	dir = 4
	},
/obj/machinery/vending/clothing,
/obj/effect/turf_decal/tile/red{
	dir = 1
	},
/obj/effect/turf_decal/tile/yellow{
	dir = 8
	},
/turf/open/floor/plasteel/dark/side{
	dir = 4
	},
/area/template_noop)

(1,1,1) = {"
U
B
t
b
y
S
V
a
f
l
"}
(2,1,1) = {"
W
Q
K
i
o
i
s
a
p
J
"}
(3,1,1) = {"
W
H
Q
O
O
O
L
a
u
l
"}
(4,1,1) = {"
U
R
X
q
c
m
M
k
g
l
"}
(5,1,1) = {"
l
l
l
l
l
l
l
l
l
l
"}
