//MAP CONVERTED BY dmm2tgm.py THIS HEADER COMMENT PREVENTS RECONVERSION, DO NOT REMOVE
"a" = (
/turf/template_noop/closed,
/area/template_noop)
"d" = (
/obj/machinery/atmospherics/pipe/simple/supply/hidden/layer2,
/obj/effect/turf_decal/tile/green/half/contrasted{
	dir = 1
	},
/obj/effect/turf_decal/tile/neutral/half/contrasted,
/turf/open/floor/plasteel,
/area/template_noop)
"g" = (
/obj/structure/sink{
	dir = 8;
	pixel_x = -12
	},
/obj/effect/turf_decal/tile/green/fourcorners/contrasted,
/obj/effect/turf_decal/tile/neutral/half/contrasted,
/turf/open/floor/plasteel,
/area/template_noop)
"h" = (
/obj/machinery/biogenerator,
/obj/item/radio/intercom{
	pixel_x = 28
	},
/turf/open/floor/plasteel,
/area/template_noop)
"i" = (
/obj/machinery/atmospherics/pipe/simple/supply/hidden/layer2,
/obj/machinery/atmospherics/pipe/simple/scrubbers/hidden/layer4{
	dir = 6
	},
/obj/effect/turf_decal/tile/green/half/contrasted{
	dir = 1
	},
/obj/effect/turf_decal/tile/neutral/half/contrasted,
/turf/open/floor/plasteel,
/area/template_noop)
"l" = (
/obj/machinery/atmospherics/components/unary/vent_scrubber/on/layer4{
	dir = 8
	},
/obj/effect/turf_decal/tile/green/half/contrasted,
/obj/effect/turf_decal/tile/neutral/half/contrasted{
	dir = 1
	},
/turf/open/floor/plasteel,
/area/template_noop)
"p" = (
/obj/structure/table,
/obj/item/reagent_containers/glass/bucket,
/obj/item/reagent_containers/glass/bucket{
	pixel_x = -8
	},
/obj/item/hatchet,
/obj/item/cultivator,
/obj/effect/turf_decal/tile/green/fourcorners/contrasted,
/obj/effect/turf_decal/tile/neutral/half/contrasted,
/turf/open/floor/plasteel,
/area/template_noop)
"q" = (
/obj/structure/table,
/obj/item/plant_analyzer,
/obj/item/plant_analyzer,
/obj/item/reagent_containers/glass/bucket,
/obj/item/reagent_containers/glass/bottle/nutrient/rh{
	pixel_x = 2;
	pixel_y = 1
	},
/obj/item/reagent_containers/glass/bottle/nutrient/ez,
/obj/item/reagent_containers/spray/pestspray{
	pixel_x = 3;
	pixel_y = 4
	},
/obj/item/reagent_containers/spray/plantbgone,
/obj/effect/turf_decal/tile/green/fourcorners/contrasted,
/obj/effect/turf_decal/tile/neutral/half/contrasted,
/turf/open/floor/plasteel,
/area/template_noop)
"s" = (
/obj/machinery/atmospherics/pipe/simple/supply/hidden/layer2{
	dir = 6
	},
/obj/effect/turf_decal/tile/green/half/contrasted{
	dir = 1
	},
/obj/effect/turf_decal/tile/neutral/half/contrasted,
/turf/open/floor/plasteel,
/area/template_noop)
"t" = (
/obj/effect/turf_decal/tile/green/half/contrasted,
/obj/effect/turf_decal/tile/neutral/half/contrasted{
	dir = 1
	},
/turf/open/floor/plasteel,
/area/template_noop)
"v" = (
/obj/structure/reagent_dispensers/watertank,
/obj/structure/extinguisher_cabinet{
	pixel_x = 24
	},
/turf/open/floor/plasteel,
/area/template_noop)
"w" = (
/obj/structure/table,
/obj/item/storage/bag/plants/portaseeder,
/obj/effect/turf_decal/tile/green/fourcorners/contrasted,
/obj/effect/turf_decal/tile/neutral/half/contrasted,
/turf/open/floor/plasteel,
/area/template_noop)
"x" = (
/obj/machinery/seed_extractor,
/turf/open/floor/plasteel,
/area/template_noop)
"z" = (
/obj/machinery/hydroponics/soil,
/obj/machinery/light{
	dir = 4
	},
/turf/open/floor/grass,
/area/template_noop)
"A" = (
/obj/machinery/atmospherics/components/unary/vent_pump/on/layer2{
	dir = 8
	},
/obj/effect/turf_decal/tile/green/half/contrasted,
/obj/effect/turf_decal/tile/neutral/half/contrasted{
	dir = 1
	},
/turf/open/floor/plasteel,
/area/template_noop)
"G" = (
/obj/effect/turf_decal/tile/green/half/contrasted{
	dir = 1
	},
/obj/effect/turf_decal/tile/neutral/half/contrasted,
/turf/open/floor/plasteel,
/area/template_noop)
"J" = (
/obj/machinery/door/airlock/maintenance{
	name = "Public Garden Maintenance";
	req_access_txt = "12"
	},
/obj/machinery/atmospherics/pipe/simple/supply/hidden/layer2,
/obj/machinery/atmospherics/pipe/simple/scrubbers/hidden/layer4,
/turf/template_noop,
/area/template_noop)
"K" = (
/obj/structure/table,
/obj/item/crowbar,
/obj/item/hatchet,
/obj/item/cultivator,
/obj/effect/turf_decal/tile/green/fourcorners/contrasted,
/obj/effect/turf_decal/tile/neutral/half/contrasted,
/turf/open/floor/plasteel,
/area/template_noop)
"M" = (
/obj/machinery/hydroponics/soil,
/obj/machinery/light{
	dir = 8
	},
/obj/effect/turf_decal/tile/neutral/half/contrasted,
/turf/open/floor/grass,
/area/template_noop)
"O" = (
/obj/machinery/light{
	dir = 8
	},
/obj/structure/table,
/obj/item/seeds/tower,
/obj/item/seeds/watermelon,
/obj/item/seeds/wheat,
/obj/item/seeds/sugarcane,
/obj/item/seeds/orange,
/obj/item/seeds/grape,
/obj/item/seeds/cocoapod,
/obj/item/seeds/banana,
/obj/item/seeds/apple,
/obj/effect/turf_decal/tile/green/fourcorners/contrasted,
/obj/effect/turf_decal/tile/neutral/half/contrasted,
/turf/open/floor/plasteel,
/area/template_noop)
"R" = (
/obj/machinery/hydroponics/soil,
/turf/open/floor/grass,
/area/template_noop)
"U" = (
/obj/effect/spawner/structure/window/reinforced,
/turf/open/floor/plating,
/area/template_noop)
"W" = (
/obj/machinery/door/airlock/public/glass{
	name = "Public Garden"
	},
/obj/machinery/door/firedoor,
/obj/effect/turf_decal/stripes/closeup,
/turf/open/floor/plasteel/grid/steel,
/area/template_noop)
"Y" = (
/obj/machinery/hydroponics/soil,
/obj/effect/turf_decal/tile/neutral/half/contrasted,
/turf/open/floor/grass,
/area/template_noop)

(1,1,1) = {"
U
g
O
w
q
K
p
Y
M
a
"}
(2,1,1) = {"
W
G
s
d
d
d
d
d
i
J
"}
(3,1,1) = {"
W
t
A
t
t
t
t
t
l
a
"}
(4,1,1) = {"
U
R
z
R
x
h
v
R
z
a
"}
(5,1,1) = {"
a
U
a
U
a
a
a
U
a
a
"}
