//MAP CONVERTED BY dmm2tgm.py THIS HEADER COMMENT PREVENTS RECONVERSION, DO NOT REMOVE
"a" = (
/turf/closed/wall,
/area/template_noop)
"b" = (
/turf/closed/wall/r_wall,
/area/template_noop)
"c" = (
/obj/machinery/atmospherics/pipe/simple/supply/hidden/layer1{
	dir = 1
	},
/turf/open/floor/plasteel,
/area/template_noop)
"f" = (
/obj/structure/closet{
	dir = 1
	},
/obj/effect/spawner/lootdrop/maintenance/two{
	dir = 1
	},
/turf/open/floor/plasteel/techmaint,
/area/template_noop)
"h" = (
/obj/machinery/door/airlock/maintenance{
	id_tag = "ScooterFront";
	name = "Scooter Rental";
	dir = 1
	},
/turf/open/floor/plasteel/dark,
/area/template_noop)
"i" = (
/obj/machinery/atmospherics/components/unary/vent_pump/on/layer1{
	dir = 8
	},
/turf/open/floor/plasteel,
/area/template_noop)
"j" = (
/obj/effect/decal/cleanable/dirt{
	dir = 4
	},
/obj/structure/closet{
	dir = 1
	},
/obj/effect/spawner/lootdrop/maintenance/two{
	dir = 1
	},
/turf/open/floor/plasteel/techmaint,
/area/template_noop)
"k" = (
/obj/structure/rack{
	dir = 1
	},
/obj/item/wrench{
	dir = 1
	},
/obj/item/screwdriver{
	dir = 1
	},
/obj/item/stack/cable_coil/random/five,
/obj/effect/decal/cleanable/dirt{
	dir = 4
	},
/turf/open/floor/plasteel/techmaint,
/area/template_noop)
"m" = (
/turf/open/floor/plasteel,
/area/template_noop)
"n" = (
/obj/machinery/atmospherics/pipe/simple/supply/hidden/layer1{
	dir = 5
	},
/turf/open/floor/plasteel,
/area/template_noop)
"o" = (
/turf/open/floor/plasteel/techmaint,
/area/template_noop)
"q" = (
/obj/structure/table{
	dir = 1
	},
/obj/item/circuitboard/machine/paystand{
	dir = 1
	},
/obj/item/stack/sheet/iron/five{
	dir = 1
	},
/obj/machinery/atmospherics/pipe/simple/supply/hidden/layer1{
	dir = 1
	},
/turf/open/floor/plasteel,
/area/template_noop)
"r" = (
/obj/machinery/newscaster{
	pixel_x = -28;
	pixel_y = -1;
	dir = 1
	},
/obj/effect/decal/cleanable/dirt{
	dir = 4
	},
/turf/open/floor/plasteel,
/area/template_noop)
"s" = (
/obj/machinery/light{
	dir = 8
	},
/turf/open/floor/plasteel,
/area/template_noop)
"t" = (
/obj/structure/rack{
	dir = 1
	},
/obj/machinery/atmospherics/pipe/simple/supply/hidden/layer1{
	dir = 1
	},
/turf/open/floor/plasteel,
/area/template_noop)
"u" = (
/obj/machinery/button/door{
	id = "ConvenienceBack";
	name = "Convenience store backroom Door Lock";
	normaldoorcontrol = 1;
	pixel_x = -8;
	pixel_y = 26;
	specialfunctions = 4;
	dir = 1
	},
/obj/effect/decal/cleanable/dirt{
	dir = 4
	},
/turf/open/floor/plasteel/techmaint,
/area/template_noop)
"v" = (
/obj/structure/extinguisher_cabinet{
	pixel_x = 24;
	dir = 1
	},
/turf/open/floor/plasteel,
/area/template_noop)
"w" = (
/obj/machinery/light_switch{
	pixel_x = 22;
	dir = 1
	},
/turf/open/floor/plasteel,
/area/template_noop)
"z" = (
/obj/effect/decal/cleanable/dirt{
	dir = 4
	},
/turf/open/floor/plasteel,
/area/template_noop)
"B" = (
/obj/machinery/door/airlock/maintenance{
	name = "Convenience store Backroom";
	dir = 1
	},
/obj/machinery/atmospherics/pipe/simple/supply/hidden/layer1{
	dir = 1
	},
/obj/machinery/atmospherics/pipe/simple/scrubbers/hidden/layer3{
	dir = 1
	},
/turf/open/floor/plasteel/grid/steel,
/area/template_noop)
"C" = (
/obj/machinery/computer/security/telescreen/entertainment{
	dir = 1
	},
/turf/closed/wall,
/area/template_noop)
"D" = (
/obj/structure/rack{
	dir = 1
	},
/turf/open/floor/plasteel,
/area/template_noop)
"F" = (
/obj/machinery/button/door{
	id = "ConvenienceShutter";
	name = "Convenience store Shutters";
	normaldoorcontrol = 1;
	pixel_x = -8;
	pixel_y = 26;
	specialfunctions = 4;
	dir = 1
	},
/obj/machinery/atmospherics/components/unary/vent_scrubber/on/layer3{
	dir = 8
	},
/turf/open/floor/plasteel,
/area/template_noop)
"G" = (
/obj/structure/table{
	dir = 1
	},
/obj/machinery/light/small{
	dir = 2
	},
/obj/effect/spawner/lootdrop/maintenance/two{
	dir = 1
	},
/turf/open/floor/plasteel/techmaint,
/area/template_noop)
"I" = (
/obj/effect/decal/cleanable/dirt{
	dir = 4
	},
/obj/machinery/atmospherics/pipe/simple/supply/hidden/layer1{
	dir = 1
	},
/obj/machinery/atmospherics/pipe/simple/scrubbers/hidden/layer3{
	dir = 1
	},
/turf/open/floor/plasteel/techmaint,
/area/template_noop)
"J" = (
/obj/machinery/door/airlock/maintenance{
	name = "Convenience store Maintenance";
	req_access_txt = "12";
	dir = 1
	},
/obj/machinery/atmospherics/pipe/simple/scrubbers/hidden/layer3{
	dir = 1
	},
/obj/machinery/atmospherics/pipe/simple/supply/hidden/layer1{
	dir = 1
	},
/turf/template_noop,
/area/template_noop)
"P" = (
/obj/machinery/atmospherics/pipe/simple/supply/hidden/layer1{
	dir = 1
	},
/obj/machinery/atmospherics/pipe/simple/scrubbers/hidden/layer3{
	dir = 1
	},
/turf/open/floor/plasteel/techmaint,
/area/template_noop)
"R" = (
/obj/item/radio/intercom{
	pixel_x = 29;
	dir = 1
	},
/turf/open/floor/plasteel,
/area/template_noop)
"S" = (
/obj/structure/table{
	dir = 1
	},
/obj/machinery/light{
	dir = 8
	},
/turf/open/floor/plasteel,
/area/template_noop)
"U" = (
/obj/effect/spawner/structure/window/reinforced{
	dir = 1
	},
/obj/machinery/door/poddoor/shutters/preopen{
	id = "ConvenienceShutter";
	name = "Convenience store Shutters";
	dir = 1
	},
/turf/open/floor/plating,
/area/template_noop)
"V" = (
/obj/structure/chair/office/light{
	dir = 2
	},
/turf/open/floor/plasteel,
/area/template_noop)
"W" = (
/obj/machinery/door/poddoor/shutters/preopen{
	id = "ConvenienceShutter";
	name = "Convenience store Shutters";
	dir = 1
	},
/obj/machinery/door/firedoor{
	dir = 1
	},
/obj/effect/turf_decal/stripes/closeup{
	dir = 4
	},
/turf/open/floor/plasteel/grid/steel,
/area/template_noop)
"Y" = (
/obj/effect/decal/cleanable/dirt{
	dir = 4
	},
/obj/machinery/atmospherics/pipe/simple/supply/hidden/layer1{
	dir = 1
	},
/obj/machinery/atmospherics/pipe/simple/scrubbers/hidden/layer3{
	dir = 5
	},
/turf/open/floor/plasteel,
/area/template_noop)

(1,1,1) = {"
a
f
j
a
V
S
m
z
s
r
U"}(2,1,1) = {"
J
I
P
B
Y
q
c
t
t
n
W"}(3,1,1) = {"
a
u
G
a
F
C
m
D
D
i
W"}(4,1,1) = {"
b
o
k
a
v
h
w
m
z
R
U"}(5,1,1) = {"
b
a
a
a
a
a
a
U
U
a
a"}