//MAP CONVERTED BY dmm2tgm.py THIS HEADER COMMENT PREVENTS RECONVERSION, DO NOT REMOVE
"a" = (
/turf/closed/wall,
/area/template_noop)
"c" = (
/obj/item/trash/canned/beans,
/obj/machinery/light/small{
	dir = 4
	},
/obj/structure/lattice/catwalk/over,
/obj/machinery/atmospherics/pipe/smart/manifold4w/supply/hidden/layer2,
/obj/machinery/atmospherics/pipe/smart/manifold4w/scrubbers/hidden/layer4,
/turf/open/floor/plating,
/area/template_noop)
"d" = (
/obj/machinery/door/airlock/maintenance/external/glass,
/obj/machinery/atmospherics/pipe/smart/manifold4w/supply/hidden/layer2,
/obj/machinery/atmospherics/pipe/smart/manifold4w/scrubbers/hidden/layer4,
/turf/open/floor/plating,
/area/template_noop)
"e" = (
/obj/item/bedsheet/random,
/obj/item/radio/intercom{
	pixel_y = 26
	},
/obj/structure/bed/maint,
/turf/open/floor/carpet,
/area/template_noop)
"f" = (
/obj/item/wirerod,
/obj/structure/table/wood,
/obj/item/storage/belt/utility,
/obj/effect/spawner/random/clothing/gloves,
/turf/open/floor/carpet,
/area/template_noop)
"h" = (
/obj/effect/spawner/random/trash/grille_or_waste,
/turf/open/floor/iron,
/area/template_noop)
"i" = (
/obj/machinery/atmospherics/pipe/smart/manifold4w/supply/hidden/layer2,
/obj/machinery/atmospherics/pipe/smart/manifold4w/scrubbers/hidden/layer4,
/obj/structure/lattice/catwalk/over,
/turf/open/floor/plating,
/area/template_noop)
"j" = (
/obj/structure/grille/broken,
/obj/structure/lattice/catwalk/over,
/turf/open/floor/plating{
	broken = 1
	},
/area/template_noop)
"k" = (
/obj/structure/bonfire,
/turf/open/floor/plating{
	broken = 1
	},
/area/template_noop)
"m" = (
/obj/structure/grille/broken,
/obj/structure/lattice/catwalk/over,
/turf/open/floor/plating,
/area/template_noop)
"o" = (
/obj/structure/toilet{
	dir = 8
	},
/obj/machinery/light/small,
/turf/open/floor/plating,
/area/template_noop)
"p" = (
/obj/machinery/door/firedoor,
/obj/effect/turf_decal/stripes/closeup,
/obj/structure/barricade/wooden,
/turf/open/floor/iron/grid/steel,
/area/template_noop)
"r" = (
/obj/effect/spawner/random/trash/grille_or_waste,
/obj/structure/lattice/catwalk/over,
/turf/open/floor/plating{
	burnt = 1
	},
/area/template_noop)
"s" = (
/obj/effect/decal/cleanable/glass,
/obj/machinery/atmospherics/pipe/smart/manifold4w/scrubbers/hidden/layer4,
/turf/open/floor/plating,
/area/template_noop)
"v" = (
/obj/structure/chair/office{
	dir = 1
	},
/turf/open/floor/plating,
/area/template_noop)
"y" = (
/obj/effect/decal/cleanable/dirt/dust,
/obj/effect/decal/cleanable/vomit/old,
/obj/effect/spawner/random/decoration/glowstick,
/turf/open/floor/plating,
/area/template_noop)
"z" = (
/turf/closed/wall/mineral/wood,
/area/template_noop)
"A" = (
/obj/effect/decal/cleanable/glass,
/obj/effect/decal/cleanable/dirt/dust,
/obj/item/broken_bottle,
/obj/item/cigbutt,
/obj/item/cigbutt{
	pixel_x = 3
	},
/obj/machinery/atmospherics/pipe/smart/manifold4w/scrubbers/hidden/layer4,
/turf/open/floor/plating,
/area/template_noop)
"D" = (
/obj/machinery/shower{
	dir = 8
	},
/obj/effect/spawner/random/maintenance/two,
/turf/open/floor/plating{
	broken = 1
	},
/area/template_noop)
"E" = (
/obj/item/trash/boritos,
/obj/machinery/light/small{
	dir = 1
	},
/obj/machinery/atmospherics/pipe/smart/manifold4w/scrubbers/hidden/layer4,
/turf/open/floor/plating,
/area/template_noop)
"G" = (
/obj/machinery/light_switch{
	pixel_x = 24
	},
/obj/machinery/atmospherics/components/unary/vent_scrubber/on/layer4{
	dir = 8
	},
/turf/open/floor/plating{
	burnt = 1
	},
/area/template_noop)
"I" = (
/obj/item/storage/bag/trash{
	pixel_x = 13;
	pixel_y = -12
	},
/obj/effect/decal/cleanable/food/tomato_smudge,
/obj/structure/barricade/wooden/crude,
/turf/open/floor/plating,
/area/template_noop)
"J" = (
/obj/machinery/door/airlock/maintenance,
/obj/machinery/atmospherics/pipe/smart/manifold4w/supply/hidden/layer2,
/obj/machinery/atmospherics/pipe/smart/manifold4w/scrubbers/hidden/layer4,
/turf/template_noop,
/area/template_noop)
"K" = (
/obj/machinery/atmospherics/pipe/smart/manifold4w/supply/hidden/layer2,
/obj/machinery/atmospherics/pipe/smart/manifold4w/scrubbers/hidden/layer4,
/obj/item/trash/can,
/turf/open/floor/plating,
/area/template_noop)
"L" = (
/obj/item/plate,
/turf/open/floor/iron,
/area/template_noop)
"Q" = (
/turf/template_noop/closed,
/area/template_noop)
"R" = (
/obj/structure/closet/cardboard,
/obj/item/storage/toolbox/emergency,
/obj/item/reagent_containers/cup/glass/bottle/hooch,
/turf/open/floor/plating,
/area/template_noop)
"S" = (
/obj/structure/barricade/wooden/crude,
/turf/open/floor/plating{
	broken = 1
	},
/area/template_noop)
"T" = (
/obj/machinery/door/airlock/maintenance/external/glass,
/turf/open/floor/plating,
/area/template_noop)
"V" = (
/obj/machinery/atmospherics/components/unary/vent_pump/on/layer2{
	dir = 4
	},
/obj/structure/closet/secure_closet/personal,
/obj/effect/spawner/random/entertainment/gambling,
/turf/open/floor/plating,
/area/template_noop)
"Z" = (
/obj/item/trash/sosjerky{
	pixel_x = -10;
	pixel_y = 2
	},
/obj/effect/spawner/random/trash/grille_or_waste,
/turf/open/floor/iron,
/area/template_noop)

(1,1,1) = {"
a
r
S
y
R
V
a
e
f
Q
"}
(2,1,1) = {"
p
m
a
A
s
K
d
c
i
J
"}
(3,1,1) = {"
p
j
a
E
k
L
z
T
z
Q
"}
(4,1,1) = {"
a
Z
I
G
h
v
z
D
o
Q
"}
(5,1,1) = {"
Q
Q
Q
Q
Q
Q
Q
Q
Q
Q
"}
