//MAP CONVERTED BY dmm2tgm.py THIS HEADER COMMENT PREVENTS RECONVERSION, DO NOT REMOVE
"a" = (
/turf/closed/wall,
/area/template_noop)
"e" = (
/obj/effect/turf_decal/tile/red/tile_marquee,
/obj/effect/turf_decal/tile/yellow/tile_marquee{
	dir = 1
	},
/obj/machinery/atmospherics/pipe/simple/supply/hidden/layer2,
/turf/open/floor/plasteel,
/area/template_noop)
"f" = (
/obj/structure/closet,
/obj/effect/decal/cleanable/dirt,
/obj/effect/spawner/lootdrop/maintenance/two,
/turf/open/floor/plating,
/area/template_noop)
"g" = (
/obj/effect/decal/cleanable/dirt,
/obj/machinery/atmospherics/pipe/simple/supply/hidden/layer2{
	dir = 9
	},
/obj/machinery/atmospherics/pipe/simple/scrubbers/hidden/layer4{
	dir = 9
	},
/turf/open/floor/plasteel/dark,
/area/template_noop)
"h" = (
/obj/machinery/light{
	dir = 4
	},
/obj/effect/turf_decal/tile/red{
	dir = 1
	},
/obj/effect/turf_decal/tile/yellow{
	dir = 8
	},
/obj/structure/table,
/turf/open/floor/plasteel/dark/side{
	dir = 4
	},
/area/template_noop)
"j" = (
/obj/structure/closet,
/obj/effect/spawner/lootdrop/maintenance/two,
/turf/open/floor/plating,
/area/template_noop)
"k" = (
/obj/machinery/light_switch{
	pixel_x = 22
	},
/obj/machinery/atmospherics/pipe/simple/supply/hidden/layer2,
/obj/machinery/atmospherics/pipe/simple/scrubbers/hidden/layer4,
/turf/open/floor/plasteel/dark,
/area/template_noop)
"l" = (
/turf/closed/wall/r_wall,
/area/template_noop)
"n" = (
/obj/effect/turf_decal/tile/red/tile_marquee,
/obj/effect/turf_decal/tile/yellow/tile_marquee{
	dir = 1
	},
/obj/effect/decal/cleanable/dirt,
/turf/open/floor/plasteel,
/area/template_noop)
"p" = (
/obj/machinery/atmospherics/pipe/simple/scrubbers/hidden/layer4{
	dir = 6
	},
/obj/machinery/atmospherics/pipe/simple/supply/hidden/layer2{
	dir = 6
	},
/turf/open/floor/plating,
/area/template_noop)
"r" = (
/obj/structure/table,
/obj/effect/turf_decal/tile/red,
/obj/effect/turf_decal/tile/yellow{
	dir = 4
	},
/obj/item/coin/arcade_token{
	pixel_x = 6
	},
/obj/item/coin/arcade_token{
	pixel_x = -6
	},
/obj/item/coin/arcade_token{
	pixel_y = 6
	},
/obj/machinery/newscaster{
	pixel_x = -28;
	pixel_y = 1
	},
/turf/open/floor/plasteel/dark/side{
	dir = 8
	},
/area/template_noop)
"t" = (
/obj/machinery/vending/assist,
/obj/effect/decal/cleanable/dirt,
/obj/machinery/light{
	dir = 8
	},
/obj/effect/turf_decal/tile/red,
/obj/effect/turf_decal/tile/yellow{
	dir = 4
	},
/turf/open/floor/plasteel/dark/side{
	dir = 8
	},
/area/template_noop)
"u" = (
/obj/machinery/door/airlock/maintenance{
	name = "Vending machine Store Backroom"
	},
/obj/machinery/atmospherics/pipe/simple/supply/hidden/layer2{
	dir = 4
	},
/obj/machinery/atmospherics/pipe/simple/scrubbers/hidden/layer4{
	dir = 8
	},
/turf/open/floor/plating,
/area/template_noop)
"v" = (
/obj/effect/turf_decal/tile/red{
	dir = 1
	},
/obj/effect/turf_decal/tile/yellow{
	dir = 8
	},
/obj/structure/extinguisher_cabinet{
	pixel_x = 24
	},
/obj/machinery/atmospherics/components/unary/vent_scrubber/on/layer4,
/obj/machinery/atmospherics/pipe/simple/supply/hidden/layer2{
	dir = 10
	},
/turf/open/floor/plasteel/dark/side{
	dir = 4
	},
/area/template_noop)
"w" = (
/obj/effect/decal/cleanable/dirt,
/obj/machinery/atmospherics/pipe/simple/supply/hidden/layer2,
/obj/machinery/atmospherics/pipe/simple/scrubbers/hidden/layer4,
/turf/open/floor/plasteel/dark,
/area/template_noop)
"x" = (
/obj/effect/turf_decal/tile/red/tile_marquee,
/obj/effect/turf_decal/tile/yellow/tile_marquee{
	dir = 1
	},
/obj/machinery/atmospherics/components/unary/vent_pump/on/layer2,
/turf/open/floor/plasteel,
/area/template_noop)
"y" = (
/obj/machinery/vending/coffee,
/obj/effect/decal/cleanable/dirt,
/obj/effect/turf_decal/tile/red,
/obj/effect/turf_decal/tile/yellow{
	dir = 4
	},
/turf/open/floor/plasteel/dark/side{
	dir = 8
	},
/area/template_noop)
"z" = (
/obj/machinery/light{
	dir = 4
	},
/obj/effect/turf_decal/tile/red{
	dir = 1
	},
/obj/effect/turf_decal/tile/yellow{
	dir = 8
	},
/obj/machinery/vending/clothing,
/turf/open/floor/plasteel/dark/side{
	dir = 4
	},
/area/template_noop)
"A" = (
/obj/effect/decal/cleanable/dirt,
/obj/effect/turf_decal/tile/red/tile_marquee,
/obj/effect/turf_decal/tile/yellow/tile_marquee{
	dir = 1
	},
/obj/machinery/atmospherics/pipe/simple/supply/hidden/layer2,
/turf/open/floor/plasteel,
/area/template_noop)
"B" = (
/obj/effect/decal/cleanable/dirt,
/obj/machinery/light/small{
	dir = 1
	},
/turf/open/floor/plating,
/area/template_noop)
"C" = (
/obj/effect/turf_decal/tile/red/tile_marquee,
/obj/effect/turf_decal/tile/yellow/tile_marquee{
	dir = 1
	},
/obj/effect/decal/cleanable/dirt,
/obj/machinery/atmospherics/pipe/simple/supply/hidden/layer2{
	dir = 5
	},
/turf/open/floor/plasteel,
/area/template_noop)
"D" = (
/obj/effect/turf_decal/tile/red/tile_marquee,
/obj/effect/turf_decal/tile/yellow/tile_marquee{
	dir = 1
	},
/turf/open/floor/plasteel,
/area/template_noop)
"F" = (
/obj/effect/decal/cleanable/dirt,
/obj/effect/turf_decal/tile/red/tile_marquee,
/obj/effect/turf_decal/tile/yellow/tile_marquee{
	dir = 1
	},
/turf/open/floor/plasteel,
/area/template_noop)
"G" = (
/obj/item/radio/intercom{
	pixel_x = 29
	},
/obj/effect/turf_decal/tile/red{
	dir = 1
	},
/obj/effect/turf_decal/tile/yellow{
	dir = 8
	},
/obj/machinery/vending/tool,
/turf/open/floor/plasteel/dark/side{
	dir = 4
	},
/area/template_noop)
"I" = (
/obj/structure/chair/stool/bar{
	pixel_x = 8
	},
/obj/effect/decal/cleanable/dirt,
/obj/effect/turf_decal/tile/red/tile_marquee,
/obj/effect/turf_decal/tile/yellow/tile_marquee{
	dir = 1
	},
/turf/open/floor/plasteel,
/area/template_noop)
"J" = (
/obj/machinery/door/airlock/maintenance{
	name = "Vending machine Store Maintenance";
	req_access_txt = "12"
	},
/obj/machinery/atmospherics/pipe/simple/supply/hidden/layer2,
/obj/machinery/atmospherics/pipe/simple/scrubbers/hidden/layer4,
/turf/template_noop,
/area/template_noop)
"R" = (
/obj/machinery/computer/arcade{
	dir = 8
	},
/obj/effect/turf_decal/tile/red{
	dir = 1
	},
/obj/effect/turf_decal/tile/yellow{
	dir = 8
	},
/turf/open/floor/plasteel/dark/side{
	dir = 4
	},
/area/template_noop)
"S" = (
/obj/machinery/vending/snack/random,
/obj/machinery/light{
	dir = 8
	},
/obj/effect/turf_decal/tile/red,
/obj/effect/turf_decal/tile/yellow{
	dir = 4
	},
/turf/open/floor/plasteel/dark/side{
	dir = 8
	},
/area/template_noop)
"T" = (
/obj/effect/decal/cleanable/dirt,
/obj/effect/turf_decal/tile/red{
	dir = 1
	},
/obj/effect/turf_decal/tile/yellow{
	dir = 8
	},
/obj/machinery/vending/autodrobe/all_access,
/turf/open/floor/plasteel/dark/side{
	dir = 4
	},
/area/template_noop)
"U" = (
/obj/effect/spawner/structure/window/reinforced,
/turf/open/floor/plating,
/area/template_noop)
"V" = (
/obj/machinery/vending/cigarette,
/obj/effect/decal/cleanable/dirt,
/obj/effect/turf_decal/tile/red,
/obj/effect/turf_decal/tile/yellow{
	dir = 4
	},
/turf/open/floor/plasteel/dark/side{
	dir = 8
	},
/area/template_noop)
"W" = (
/obj/machinery/door/firedoor,
/obj/effect/turf_decal/stripes/closeup,
/turf/open/floor/plasteel/grid/steel,
/area/template_noop)
"Y" = (
/obj/effect/decal/cleanable/dirt,
/obj/effect/turf_decal/tile/red/tile_marquee,
/obj/effect/turf_decal/tile/yellow/tile_marquee{
	dir = 1
	},
/obj/machinery/atmospherics/pipe/simple/supply/hidden/layer2{
	dir = 4
	},
/turf/open/floor/plasteel,
/area/template_noop)
"Z" = (
/obj/effect/turf_decal/tile/red,
/obj/effect/turf_decal/tile/yellow{
	dir = 4
	},
/obj/machinery/vending/cola/random,
/turf/open/floor/plasteel/dark/side{
	dir = 8
	},
/area/template_noop)

(1,1,1) = {"
U
r
t
Z
y
S
V
a
j
f
a
"}
(2,1,1) = {"
W
F
x
e
A
e
C
a
B
p
J
"}
(3,1,1) = {"
W
I
n
D
D
D
Y
a
a
u
a
"}
(4,1,1) = {"
U
R
z
G
T
h
v
w
k
g
l
"}
(5,1,1) = {"
a
a
a
a
a
a
a
a
a
a
l
"}
