//MAP CONVERTED BY dmm2tgm.py THIS HEADER COMMENT PREVENTS RECONVERSION, DO NOT REMOVE
"a" = (
/turf/closed/wall,
/area/template_noop)
"b" = (
/obj/structure/flora/ausbushes/ywflowers{
	dir = 1
	},
/obj/machinery/atmospherics/pipe/simple/supply/hidden/layer1{
	dir = 1
	},
/turf/open/floor/grass,
/area/template_noop)
"c" = (
/obj/machinery/hydroponics/soil{
	dir = 1
	},
/obj/item/radio/intercom{
	pixel_x = 29;
	dir = 1
	},
/obj/item/seeds/cannabis{
	dir = 1
	},
/turf/open/floor/grass,
/area/template_noop)
"f" = (
/obj/effect/turf_decal/tile/neutral{
	dir = 1
	},
/obj/effect/turf_decal/bot{
	dir = 4
	},
/obj/effect/decal/cleanable/dirt{
	dir = 4
	},
/obj/machinery/biogenerator{
	dir = 1
	},
/obj/effect/turf_decal/tile/neutral/tile_side{
	dir = 1
	},
/turf/open/floor/plasteel/dark,
/area/template_noop)
"h" = (
/obj/machinery/newscaster{
	pixel_x = 28;
	pixel_y = -1;
	dir = 1
	},
/turf/open/floor/grass,
/area/template_noop)
"j" = (
/obj/structure/table/glass{
	dir = 1
	},
/obj/item/shovel/spade{
	dir = 1
	},
/obj/item/plant_analyzer{
	dir = 1
	},
/obj/item/cultivator{
	pixel_x = 6;
	dir = 1
	},
/obj/item/reagent_containers/spray/plantbgone{
	pixel_x = 6;
	pixel_y = -6;
	dir = 1
	},
/obj/effect/turf_decal/tile/neutral/tile_side{
	dir = 1
	},
/obj/machinery/light{
	dir = 8
	},
/obj/item/reagent_containers/glass/bucket{
	dir = 1
	},
/turf/open/floor/plasteel/dark,
/area/template_noop)
"k" = (
/obj/structure/flora/grass/jungle/b{
	dir = 1
	},
/obj/structure/extinguisher_cabinet{
	pixel_x = 24;
	dir = 1
	},
/obj/machinery/light{
	dir = 4
	},
/turf/open/floor/grass,
/area/template_noop)
"l" = (
/obj/machinery/atmospherics/pipe/simple/supply/hidden/layer1{
	dir = 1
	},
/turf/open/floor/grass,
/area/template_noop)
"n" = (
/obj/machinery/atmospherics/components/unary/vent_scrubber/on/layer3{
	dir = 8
	},
/turf/open/floor/grass,
/area/template_noop)
"o" = (
/obj/structure/closet{
	name = "beekeeping wardrobe";
	dir = 1
	},
/obj/item/clothing/suit/beekeeper_suit{
	dir = 1
	},
/obj/item/clothing/suit/beekeeper_suit{
	dir = 1
	},
/obj/item/clothing/suit/beekeeper_suit{
	dir = 1
	},
/obj/item/clothing/head/beekeeper_head{
	dir = 1
	},
/obj/item/clothing/head/beekeeper_head{
	dir = 1
	},
/obj/item/clothing/head/beekeeper_head{
	dir = 1
	},
/obj/item/melee/flyswatter{
	dir = 1
	},
/obj/item/melee/flyswatter{
	dir = 1
	},
/obj/item/melee/flyswatter{
	dir = 1
	},
/obj/effect/turf_decal/bot{
	dir = 4
	},
/obj/effect/turf_decal/tile/neutral/tile_side{
	dir = 4
	},
/turf/open/floor/plasteel/dark,
/area/template_noop)
"p" = (
/obj/machinery/atmospherics/components/unary/vent_pump/on/layer1{
	dir = 8
	},
/turf/open/floor/grass,
/area/template_noop)
"r" = (
/obj/structure/flora/ausbushes/leafybush{
	dir = 1
	},
/obj/machinery/light{
	dir = 8
	},
/turf/open/floor/grass,
/area/template_noop)
"v" = (
/obj/structure/flora/ausbushes/ywflowers{
	dir = 1
	},
/turf/open/floor/grass,
/area/template_noop)
"w" = (
/turf/closed/wall/r_wall,
/area/template_noop)
"x" = (
/obj/structure/closet{
	name = "beekeeping supplies";
	dir = 1
	},
/obj/item/honey_frame{
	dir = 1
	},
/obj/item/honey_frame{
	dir = 1
	},
/obj/item/honey_frame{
	dir = 1
	},
/obj/item/honey_frame{
	dir = 1
	},
/obj/item/honey_frame{
	dir = 1
	},
/obj/item/honey_frame{
	dir = 1
	},
/obj/effect/turf_decal/bot{
	dir = 4
	},
/obj/effect/turf_decal/tile/neutral/tile_side{
	dir = 9
	},
/turf/open/floor/plasteel/dark,
/area/template_noop)
"y" = (
/obj/machinery/hydroponics/soil{
	dir = 1
	},
/obj/item/seeds/liberty{
	dir = 1
	},
/turf/open/floor/grass,
/area/template_noop)
"z" = (
/obj/machinery/hydroponics/soil{
	dir = 1
	},
/obj/item/seeds/ambrosia{
	dir = 1
	},
/turf/open/floor/grass,
/area/template_noop)
"A" = (
/obj/machinery/hydroponics/soil{
	dir = 1
	},
/obj/item/seeds/cabbage{
	dir = 1
	},
/turf/open/floor/grass,
/area/template_noop)
"D" = (
/obj/structure/flora/ausbushes/grassybush{
	dir = 1
	},
/obj/machinery/atmospherics/pipe/simple/supply/hidden/layer1{
	dir = 5
	},
/turf/open/floor/grass,
/area/template_noop)
"F" = (
/turf/open/floor/grass,
/area/template_noop)
"G" = (
/obj/structure/beebox{
	dir = 1
	},
/turf/open/floor/grass,
/area/template_noop)
"H" = (
/obj/structure/flora/grass/jungle/b{
	dir = 1
	},
/obj/structure/flora/ausbushes/grassybush{
	dir = 1
	},
/obj/structure/flora/ausbushes/leafybush{
	dir = 1
	},
/obj/structure/flora/ausbushes/ywflowers{
	dir = 1
	},
/obj/structure/flora/ausbushes/leafybush{
	dir = 1
	},
/obj/machinery/atmospherics/pipe/simple/supply/hidden/layer1{
	dir = 1
	},
/obj/machinery/atmospherics/pipe/simple/scrubbers/hidden/layer3{
	dir = 5
	},
/turf/open/floor/grass,
/area/template_noop)
"I" = (
/obj/effect/turf_decal/bot{
	dir = 4
	},
/obj/effect/decal/cleanable/dirt{
	dir = 4
	},
/obj/machinery/seed_extractor{
	dir = 1
	},
/obj/effect/turf_decal/tile/neutral/tile_side{
	dir = 5
	},
/turf/open/floor/plasteel/dark,
/area/template_noop)
"J" = (
/obj/machinery/door/airlock/maintenance{
	name = "Apiary Maintenance";
	req_one_access_txt = "22;35";
	dir = 1
	},
/obj/machinery/atmospherics/pipe/simple/supply/hidden/layer1{
	dir = 1
	},
/obj/machinery/atmospherics/pipe/simple/scrubbers/hidden/layer3{
	dir = 1
	},
/turf/template_noop,
/area/template_noop)
"L" = (
/obj/machinery/hydroponics/soil{
	dir = 1
	},
/obj/item/seeds/bamboo{
	dir = 1
	},
/turf/open/floor/grass,
/area/template_noop)
"O" = (
/obj/machinery/hydroponics/soil{
	dir = 1
	},
/obj/item/seeds/carrot{
	dir = 1
	},
/turf/open/floor/grass,
/area/template_noop)
"P" = (
/obj/structure/flora/grass/jungle/b{
	dir = 1
	},
/obj/machinery/atmospherics/pipe/simple/supply/hidden/layer1{
	dir = 1
	},
/turf/open/floor/grass,
/area/template_noop)
"R" = (
/obj/structure/flora/grass/jungle/b{
	dir = 1
	},
/obj/machinery/light{
	dir = 4
	},
/obj/machinery/light_switch{
	pixel_x = 22;
	dir = 1
	},
/turf/open/floor/grass,
/area/template_noop)
"S" = (
/obj/structure/flora/grass/jungle/b{
	dir = 1
	},
/obj/structure/flora/ausbushes/grassybush{
	dir = 1
	},
/turf/open/floor/grass,
/area/template_noop)
"U" = (
/obj/effect/spawner/structure/window/reinforced{
	dir = 1
	},
/turf/open/floor/plating,
/area/template_noop)
"V" = (
/obj/structure/flora/ausbushes/leafybush{
	dir = 1
	},
/turf/open/floor/grass,
/area/template_noop)
"W" = (
/obj/machinery/door/airlock/public/glass{
	name = "Apiary";
	req_one_access_txt = "22;35";
	dir = 1
	},
/obj/machinery/door/firedoor{
	dir = 1
	},
/obj/effect/turf_decal/stripes/closeup{
	dir = 4
	},
/turf/open/floor/plasteel/grid/steel,
/area/template_noop)
"Y" = (
/obj/machinery/atmospherics/pipe/simple/supply/hidden/layer1{
	dir = 1
	},
/obj/machinery/atmospherics/pipe/simple/scrubbers/hidden/layer3{
	dir = 1
	},
/turf/open/floor/grass,
/area/template_noop)

(1,1,1) = {"
a
f
j
I
y
F
A
G
z
r
U"}(2,1,1) = {"
J
Y
Y
H
l
b
l
P
D
v
W"}(3,1,1) = {"
a
x
V
n
S
F
V
v
p
S
W"}(4,1,1) = {"
w
o
k
V
O
h
c
G
L
R
U"}(5,1,1) = {"
w
a
a
U
U
a
a
U
U
a
a"}