//MAP CONVERTED BY dmm2tgm.py THIS HEADER COMMENT PREVENTS RECONVERSION, DO NOT REMOVE
"a" = (
/obj/effect/turf_decal/tile/neutral{
	dir = 2
	},
/obj/effect/turf_decal/tile/neutral{
	dir = 1
	},
/obj/structure/closet/secure_closet/courtroom{
	dir = 1
	},
/turf/open/floor/holofloor/dark,
/area/template_noop)
"b" = (
/obj/effect/turf_decal/tile/neutral{
	dir = 2
	},
/obj/effect/turf_decal/tile/neutral{
	dir = 1
	},
/obj/structure/table/wood{
	dir = 1
	},
/obj/item/reagent_containers/food/snacks/grown/harebell{
	dir = 1
	},
/obj/item/reagent_containers/food/snacks/grown/harebell{
	dir = 1
	},
/obj/item/reagent_containers/food/snacks/grown/harebell{
	dir = 1
	},
/obj/item/reagent_containers/food/snacks/grown/harebell{
	dir = 1
	},
/obj/item/reagent_containers/food/snacks/grown/harebell{
	dir = 1
	},
/turf/open/floor/holofloor/dark,
/area/template_noop)
"c" = (
/obj/structure/chair{
	dir = 2
	},
/turf/open/floor/holofloor/chapel/bottom_left,
/area/template_noop)
"d" = (
/obj/structure/table/wood/fancy{
	dir = 1
	},
/obj/item/clothing/suit/chaplainsuit/nun{
	dir = 1
	},
/obj/item/clothing/head/nun_hood{
	dir = 1
	},
/obj/item/clothing/suit/chaplainsuit/holidaypriest{
	dir = 1
	},
/obj/effect/turf_decal/tile/neutral{
	dir = 4
	},
/obj/effect/turf_decal/tile/neutral{
	dir = 8
	},
/obj/effect/turf_decal/tile/neutral{
	dir = 2
	},
/obj/effect/turf_decal/tile/neutral{
	dir = 1
	},
/turf/open/floor/holofloor/dark,
/area/template_noop)
"f" = (
/turf/open/floor/holofloor/dark,
/area/template_noop)
"g" = (
/turf/open/floor/holofloor/chapel/top_left,
/area/template_noop)
"h" = (
/obj/effect/turf_decal/tile/neutral{
	dir = 2
	},
/obj/effect/turf_decal/tile/neutral{
	dir = 1
	},
/obj/structure/table/wood{
	dir = 1
	},
/obj/item/reagent_containers/food/snacks/grown/poppy{
	dir = 1
	},
/obj/item/reagent_containers/food/snacks/grown/poppy{
	dir = 1
	},
/obj/item/reagent_containers/food/snacks/grown/poppy{
	dir = 1
	},
/obj/item/reagent_containers/food/snacks/grown/poppy{
	dir = 1
	},
/obj/item/reagent_containers/food/snacks/grown/poppy{
	dir = 1
	},
/turf/open/floor/holofloor/dark,
/area/template_noop)
"i" = (
/turf/open/floor/holofloor/chapel/bottom_right,
/area/template_noop)
"k" = (
/obj/structure/chair{
	dir = 2
	},
/turf/open/floor/holofloor/chapel/top_right,
/area/template_noop)
"l" = (
/obj/effect/turf_decal/tile/neutral{
	dir = 2
	},
/obj/effect/turf_decal/tile/neutral{
	dir = 1
	},
/obj/structure/table/wood{
	dir = 1
	},
/obj/item/folder/blue{
	dir = 1
	},
/obj/item/pen/red{
	dir = 1
	},
/turf/open/floor/holofloor/dark,
/area/template_noop)
"m" = (
/obj/item/clothing/head/chaplain/witchunter_hat{
	dir = 1
	},
/obj/effect/turf_decal/tile/neutral{
	dir = 4
	},
/obj/effect/turf_decal/tile/neutral{
	dir = 8
	},
/obj/effect/turf_decal/tile/neutral{
	dir = 2
	},
/obj/effect/turf_decal/tile/neutral{
	dir = 1
	},
/obj/structure/table/wood/fancy{
	dir = 1
	},
/turf/open/floor/holofloor/dark,
/area/template_noop)
"o" = (
/obj/effect/turf_decal/tile/neutral{
	dir = 2
	},
/obj/effect/turf_decal/tile/neutral{
	dir = 1
	},
/obj/structure/table/wood{
	dir = 1
	},
/obj/item/storage/fancy/candle_box{
	dir = 1
	},
/turf/open/floor/holofloor/dark,
/area/template_noop)
"p" = (
/obj/structure/table/wood{
	dir = 1
	},
/obj/effect/turf_decal/tile/neutral{
	dir = 1
	},
/obj/effect/turf_decal/tile/neutral{
	dir = 4
	},
/turf/open/floor/holofloor/dark,
/area/template_noop)
"q" = (
/obj/effect/turf_decal/tile/neutral{
	dir = 2
	},
/obj/effect/turf_decal/tile/neutral{
	dir = 1
	},
/obj/structure/table/wood{
	dir = 1
	},
/obj/item/folder/red{
	dir = 1
	},
/obj/item/pen/red{
	dir = 1
	},
/turf/open/floor/holofloor/dark,
/area/template_noop)
"r" = (
/obj/item/gavelblock{
	dir = 1
	},
/obj/item/gavelhammer{
	dir = 1
	},
/obj/structure/table/wood{
	dir = 1
	},
/obj/effect/turf_decal/tile/neutral{
	dir = 1
	},
/obj/effect/turf_decal/tile/neutral{
	dir = 4
	},
/turf/open/floor/holofloor/dark,
/area/template_noop)
"s" = (
/obj/effect/turf_decal/tile/neutral{
	dir = 2
	},
/obj/effect/turf_decal/tile/neutral{
	dir = 1
	},
/turf/open/floor/holofloor/dark,
/area/template_noop)
"u" = (
/obj/structure/table/wood/fancy{
	dir = 1
	},
/obj/item/storage/book/bible{
	dir = 1
	},
/obj/effect/turf_decal/tile/neutral{
	dir = 4
	},
/obj/effect/turf_decal/tile/neutral{
	dir = 8
	},
/obj/effect/turf_decal/tile/neutral{
	dir = 2
	},
/obj/effect/turf_decal/tile/neutral{
	dir = 1
	},
/turf/open/floor/holofloor/dark,
/area/template_noop)
"w" = (
/obj/effect/turf_decal/tile/neutral{
	dir = 4
	},
/obj/effect/turf_decal/tile/neutral{
	dir = 2
	},
/turf/open/floor/holofloor/dark,
/area/template_noop)
"x" = (
/obj/effect/turf_decal/tile/neutral{
	dir = 4
	},
/obj/effect/turf_decal/tile/neutral{
	dir = 8
	},
/obj/effect/turf_decal/tile/neutral{
	dir = 2
	},
/obj/effect/turf_decal/tile/neutral{
	dir = 1
	},
/turf/open/floor/holofloor/dark,
/area/template_noop)
"y" = (
/obj/item/toy/figure/chaplain{
	dir = 1
	},
/obj/effect/turf_decal/tile/neutral{
	dir = 4
	},
/obj/effect/turf_decal/tile/neutral{
	dir = 8
	},
/obj/effect/turf_decal/tile/neutral{
	dir = 2
	},
/obj/effect/turf_decal/tile/neutral{
	dir = 1
	},
/obj/structure/table/wood/fancy{
	dir = 1
	},
/turf/open/floor/holofloor/dark,
/area/template_noop)
"A" = (
/turf/open/floor/holofloor/chapel/bottom_left,
/area/template_noop)
"C" = (
/obj/structure/chair{
	dir = 2
	},
/turf/open/floor/holofloor/chapel,
/area/template_noop)
"E" = (
/obj/structure/chair{
	dir = 2
	},
/turf/open/floor/holofloor/chapel/bottom_right,
/area/template_noop)
"F" = (
/obj/item/clothing/suit/judgerobe{
	dir = 1
	},
/obj/item/clothing/head/powdered_wig{
	dir = 1
	},
/obj/effect/turf_decal/tile/neutral{
	dir = 4
	},
/obj/effect/turf_decal/tile/neutral{
	dir = 8
	},
/obj/effect/turf_decal/tile/neutral{
	dir = 2
	},
/obj/effect/turf_decal/tile/neutral{
	dir = 1
	},
/obj/structure/table/wood/fancy{
	dir = 1
	},
/turf/open/floor/holofloor/dark,
/area/template_noop)
"H" = (
/obj/structure/table/wood/fancy{
	dir = 1
	},
/obj/item/book/manual/wiki/security_space_law{
	dir = 1
	},
/obj/effect/turf_decal/tile/neutral{
	dir = 4
	},
/obj/effect/turf_decal/tile/neutral{
	dir = 8
	},
/obj/effect/turf_decal/tile/neutral{
	dir = 2
	},
/obj/effect/turf_decal/tile/neutral{
	dir = 1
	},
/turf/open/floor/holofloor/dark,
/area/template_noop)
"I" = (
/obj/effect/turf_decal/tile/neutral{
	dir = 1
	},
/obj/effect/turf_decal/tile/neutral{
	dir = 8
	},
/turf/open/floor/holofloor/dark,
/area/template_noop)
"K" = (
/turf/open/floor/holofloor/chapel/top_right,
/area/template_noop)
"L" = (
/obj/structure/chair{
	dir = 2
	},
/obj/effect/turf_decal/tile/neutral{
	dir = 2
	},
/obj/effect/turf_decal/tile/neutral{
	dir = 1
	},
/turf/open/floor/holofloor/dark,
/area/template_noop)
"N" = (
/obj/effect/turf_decal/tile/neutral{
	dir = 1
	},
/obj/effect/turf_decal/tile/neutral{
	dir = 8
	},
/obj/effect/turf_decal/tile/neutral{
	dir = 4
	},
/turf/open/floor/holofloor/dark,
/area/template_noop)
"O" = (
/obj/effect/turf_decal/tile/neutral{
	dir = 2
	},
/obj/effect/turf_decal/tile/neutral{
	dir = 1
	},
/obj/structure/table/wood{
	dir = 1
	},
/obj/item/paper_bin{
	dir = 1
	},
/turf/open/floor/holofloor/dark,
/area/template_noop)
"Q" = (
/obj/structure/chair{
	dir = 1
	},
/turf/open/floor/holofloor/dark,
/area/template_noop)
"S" = (
/obj/effect/turf_decal/tile/neutral{
	dir = 1
	},
/obj/effect/turf_decal/tile/neutral{
	dir = 8
	},
/obj/effect/turf_decal/tile/neutral{
	dir = 2
	},
/obj/effect/turf_decal/tile/neutral{
	dir = 4
	},
/turf/open/floor/holofloor/dark,
/area/template_noop)
"T" = (
/obj/structure/chair{
	dir = 2
	},
/turf/open/floor/holofloor/chapel/top_left,
/area/template_noop)
"U" = (
/obj/effect/turf_decal/tile/neutral{
	dir = 2
	},
/obj/effect/turf_decal/tile/neutral{
	dir = 1
	},
/obj/structure/table/wood{
	dir = 1
	},
/obj/item/hand_labeler{
	dir = 1
	},
/turf/open/floor/holofloor/dark,
/area/template_noop)
"W" = (
/obj/effect/turf_decal/tile/neutral{
	dir = 1
	},
/obj/effect/turf_decal/tile/neutral{
	dir = 4
	},
/obj/effect/turf_decal/tile/neutral{
	dir = 2
	},
/turf/open/floor/holofloor/dark,
/area/template_noop)
"X" = (
/obj/item/clothing/suit/chaplainsuit/bishoprobe{
	dir = 1
	},
/obj/effect/turf_decal/tile/neutral{
	dir = 4
	},
/obj/effect/turf_decal/tile/neutral{
	dir = 8
	},
/obj/effect/turf_decal/tile/neutral{
	dir = 2
	},
/obj/effect/turf_decal/tile/neutral{
	dir = 1
	},
/obj/structure/table/wood/fancy{
	dir = 1
	},
/turf/open/floor/holofloor/dark,
/area/template_noop)

(1,1,1) = {"
a
L
L
A
T
c
g
A
g
x"}(2,1,1) = {"
O
L
L
i
k
C
K
i
K
y"}(3,1,1) = {"
q
L
L
A
T
c
g
N
I
F"}(4,1,1) = {"
l
L
L
i
k
C
K
p
f
d"}(5,1,1) = {"
h
s
s
S
S
S
S
r
Q
u"}(6,1,1) = {"
b
L
L
A
T
c
g
p
f
H"}(7,1,1) = {"
o
L
L
i
k
E
K
W
w
m"}(8,1,1) = {"
U
L
L
A
T
c
g
A
g
X"}(9,1,1) = {"
a
L
L
i
k
E
K
i
K
x"}