//MAP CONVERTED BY dmm2tgm.py THIS HEADER COMMENT PREVENTS RECONVERSION, DO NOT REMOVE
"a" = (
/turf/open/floor/holofloor/plating,
/area/template_noop)
"c" = (
/obj/machinery/button/massdriver/indestructible{
	id = "trektorpedo1";
	layer = 3.9;
	name = "photon torpedo button";
	pixel_x = -16;
	pixel_y = 5;
	dir = 1
	},
/obj/machinery/button/massdriver/indestructible{
	id = "trektorpedo2";
	layer = 3.9;
	name = "photon torpedo button";
	pixel_x = 16;
	pixel_y = 5;
	dir = 1
	},
/obj/machinery/computer/arcade/orion_trail/kobayashi{
	dir = 1
	},
/turf/open/floor/holofloor/plating,
/area/template_noop)
"d" = (
/obj/machinery/computer/station_alert{
	dir = 4
	},
/turf/open/floor/holofloor/plating,
/area/template_noop)
"f" = (
/obj/machinery/door/window/westleft{
	dir = 2
	},
/turf/open/floor/holofloor/plating,
/area/template_noop)
"j" = (
/obj/structure/chair/office{
	dir = 2
	},
/turf/open/floor/holofloor/plating,
/area/template_noop)
"k" = (
/obj/structure/chair/office{
	dir = 8
	},
/turf/open/floor/holofloor/plating,
/area/template_noop)
"l" = (
/obj/structure/window/reinforced{
	dir = 1
	},
/obj/machinery/computer/station_alert{
	dir = 8
	},
/turf/open/floor/holofloor/plating,
/area/template_noop)
"m" = (
/obj/effect/turf_decal/tile/neutral{
	dir = 2
	},
/obj/effect/turf_decal/tile/neutral{
	dir = 8
	},
/obj/structure/window/reinforced{
	dir = 8
	},
/turf/open/floor/holofloor,
/area/template_noop)
"o" = (
/obj/structure/chair/comfy/beige{
	dir = 2
	},
/turf/open/floor/holofloor/plating,
/area/template_noop)
"p" = (
/obj/structure/window/reinforced{
	dir = 8
	},
/obj/machinery/computer/arcade/orion_trail/kobayashi{
	dir = 1
	},
/turf/open/floor/holofloor/plating,
/area/template_noop)
"r" = (
/obj/structure/table{
	dir = 1
	},
/turf/open/floor/holofloor/plating,
/area/template_noop)
"s" = (
/obj/effect/turf_decal/tile/neutral{
	dir = 4
	},
/obj/effect/turf_decal/tile/neutral{
	dir = 1
	},
/turf/open/floor/holofloor,
/area/template_noop)
"t" = (
/obj/structure/table/glass{
	dir = 1
	},
/obj/item/gun/energy/e_gun/mini/practice_phaser{
	dir = 1
	},
/obj/structure/window/reinforced{
	dir = 8
	},
/obj/machinery/recharger{
	dir = 1
	},
/turf/open/floor/holofloor/plating,
/area/template_noop)
"w" = (
/obj/structure/table{
	dir = 1
	},
/obj/item/folder{
	dir = 1
	},
/obj/item/pen/blue{
	dir = 1
	},
/obj/structure/window/reinforced{
	dir = 8
	},
/obj/effect/turf_decal/tile/neutral{
	dir = 8
	},
/obj/effect/turf_decal/tile/neutral{
	dir = 2
	},
/turf/open/floor/holofloor,
/area/template_noop)
"x" = (
/obj/structure/window/reinforced{
	dir = 4
	},
/obj/machinery/computer/arcade/orion_trail/kobayashi{
	dir = 1
	},
/turf/open/floor/holofloor/plating,
/area/template_noop)
"y" = (
/turf/open/floor/holofloor/hyperspace,
/area/template_noop)
"z" = (
/obj/machinery/computer/atmos_alert{
	dir = 8
	},
/obj/structure/window/reinforced{
	dir = 1
	},
/turf/open/floor/holofloor/plating,
/area/template_noop)
"A" = (
/obj/structure/window/reinforced{
	dir = 1
	},
/turf/open/floor/holofloor/plating,
/area/template_noop)
"B" = (
/obj/structure/window/reinforced{
	dir = 1
	},
/turf/open/floor/holofloor/hyperspace,
/area/template_noop)
"C" = (
/obj/machinery/computer/station_alert{
	dir = 8
	},
/turf/open/floor/holofloor/plating,
/area/template_noop)
"E" = (
/obj/structure/chair{
	dir = 2
	},
/turf/open/floor/holofloor,
/area/template_noop)
"F" = (
/obj/structure/rack{
	dir = 1
	},
/obj/item/clothing/under/trek/engsec{
	dir = 1
	},
/obj/item/clothing/under/trek/engsec{
	dir = 1
	},
/obj/effect/turf_decal/tile/neutral{
	dir = 2
	},
/obj/effect/turf_decal/tile/neutral{
	dir = 8
	},
/obj/structure/window/reinforced{
	dir = 4;
	layer = 2.9
	},
/turf/open/floor/holofloor,
/area/template_noop)
"H" = (
/obj/machinery/door/window/westleft{
	dir = 2;
	icon_state = "right"
	},
/turf/open/floor/holofloor/plating,
/area/template_noop)
"J" = (
/obj/effect/turf_decal/tile/neutral{
	dir = 2
	},
/obj/effect/turf_decal/tile/neutral{
	dir = 8
	},
/obj/structure/window/reinforced{
	dir = 4;
	layer = 2.9
	},
/turf/open/floor/holofloor,
/area/template_noop)
"L" = (
/obj/structure/table/glass{
	dir = 1
	},
/obj/item/gun/energy/e_gun/mini/practice_phaser{
	dir = 1
	},
/obj/structure/window/reinforced{
	dir = 4
	},
/turf/open/floor/holofloor/plating,
/area/template_noop)
"Q" = (
/obj/structure/table{
	dir = 1
	},
/obj/structure/window/reinforced{
	dir = 4
	},
/obj/item/folder{
	dir = 1
	},
/obj/item/pen/red{
	dir = 1
	},
/obj/effect/turf_decal/tile/neutral{
	dir = 8
	},
/obj/effect/turf_decal/tile/neutral{
	dir = 2
	},
/turf/open/floor/holofloor,
/area/template_noop)
"T" = (
/obj/structure/rack{
	dir = 1
	},
/obj/item/clothing/under/trek/medsci{
	dir = 1
	},
/obj/item/clothing/under/trek/medsci{
	dir = 1
	},
/obj/item/clothing/under/trek/command{
	dir = 1
	},
/obj/effect/turf_decal/tile/neutral{
	dir = 2
	},
/obj/effect/turf_decal/tile/neutral{
	dir = 8
	},
/obj/structure/window/reinforced{
	dir = 8
	},
/turf/open/floor/holofloor,
/area/template_noop)
"V" = (
/obj/structure/window/reinforced{
	dir = 1
	},
/obj/machinery/mass_driver{
	dir = 2;
	id = "trektorpedo2";
	name = "photon torpedo tube"
	},
/obj/item/toy/minimeteor{
	desc = "A primitive long-range weapon, inferior to Nanotrasen's perfected bluespace artillery.";
	icon = 'icons/effects/effects.dmi';
	icon_state = "impact_laser";
	name = "photon torpedo";
	dir = 1
	},
/turf/open/floor/holofloor/hyperspace,
/area/template_noop)
"X" = (
/obj/structure/chair/office{
	dir = 4
	},
/turf/open/floor/holofloor/plating,
/area/template_noop)
"Z" = (
/obj/structure/table{
	dir = 1
	},
/obj/item/folder{
	dir = 1
	},
/obj/item/pen{
	dir = 1
	},
/obj/effect/turf_decal/tile/neutral{
	dir = 8
	},
/obj/effect/turf_decal/tile/neutral{
	dir = 2
	},
/turf/open/floor/holofloor,
/area/template_noop)

(1,1,1) = {"
a
a
a
a
l
C
a
B
y
y"}(2,1,1) = {"
a
a
a
a
k
k
a
B
y
y"}(3,1,1) = {"
T
m
H
a
a
a
a
t
V
y"}(4,1,1) = {"
s
E
w
A
a
a
a
a
p
B"}(5,1,1) = {"
s
E
Z
A
o
a
a
j
c
B"}(6,1,1) = {"
s
E
Q
A
r
a
a
a
x
B"}(7,1,1) = {"
F
J
f
a
a
a
a
L
V
y"}(8,1,1) = {"
a
a
a
a
X
X
a
B
y
y"}(9,1,1) = {"
a
a
a
a
z
d
a
B
y
y"}