//MAP CONVERTED BY dmm2tgm.py THIS HEADER COMMENT PREVENTS RECONVERSION, DO NOT REMOVE
"a" = (
/obj/structure/chair/fancy/comfy{
	buildstackamount = 0;
	color = "#742925"
	},
/turf/open/floor/carpet/royalblue,
/area/template_noop)
"b" = (
/obj/structure/table/wood/bar,
/turf/open/floor/holofloor{
	dir = 9;
	icon_state = "wood"
	},
/area/template_noop)
"c" = (
/obj/effect/turf_decal/siding/wood/corner{
	dir = 8
	},
/turf/open/floor/carpet/blue,
/area/template_noop)
"d" = (
/obj/effect/turf_decal/siding/wood{
	dir = 4
	},
/turf/open/floor/carpet/royalblue,
/area/template_noop)
"f" = (
/obj/effect/turf_decal/siding/wood{
	dir = 8
	},
/turf/open/floor/carpet/blue,
/area/template_noop)
"g" = (
/obj/item/kirbyplants/random,
/obj/item/storage/box/matches,
/turf/open/floor/holofloor{
	dir = 9;
	icon_state = "wood"
	},
/area/template_noop)
"h" = (
/obj/effect/turf_decal/siding/wood{
	dir = 5
	},
/turf/open/floor/carpet/royalblue,
/area/template_noop)
"i" = (
/obj/structure/table/wood/bar,
/obj/effect/turf_decal/siding/wood/corner{
	dir = 8
	},
/turf/open/floor/carpet/royalblue,
/area/template_noop)
"j" = (
/obj/machinery/photocopier,
/obj/effect/turf_decal/bot,
/turf/open/floor/holofloor{
	dir = 9;
	icon_state = "wood"
	},
/area/template_noop)
"k" = (
/obj/structure/table/wood/bar,
/obj/effect/turf_decal/siding/wood{
	dir = 8
	},
/turf/open/floor/carpet/royalblue,
/area/template_noop)
"l" = (
/turf/open/floor/carpet/blue,
/area/template_noop)
"m" = (
/obj/structure/table/wood/bar,
/obj/item/toy/figure/ninja{
	pixel_y = 3
	},
/turf/open/floor/holofloor{
	dir = 9;
	icon_state = "wood"
	},
/area/template_noop)
"n" = (
/obj/structure/chair/fancy/comfy{
	color = "#596479"
	},
/turf/open/floor/carpet/royalblue,
/area/template_noop)
"o" = (
/obj/structure/table/wood/bar,
/obj/effect/turf_decal/siding/wood{
	dir = 6
	},
/turf/open/floor/carpet/royalblue,
/area/template_noop)
"p" = (
/obj/structure/table/wood/bar,
/obj/effect/turf_decal/siding/wood,
/turf/open/floor/carpet/royalblue,
/area/template_noop)
"q" = (
/obj/structure/table/wood/bar,
/obj/effect/turf_decal/siding/wood/corner,
/obj/item/storage/fancy/cigarettes/cigars/cohiba{
	pixel_y = 8
	},
/turf/open/floor/carpet/royalblue,
/area/template_noop)
"r" = (
/obj/item/kirbyplants/random,
/turf/open/floor/holofloor{
	dir = 9;
	icon_state = "wood"
	},
/area/template_noop)
"s" = (
/obj/effect/turf_decal/siding/wood/corner{
	dir = 1
	},
/turf/open/floor/carpet/royalblue,
/area/template_noop)
"t" = (
/obj/machinery/vending/snack/green,
/obj/effect/turf_decal/bot,
/turf/open/floor/holofloor{
	dir = 9;
	icon_state = "wood"
	},
/area/template_noop)
"u" = (
/obj/effect/turf_decal/siding/wood{
	dir = 4
	},
/turf/open/floor/carpet/blue,
/area/template_noop)
"v" = (
/obj/structure/table/wood/bar,
/obj/effect/turf_decal/siding/wood/corner,
/turf/open/floor/carpet/royalblue,
/area/template_noop)
"w" = (
/obj/structure/table/wood/bar,
/obj/item/book/fish_catalog,
/obj/effect/holodeck_effect/random_book,
/turf/open/floor/holofloor{
	dir = 9;
	icon_state = "wood"
	},
/area/template_noop)
"x" = (
/obj/effect/turf_decal/siding/wood{
	dir = 8
	},
/turf/open/floor/carpet/royalblue,
/area/template_noop)
"y" = (
/obj/effect/turf_decal/siding/wood/corner,
/turf/open/floor/carpet/blue,
/area/template_noop)
"z" = (
/obj/effect/turf_decal/siding/wood/corner{
	dir = 4
	},
/turf/open/floor/carpet/royalblue,
/area/template_noop)
"A" = (
/obj/structure/table/wood/bar,
/obj/effect/spawner/bundle/costume/cutewitch,
/turf/open/floor/holofloor{
	dir = 9;
	icon_state = "wood"
	},
/area/template_noop)
"B" = (
/obj/structure/table/wood/bar,
/obj/item/kirbyplants{
	icon_state = "plant-22";
	pixel_y = 13
	},
/turf/open/floor/holofloor{
	dir = 9;
	icon_state = "wood"
	},
/area/template_noop)
"D" = (
/obj/structure/table/wood/bar,
/obj/effect/turf_decal/siding/wood{
	dir = 4
	},
/turf/open/floor/carpet/royalblue,
/area/template_noop)
"E" = (
/obj/structure/chair/fancy/comfy{
	buildstackamount = 0;
	color = "#742925";
	dir = 4
	},
/turf/open/floor/carpet/royalblue,
/area/template_noop)
"F" = (
/obj/structure/table/wood/bar,
/obj/effect/turf_decal/siding/wood{
	dir = 10
	},
/turf/open/floor/carpet/royalblue,
/area/template_noop)
"H" = (
/obj/structure/table/wood/bar,
/obj/item/toy/cards/deck{
	pixel_y = 7
	},
/turf/open/floor/holofloor{
	dir = 9;
	icon_state = "wood"
	},
/area/template_noop)
"I" = (
/obj/structure/chair/fancy/comfy{
	buildstackamount = 0;
	color = "#742925";
	dir = 8
	},
/obj/effect/turf_decal/siding/wood{
	dir = 4
	},
/turf/open/floor/carpet/royalblue,
/area/template_noop)
"J" = (
/obj/effect/turf_decal/siding/wood{
	dir = 6
	},
/turf/open/floor/carpet/blue,
/area/template_noop)
"M" = (
/obj/effect/turf_decal/siding/wood,
/turf/open/floor/carpet/blue,
/area/template_noop)
"N" = (
/turf/open/floor/holofloor{
	dir = 9;
	icon_state = "wood"
	},
/area/template_noop)
"O" = (
/obj/structure/table/wood/bar,
/obj/item/paper_bin,
/obj/item/pen,
/turf/open/floor/holofloor{
	dir = 9;
	icon_state = "wood"
	},
/area/template_noop)
"P" = (
/obj/effect/turf_decal/siding/wood{
	dir = 6
	},
/turf/open/floor/carpet/royalblue,
/area/template_noop)
"Q" = (
/obj/structure/chair/fancy/comfy{
	buildstackamount = 0;
	color = "#742925";
	dir = 4
	},
/obj/effect/turf_decal/siding/wood{
	dir = 8
	},
/turf/open/floor/carpet/royalblue,
/area/template_noop)
"R" = (
/obj/structure/table/wood/bar,
/obj/item/flashlight/lamp/green{
	layer = 3.3
	},
/turf/open/floor/holofloor{
	dir = 9;
	icon_state = "wood"
	},
/area/template_noop)
"S" = (
/obj/effect/turf_decal/siding/wood{
	dir = 1;
	layer = 1
	},
/turf/open/floor/carpet/royalblue,
/area/template_noop)
"T" = (
/obj/effect/turf_decal/siding/wood{
	dir = 10
	},
/turf/open/floor/carpet/blue,
/area/template_noop)
"U" = (
/obj/effect/turf_decal/siding/wood{
	dir = 10
	},
/turf/open/floor/carpet/royalblue,
/area/template_noop)
"W" = (
/obj/structure/table/wood/bar,
/obj/item/laser_pointer{
	pixel_x = 7;
	pixel_y = 3
	},
/turf/open/floor/holofloor{
	dir = 9;
	icon_state = "wood"
	},
/area/template_noop)
"X" = (
/obj/structure/chair/fancy/comfy{
	buildstackamount = 0;
	color = "#742925";
	dir = 8
	},
/turf/open/floor/carpet/royalblue,
/area/template_noop)
"Y" = (
/obj/effect/turf_decal/siding/wood{
	dir = 9
	},
/turf/open/floor/carpet/royalblue,
/area/template_noop)
"Z" = (
/obj/structure/table/wood/bar,
/obj/effect/turf_decal/siding/wood/corner{
	dir = 8
	},
/obj/item/storage/box/matches{
	pixel_x = -2;
	pixel_y = 8
	},
/turf/open/floor/carpet/royalblue,
/area/template_noop)

(1,1,1) = {"
b
N
N
N
N
N
N
N
N
O
"}
(2,1,1) = {"
N
N
Y
x
Q
Q
Q
Q
U
j
"}
(3,1,1) = {"
N
Y
s
E
v
D
D
D
P
r
"}
(4,1,1) = {"
N
S
a
q
o
l
y
u
J
m
"}
(5,1,1) = {"
N
S
n
p
l
l
M
W
B
R
"}
(6,1,1) = {"
N
S
a
Z
F
l
c
f
T
H
"}
(7,1,1) = {"
N
h
z
X
i
k
k
k
U
g
"}
(8,1,1) = {"
N
N
h
d
I
I
I
I
P
A
"}
(9,1,1) = {"
t
N
N
N
N
N
N
N
N
w
"}
