//MAP CONVERTED BY dmm2tgm.py THIS HEADER COMMENT PREVENTS RECONVERSION, DO NOT REMOVE
"a" = (
/obj/effect/turf_decal/siding/wood/corner{
	dir = 1
	},
/turf/open/floor/carpet/royalblue,
/area/template_noop)
"b" = (
/obj/structure/table/wood/bar,
/obj/effect/turf_decal/siding/wood,
/turf/open/floor/carpet/royalblue,
/area/template_noop)
"c" = (
/obj/structure/table/wood/bar,
/obj/item/laser_pointer{
	pixel_x = 7;
	pixel_y = 3
	},
/turf/open/floor/holofloor{
	dir = 9;
	icon_state = "wood"
	},
/area/template_noop)
"d" = (
/obj/item/kirbyplants/random,
/turf/open/floor/holofloor{
	dir = 9;
	icon_state = "wood"
	},
/area/template_noop)
"e" = (
/obj/machinery/vending/snack/green,
/obj/effect/turf_decal/bot,
/turf/open/floor/holofloor{
	dir = 9;
	icon_state = "wood"
	},
/area/template_noop)
"f" = (
/obj/effect/turf_decal/siding/wood/corner{
	dir = 4
	},
/turf/open/floor/carpet/royalblue,
/area/template_noop)
"g" = (
/obj/structure/table/wood/bar,
/obj/effect/turf_decal/siding/wood{
	dir = 8
	},
/turf/open/floor/carpet/royalblue,
/area/template_noop)
"h" = (
/obj/effect/turf_decal/siding/wood{
	dir = 8
	},
/turf/open/floor/carpet/blue,
/area/template_noop)
"i" = (
/obj/structure/table/wood/bar,
/obj/item/toy/figure/ninja{
	pixel_y = 3
	},
/turf/open/floor/holofloor{
	dir = 9;
	icon_state = "wood"
	},
/area/template_noop)
"j" = (
/obj/effect/turf_decal/siding/wood{
	dir = 6
	},
/turf/open/floor/carpet/blue,
/area/template_noop)
"k" = (
/obj/effect/turf_decal/siding/wood{
	dir = 10
	},
/turf/open/floor/carpet/royalblue,
/area/template_noop)
"l" = (
/obj/structure/table/wood/bar,
/obj/effect/turf_decal/siding/wood{
	dir = 10
	},
/turf/open/floor/carpet/royalblue,
/area/template_noop)
"m" = (
/obj/effect/turf_decal/siding/wood{
	dir = 5
	},
/turf/open/floor/carpet/royalblue,
/area/template_noop)
"n" = (
/obj/structure/table/wood/bar,
/obj/item/paper_bin,
/obj/item/pen,
/turf/open/floor/holofloor{
	dir = 9;
	icon_state = "wood"
	},
/area/template_noop)
"o" = (
/obj/effect/turf_decal/siding/wood,
/turf/open/floor/carpet/blue,
/area/template_noop)
"p" = (
/obj/structure/chair/fancy/comfy{
	buildstackamount = 0;
	color = "#742925"
	},
/turf/open/floor/carpet/royalblue,
/area/template_noop)
"r" = (
/turf/open/floor/carpet/blue,
/area/template_noop)
"s" = (
/obj/effect/turf_decal/siding/wood/corner{
	dir = 8
	},
/turf/open/floor/carpet/blue,
/area/template_noop)
"t" = (
/obj/structure/table/wood/bar,
/obj/effect/turf_decal/siding/wood{
	dir = 6
	},
/turf/open/floor/carpet/royalblue,
/area/template_noop)
"u" = (
/obj/structure/table/wood/bar,
/obj/effect/turf_decal/siding/wood/corner{
	dir = 8
	},
/obj/item/storage/box/matches{
	pixel_x = -2;
	pixel_y = 8
	},
/turf/open/floor/carpet/royalblue,
/area/template_noop)
"v" = (
/obj/structure/table/wood/bar,
/obj/item/book/fish_catalog,
/obj/effect/holodeck_effect/random_book,
/turf/open/floor/holofloor{
	dir = 9;
	icon_state = "wood"
	},
/area/template_noop)
"y" = (
/obj/structure/table/wood/bar,
/obj/item/flashlight/lamp/green{
	layer = 3.3
	},
/turf/open/floor/holofloor{
	dir = 9;
	icon_state = "wood"
	},
/area/template_noop)
"A" = (
/obj/effect/turf_decal/siding/wood{
	dir = 4
	},
/turf/open/floor/carpet/royalblue,
/area/template_noop)
"B" = (
/obj/machinery/newscaster{
	pixel_y = 32
	},
/obj/machinery/photocopier,
/obj/effect/turf_decal/bot,
/turf/open/floor/holofloor{
	dir = 9;
	icon_state = "wood"
	},
/area/template_noop)
"C" = (
/obj/effect/turf_decal/siding/wood{
	dir = 1;
	layer = 1
	},
/turf/open/floor/carpet/royalblue,
/area/template_noop)
"D" = (
/obj/effect/turf_decal/siding/wood{
	dir = 10
	},
/turf/open/floor/carpet/blue,
/area/template_noop)
"E" = (
/obj/structure/table/wood/bar,
/obj/effect/turf_decal/siding/wood{
	dir = 4
	},
/turf/open/floor/carpet/royalblue,
/area/template_noop)
"F" = (
/obj/structure/table/wood/bar,
/obj/item/kirbyplants{
	icon_state = "plant-22";
	pixel_y = 13
	},
/turf/open/floor/holofloor{
	dir = 9;
	icon_state = "wood"
	},
/area/template_noop)
"G" = (
/obj/effect/turf_decal/siding/wood/corner,
/turf/open/floor/carpet/blue,
/area/template_noop)
"H" = (
/obj/structure/table/wood/bar,
/obj/effect/turf_decal/siding/wood/corner,
/obj/item/storage/fancy/cigarettes/cigars/cohiba{
	pixel_y = 8
	},
/turf/open/floor/carpet/royalblue,
/area/template_noop)
"I" = (
/obj/structure/chair/fancy/comfy{
	color = "#596479"
	},
/turf/open/floor/carpet/royalblue,
/area/template_noop)
"J" = (
/obj/structure/bookcase/random,
/turf/open/floor/holofloor{
	dir = 9;
	icon_state = "wood"
	},
/area/template_noop)
"K" = (
/obj/effect/turf_decal/siding/wood{
	dir = 6
	},
/turf/open/floor/carpet/royalblue,
/area/template_noop)
"L" = (
/obj/structure/table/wood/bar,
/obj/effect/turf_decal/siding/wood/corner{
	dir = 8
	},
/turf/open/floor/carpet/royalblue,
/area/template_noop)
"N" = (
/obj/effect/turf_decal/siding/wood{
	dir = 4
	},
/turf/open/floor/carpet/blue,
/area/template_noop)
"O" = (
/obj/machinery/bookbinder,
/obj/effect/turf_decal/bot,
/turf/open/floor/holofloor{
	dir = 9;
	icon_state = "wood"
	},
/area/template_noop)
"P" = (
/obj/structure/table/wood/bar,
/obj/effect/holodeck_effect/random_book,
/turf/open/floor/holofloor{
	dir = 9;
	icon_state = "wood"
	},
/area/template_noop)
"Q" = (
/obj/structure/table/wood/bar,
/obj/effect/turf_decal/siding/wood/corner,
/turf/open/floor/carpet/royalblue,
/area/template_noop)
"R" = (
/obj/structure/chair/fancy/comfy{
	buildstackamount = 0;
	color = "#742925";
	dir = 4
	},
/turf/open/floor/carpet/royalblue,
/area/template_noop)
"S" = (
/obj/structure/chair/fancy/comfy{
	buildstackamount = 0;
	color = "#742925";
	dir = 8
	},
/turf/open/floor/carpet/royalblue,
/area/template_noop)
"T" = (
/obj/effect/turf_decal/siding/wood{
	dir = 8
	},
/turf/open/floor/carpet/royalblue,
/area/template_noop)
"U" = (
/obj/effect/turf_decal/siding/wood{
	dir = 9
	},
/turf/open/floor/carpet/royalblue,
/area/template_noop)
"V" = (
/obj/structure/table/wood/bar,
/obj/item/toy/cards/deck{
	pixel_y = 7
	},
/turf/open/floor/holofloor{
	dir = 9;
	icon_state = "wood"
	},
/area/template_noop)
"W" = (
/obj/machinery/status_display/evac{
	pixel_y = 32
	},
/obj/structure/bookcase/random,
/turf/open/floor/holofloor{
	dir = 9;
	icon_state = "wood"
	},
/area/template_noop)
"X" = (
/turf/open/floor/holofloor{
	dir = 9;
	icon_state = "wood"
	},
/area/template_noop)
"Y" = (
/obj/structure/chair/fancy/comfy{
	buildstackamount = 0;
	color = "#742925";
	dir = 8
	},
/obj/effect/turf_decal/siding/wood{
	dir = 4
	},
/turf/open/floor/carpet/royalblue,
/area/template_noop)
"Z" = (
/obj/structure/chair/fancy/comfy{
	buildstackamount = 0;
	color = "#742925";
	dir = 4
	},
/obj/effect/turf_decal/siding/wood{
	dir = 8
	},
/turf/open/floor/carpet/royalblue,
/area/template_noop)

(1,1,1) = {"
P
X
X
X
X
X
X
X
X
P
"}
(2,1,1) = {"
J
X
U
T
Z
Z
Z
Z
k
X
"}
(3,1,1) = {"
W
U
a
R
Q
E
E
E
K
d
"}
(4,1,1) = {"
O
C
p
H
t
r
G
N
j
i
"}
(5,1,1) = {"
B
C
I
b
r
r
o
c
F
y
"}
(6,1,1) = {"
n
C
p
u
l
r
s
h
D
V
"}
(7,1,1) = {"
W
m
f
S
L
g
g
g
k
d
"}
(8,1,1) = {"
J
X
m
A
Y
Y
Y
Y
K
X
"}
(9,1,1) = {"
e
X
X
X
X
X
X
X
X
v
"}
