//MAP CONVERTED BY dmm2tgm.py THIS HEADER COMMENT PREVENTS RECONVERSION, DO NOT REMOVE
"a" = (
/turf/open/floor/holofloor/wood,
/area/template_noop)
"b" = (
/obj/effect/turf_decal/siding/wood,
/turf/open/floor/holofloor/wood,
/area/template_noop)
"c" = (
/obj/structure/chess/checker/whiteman,
/turf/open/floor/holofloor/chess_black,
/area/template_noop)
"d" = (
/turf/open/floor/holofloor/chess_black,
/area/template_noop)
"g" = (
/obj/effect/turf_decal/siding/wood{
	dir = 1
	},
/obj/structure/chess/checker/whiteking,
/obj/structure/chess/checker/whiteking,
/obj/structure/chess/checker/whiteking,
/obj/structure/chess/checker/whiteking,
/obj/structure/chess/checker/whiteking,
/turf/open/floor/holofloor/wood,
/area/template_noop)
"y" = (
/obj/effect/turf_decal/siding/wood{
	dir = 4
	},
/turf/open/floor/holofloor/wood,
/area/template_noop)
"z" = (
/obj/effect/turf_decal/siding/wood,
/obj/structure/chess/checker/blackking,
/obj/structure/chess/checker/blackking,
/obj/structure/chess/checker/blackking,
/obj/structure/chess/checker/blackking,
/obj/structure/chess/checker/blackking,
/turf/open/floor/holofloor/wood,
/area/template_noop)
"J" = (
/turf/open/floor/holofloor/chess_white,
/area/template_noop)
"M" = (
/obj/structure/chess/checker/blackman,
/turf/open/floor/holofloor/chess_black,
/area/template_noop)
"O" = (
/obj/effect/turf_decal/siding/wood{
	dir = 1
	},
/turf/open/floor/holofloor/wood,
/area/template_noop)

(1,1,1) = {"
a
y
y
y
y
y
y
y
y
a
"}
(2,1,1) = {"
b
J
M
J
d
J
c
J
c
O
"}
(3,1,1) = {"
b
M
J
M
J
d
J
c
J
O
"}
(4,1,1) = {"
b
J
M
J
d
J
c
J
c
O
"}
(5,1,1) = {"
b
M
J
M
J
d
J
c
J
O
"}
(6,1,1) = {"
b
J
M
J
d
J
c
J
c
O
"}
(7,1,1) = {"
b
M
J
M
J
d
J
c
J
O
"}
(8,1,1) = {"
b
J
M
J
d
J
c
J
c
O
"}
(9,1,1) = {"
z
M
J
M
J
d
J
c
J
g
"}
