//MAP CONVERTED BY dmm2tgm.py THIS HEADER COMMENT PREVENTS RECONVERSION, DO NOT REMOVE
"h" = (
/obj/effect/turf_decal/delivery,
/obj/effect/decal/cleanable/dirt,
/obj/effect/spawner/random/trash/grille_or_waste,
/turf/open/floor/plating,
/area/misc/space)
"i" = (
/obj/effect/turf_decal/delivery,
/obj/effect/decal/cleanable/dirt,
/turf/open/floor/plating,
/area/misc/space)
"j" = (
/obj/effect/decal/cleanable/dirt,
/obj/effect/turf_decal/stripes/box,
/obj/structure/closet/cardboard,
/obj/effect/mob_spawn/human/engineer,
/turf/open/floor/iron,
/area/misc/space)
"k" = (
/obj/structure/frame/computer{
	anchored = 1;
	dir = 8
	},
/obj/effect/turf_decal/bot,
/obj/effect/decal/cleanable/dirt,
/turf/open/floor/plating,
/area/misc/space)
"q" = (
/obj/effect/decal/cleanable/dirt,
/obj/structure/closet/crate,
/obj/effect/spawner/random/maintenance/two,
/obj/item/toy/crayon/spraycan,
/turf/open/floor/iron,
/area/misc/space)
"r" = (
/obj/structure/frame/computer{
	anchored = 1
	},
/obj/effect/turf_decal/bot,
/obj/effect/decal/cleanable/dirt,
/turf/open/floor/plating,
/area/misc/space)
"s" = (
/obj/effect/decal/cleanable/dirt,
/obj/effect/turf_decal/bot,
/obj/machinery/portable_atmospherics/canister,
/turf/open/floor/iron,
/area/misc/space)
"y" = (
/obj/effect/turf_decal/stripes/corner{
	dir = 10
	},
/obj/effect/decal/cleanable/dirt,
/obj/effect/turf_decal/arrows,
/obj/machinery/holopad{
	pixel_y = 16
	},
/obj/effect/turf_decal/box/corners,
/obj/effect/turf_decal/box/corners{
	dir = 8
	},
/turf/open/floor/plating,
/area/misc/space)
"z" = (
/obj/effect/decal/cleanable/dirt,
/obj/structure/closet,
/obj/effect/turf_decal/delivery,
/obj/item/airlock_painter/decal/tile,
/turf/open/floor/iron,
/area/misc/space)
"A" = (
/obj/effect/decal/cleanable/dirt,
/obj/effect/turf_decal/delivery,
/obj/structure/reagent_dispensers/fueltank,
/turf/open/floor/plating,
/area/misc/space)
"C" = (
/obj/effect/decal/cleanable/dirt,
/obj/structure/rack,
/obj/item/airlock_painter,
/turf/open/floor/iron,
/area/misc/space)
"D" = (
/obj/effect/turf_decal/stripes/line{
	dir = 10
	},
/obj/effect/decal/cleanable/dirt,
/obj/item/airlock_painter/decal,
/obj/item/paper/crumpled{
	default_raw_text = "THE LINE TWISTERS RIGHT, THEN IT HAS A STRIPPED SQUARE UNDER THE VENDING MACHINE BUT NO IT NOW HAS AN EMPTY SQUARE?! <br>BUT WHAT OF HOLOPADS?I HATE IT! I HATE IT! I HATE IT! <br>I KNOW THEY'RE AFTER ME! THEY WANT MY SOUL! THE STRIPES TURN RIGHT, THE LINES AREE EVERYWHERE, THEY SEE EVERYTHING, I WANT OUT, I WANT OUT OF THIS! THEY CAN NOT FIND ME, NOT HERE, NO NOT IN MY HIDEY BOX! </p>";
	name = "YELLOW STRIPES"
	},
/turf/open/floor/plating,
/area/misc/space)
"F" = (
/obj/effect/turf_decal/stripes/corner,
/obj/effect/decal/cleanable/dirt,
/obj/effect/turf_decal/arrows{
	dir = 4
	},
/obj/effect/turf_decal/loading_area{
	dir = 1
	},
/obj/effect/turf_decal/stripes/corner{
	dir = 4
	},
/obj/item/airlock_painter/decal,
/turf/open/floor/plating,
/area/misc/space)
"K" = (
/obj/effect/decal/cleanable/dirt,
/obj/machinery/light/small/directional/south,
/obj/machinery/flasher/portable,
/obj/effect/turf_decal/bot,
/obj/structure/grille/broken,
/turf/open/floor/iron,
/area/misc/space)
"N" = (
/obj/effect/turf_decal/stripes/corner{
	dir = 9
	},
/obj/effect/decal/cleanable/dirt,
/obj/effect/turf_decal/arrows{
	dir = 1
	},
/obj/effect/turf_decal/box/corners{
	dir = 1
	},
/obj/effect/turf_decal/box/corners{
	dir = 4
	},
/obj/item/trash/can,
/turf/open/floor/plating,
/area/misc/space)
"O" = (
/obj/effect/turf_decal/stripes/line{
	dir = 1
	},
/obj/effect/turf_decal/stripes/corner{
	dir = 8
	},
/obj/effect/turf_decal/stripes/corner{
	dir = 8
	},
/obj/effect/decal/cleanable/dirt,
/obj/effect/turf_decal/arrows{
	dir = 8
	},
/turf/open/floor/plating,
/area/misc/space)
"W" = (
/obj/effect/decal/cleanable/dirt,
/obj/effect/turf_decal/loading_area,
/obj/effect/turf_decal/stripes/line{
	dir = 4
	},
/obj/effect/turf_decal/stripes/corner{
	dir = 8
	},
/turf/open/floor/plating,
/area/misc/space)
"Z" = (
/obj/effect/decal/cleanable/dirt,
/obj/structure/girder,
/obj/structure/grille/broken,
/turf/open/floor/plating,
/area/misc/space)

(1,1,1) = {"
Z
h
j
q
"}
(2,1,1) = {"
r
O
D
z
"}
(3,1,1) = {"
i
N
y
h
"}
(4,1,1) = {"
s
F
W
K
"}
(5,1,1) = {"
A
i
k
C
"}
