//MAP CONVERTED BY dmm2tgm.py THIS HEADER COMMENT PREVENTS RECONVERSION, DO NOT REMOVE
"c" = (
/obj/effect/turf_decal/box,
/obj/machinery/power/solar{
	id = "forestarboard";
	name = "Fore-Starboard Solar Array"
	},
/obj/structure/cable{
	icon_state = "4-8"
	},
/obj/structure/cable{
	icon_state = "0-4"
	},
/turf/open/floor/iron/solarpanel/airless,
/area/misc/space)
"g" = (
/obj/structure/window/reinforced/spawner/directional/south,
/obj/effect/turf_decal/stripes/line{
	dir = 1
	},
/turf/open/floor/plating{
	broken = 1
	},
/area/template_noop)
"k" = (
/obj/structure/window/reinforced/spawner/directional/west,
/obj/effect/turf_decal/stripes/line{
	dir = 4
	},
/turf/open/floor/plating,
/area/template_noop)
"l" = (
/obj/structure/window/reinforced/spawner/directional/west,
/obj/effect/turf_decal/stripes/line{
	dir = 4
	},
/obj/machinery/light/small/directional/east,
/obj/effect/decal/cleanable/dirt,
/turf/open/floor/plating{
	broken = 1
	},
/area/template_noop)
"m" = (
/obj/structure/window/reinforced/spawner/directional/south,
/obj/effect/turf_decal/stripes/line{
	dir = 1
	},
/turf/open/floor/plating,
/area/template_noop)
"n" = (
/obj/effect/turf_decal/box,
/obj/machinery/power/solar{
	id = "forestarboard";
	name = "Fore-Starboard Solar Array"
	},
/obj/structure/cable{
	icon_state = "0-4"
	},
/turf/open/floor/iron/solarpanel/airless,
/area/misc/space)
"p" = (
/obj/effect/turf_decal/box,
/obj/machinery/power/solar{
	id = "forestarboard";
	name = "Fore-Starboard Solar Array"
	},
/obj/structure/cable{
	icon_state = "2-8"
	},
/obj/structure/cable{
	icon_state = "0-2"
	},
/turf/open/floor/iron/solarpanel/airless,
/area/misc/space)
"q" = (
/obj/effect/turf_decal/stripes/line{
	dir = 9
	},
/obj/effect/decal/cleanable/dirt,
/turf/open/floor/plating{
	broken = 1
	},
/area/template_noop)
"s" = (
/obj/structure/cable{
	icon_state = "1-4"
	},
/obj/effect/turf_decal/stripes/line,
/turf/open/floor/plating,
/area/template_noop)
"v" = (
/obj/machinery/power/solar_control{
	dir = 8;
	id = "forestarboard";
	name = "Starboard Bow Solar Control"
	},
/obj/structure/window/reinforced/spawner/directional/east,
/obj/structure/window/reinforced/spawner/directional/north,
/obj/structure/cable{
	icon_state = "0-2"
	},
/obj/structure/cable{
	icon_state = "2-8"
	},
/obj/effect/turf_decal/bot,
/turf/open/floor/plating{
	burnt = 1
	},
/area/template_noop)
"w" = (
/obj/structure/cable{
	icon_state = "0-4"
	},
/obj/effect/turf_decal/stripes/line{
	dir = 8
	},
/turf/open/floor/plating,
/area/template_noop)
"z" = (
/obj/structure/lattice/catwalk,
/obj/structure/cable{
	icon_state = "1-8"
	},
/turf/open/space/basic,
/area/misc/space)
"C" = (
/obj/effect/turf_decal/stripes/line{
	dir = 10
	},
/obj/effect/decal/cleanable/dirt,
/obj/structure/sign/warning/electric_shock{
	pixel_x = -32
	},
/turf/open/floor/plating,
/area/template_noop)
"F" = (
/obj/effect/turf_decal/stripes/line{
	dir = 5
	},
/obj/structure/sign/warning/vacuum/external{
	pixel_x = 32
	},
/turf/open/floor/plating,
/area/template_noop)
"G" = (
/obj/structure/window/reinforced/spawner/directional/south,
/obj/effect/turf_decal/stripes/line{
	dir = 1
	},
/obj/effect/decal/cleanable/dirt,
/turf/open/floor/plating,
/area/template_noop)
"H" = (
/obj/structure/window/reinforced/spawner/directional/east,
/obj/effect/turf_decal/stripes/line{
	dir = 8
	},
/obj/machinery/light/small/directional/west,
/turf/open/floor/plating,
/area/template_noop)
"M" = (
/obj/structure/window/reinforced/spawner/directional/north,
/obj/effect/turf_decal/stripes/line,
/turf/open/floor/plating{
	broken = 1
	},
/area/template_noop)
"Q" = (
/obj/effect/turf_decal/stripes/line{
	dir = 6
	},
/turf/open/floor/plating,
/area/template_noop)
"V" = (
/obj/machinery/door/window/westleft{
	dir = 1
	},
/obj/structure/cable{
	icon_state = "1-8"
	},
/obj/effect/turf_decal/stripes/line,
/obj/effect/turf_decal/stripes/line{
	dir = 1;
	pixel_y = -3
	},
/obj/effect/decal/cleanable/dirt,
/turf/open/floor/plating,
/area/template_noop)
"X" = (
/obj/structure/lattice/catwalk,
/obj/structure/cable{
	icon_state = "2-4"
	},
/turf/open/space/basic,
/area/misc/space)

(1,1,1) = {"
q
H
w
C
"}
(2,1,1) = {"
m
n
v
s
"}
(3,1,1) = {"
g
c
X
V
"}
(4,1,1) = {"
G
p
z
M
"}
(5,1,1) = {"
F
k
l
Q
"}
