//MAP CONVERTED BY dmm2tgm.py THIS HEADER COMMENT PREVENTS RECONVERSION, DO NOT REMOVE
"a" = (
/obj/effect/turf_decal/stripes/line{
	dir = 6
	},
/obj/item/stack/rods/ten,
/obj/item/stock_parts/capacitor,
/obj/item/circuitboard/machine/stasis,
/obj/item/stock_parts/manipulator,
/turf/open/floor/iron,
/area/template_noop)
"b" = (
/obj/structure/closet/secure_closet/medical2,
/obj/effect/decal/cleanable/dirt,
/obj/structure/cable/white,
/turf/open/floor/plating,
/area/template_noop)
"e" = (
/obj/item/kirbyplants/random,
/obj/effect/decal/cleanable/dirt,
/turf/open/floor/plating,
/area/template_noop)
"g" = (
/obj/item/wrench,
/obj/effect/decal/cleanable/blood/old,
/turf/open/floor/plating,
/area/template_noop)
"j" = (
/obj/machinery/iv_drip,
/obj/effect/decal/cleanable/dirt,
/turf/open/floor/plating,
/area/template_noop)
"m" = (
/obj/structure/chair{
	dir = 8
	},
/obj/machinery/vending/wallmed{
	name = "Emergency NanoMed";
	pixel_x = 26;
	use_power = 0;
	dir = 4
	},
/obj/effect/turf_decal/tile/blue,
/turf/open/floor/iron/white,
/area/template_noop)
"o" = (
/obj/structure/table/reinforced,
/obj/machinery/newscaster{
	pixel_y = -32
	},
/obj/item/hemostat,
/obj/effect/decal/cleanable/dirt,
/obj/effect/decal/cleanable/dirt,
/turf/open/floor/plating,
/area/template_noop)
"r" = (
/obj/structure/chair{
	dir = 8
	},
/obj/effect/decal/cleanable/dirt,
/obj/effect/turf_decal/tile/blue,
/turf/open/floor/iron/white,
/area/template_noop)
"s" = (
/obj/effect/trap/nexus/trickyspawner/catbutcher,
/turf/open/floor/iron,
/area/template_noop)
"t" = (
/obj/effect/decal/cleanable/dirt,
/obj/effect/spawner/random/unsorted/trap,
/turf/open/floor/plating,
/area/template_noop)
"u" = (
/obj/effect/decal/cleanable/dirt,
/obj/effect/decal/cleanable/dirt,
/obj/effect/spawner/random/unsorted/trap,
/obj/effect/turf_decal/tile/blue/fourcorners/contrasted,
/turf/open/floor/iron,
/area/template_noop)
"x" = (
/obj/effect/decal/cleanable/dirt,
/obj/effect/spawner/random/unsorted/trap,
/obj/effect/turf_decal/tile/blue{
	dir = 4
	},
/turf/open/floor/iron/white,
/area/template_noop)
"y" = (
/obj/structure/table/reinforced,
/obj/machinery/status_display/evac{
	pixel_y = -32
	},
/obj/item/storage/firstaid/regular,
/obj/item/clothing/gloves/color/latex,
/obj/item/clothing/suit/apron/surgical,
/obj/item/clothing/mask/surgical,
/obj/effect/turf_decal/tile/neutral/fourcorners/contrasted,
/turf/open/floor/iron/dark,
/area/template_noop)
"A" = (
/obj/item/crowbar/red,
/obj/effect/decal/cleanable/dirt,
/obj/effect/turf_decal/tile/blue/fourcorners/contrasted,
/turf/open/floor/iron,
/area/template_noop)
"G" = (
/obj/effect/turf_decal/tile/neutral/fourcorners/contrasted,
/turf/open/floor/iron,
/area/template_noop)
"K" = (
/obj/structure/table/optable,
/obj/effect/decal/cleanable/blood/old,
/obj/effect/decal/cleanable/dirt,
/obj/item/surgical_drapes,
/obj/effect/turf_decal/tile/blue/fourcorners/contrasted,
/turf/open/floor/iron,
/area/template_noop)
"O" = (
/obj/structure/table/reinforced,
/obj/machinery/light/small,
/obj/structure/bedsheetbin,
/obj/item/gun/syringe,
/obj/effect/decal/cleanable/dirt,
/obj/effect/turf_decal/tile/neutral/fourcorners/contrasted,
/turf/open/floor/iron/dark,
/area/template_noop)
"Q" = (
/obj/effect/spawner/random/unsorted/trap,
/obj/effect/turf_decal/tile/neutral/fourcorners/contrasted,
/turf/open/floor/iron,
/area/template_noop)
"T" = (
/obj/structure/frame/computer,
/obj/item/circuitboard/computer/operating,
/obj/effect/turf_decal/tile/neutral/fourcorners/contrasted,
/turf/open/floor/iron,
/area/template_noop)
"U" = (
/obj/effect/decal/cleanable/dirt,
/obj/effect/decal/cleanable/dirt,
/obj/effect/turf_decal/tile/blue/fourcorners/contrasted,
/turf/open/floor/iron,
/area/template_noop)

(1,1,1) = {"
a
u
j
y
"}
(2,1,1) = {"
b
K
U
o
"}
(3,1,1) = {"
Q
T
s
t
"}
(4,1,1) = {"
A
G
g
O
"}
(5,1,1) = {"
e
x
m
r
"}
