//MAP CONVERTED BY dmm2tgm.py THIS HEADER COMMENT PREVENTS RECONVERSION, DO NOT REMOVE
"a" = (
/obj/structure/table{
	dir = 1
	},
/obj/effect/decal/cleanable/dirt/dust{
	dir = 4
	},
/obj/item/paper_bin{
	pixel_y = -3;
	dir = 1
	},
/obj/item/pen{
	pixel_y = -4;
	dir = 1
	},
/turf/open/floor/plating,
/area/template_noop)
"b" = (
/obj/effect/decal/cleanable/dirt/dust{
	dir = 4
	},
/turf/open/floor/plating,
/area/template_noop)
"c" = (
/obj/effect/decal/cleanable/dirt/dust{
	dir = 4
	},
/obj/structure/closet{
	dir = 1
	},
/obj/item/nanite_remote{
	dir = 1
	},
/obj/item/nanite_scanner{
	dir = 1
	},
/turf/open/floor/plating,
/area/template_noop)
"d" = (
/obj/machinery/nanite_chamber{
	dir = 1
	},
/obj/effect/turf_decal/delivery{
	dir = 4
	},
/obj/effect/decal/cleanable/dirt/dust{
	dir = 4
	},
/turf/open/floor/plasteel/dark,
/area/template_noop)
"e" = (
/obj/effect/turf_decal/stripes/corner{
	dir = 4
	},
/obj/effect/turf_decal/stripes/corner{
	dir = 1
	},
/obj/effect/decal/cleanable/dirt/dust{
	dir = 4
	},
/obj/effect/decal/cleanable/blood/old{
	dir = 4
	},
/turf/open/floor/plasteel/dark,
/area/template_noop)
"f" = (
/obj/effect/turf_decal/bot{
	dir = 4
	},
/obj/effect/decal/cleanable/dirt/dust{
	dir = 4
	},
/obj/machinery/light/built{
	icon_state = "tube-empty";
	dir = 8
	},
/obj/structure/frame/machine{
	dir = 1
	},
/turf/open/floor/plasteel/dark,
/area/template_noop)
"g" = (
/obj/effect/turf_decal/stripes/line{
	dir = 8
	},
/obj/effect/turf_decal/stripes/line{
	dir = 4
	},
/obj/effect/decal/cleanable/dirt/dust{
	dir = 4
	},
/turf/open/floor/plasteel/dark,
/area/template_noop)
"h" = (
/obj/machinery/computer/nanite_chamber_control{
	dir = 1
	},
/obj/effect/turf_decal/bot{
	dir = 4
	},
/obj/effect/decal/cleanable/dirt/dust{
	dir = 4
	},
/turf/open/floor/plasteel/dark,
/area/template_noop)
"i" = (
/obj/structure/table{
	dir = 1
	},
/obj/effect/decal/cleanable/dirt/dust{
	dir = 4
	},
/obj/item/storage/box/disks_nanite{
	pixel_y = -5;
	dir = 1
	},
/obj/machinery/light/broken{
	icon_state = "tube-broken";
	dir = 4
	},
/turf/open/floor/plating,
/area/template_noop)
"j" = (
/obj/machinery/nanite_program_hub{
	dir = 1
	},
/obj/effect/turf_decal/bot{
	dir = 4
	},
/obj/effect/decal/cleanable/dirt/dust{
	dir = 4
	},
/turf/open/floor/plasteel/dark,
/area/template_noop)
"k" = (
/obj/effect/turf_decal/stripes/line{
	dir = 8
	},
/obj/effect/turf_decal/stripes/corner{
	dir = 2
	},
/obj/effect/decal/cleanable/dirt/dust{
	dir = 4
	},
/turf/open/floor/plasteel/dark,
/area/template_noop)
"l" = (
/obj/effect/turf_decal/stripes/line{
	dir = 2
	},
/obj/effect/decal/cleanable/dirt/dust{
	dir = 4
	},
/turf/open/floor/plasteel/dark,
/area/template_noop)
"m" = (
/obj/machinery/nanite_programmer{
	dir = 1
	},
/obj/effect/turf_decal/bot{
	dir = 4
	},
/obj/effect/decal/cleanable/dirt/dust{
	dir = 4
	},
/turf/open/floor/plasteel/dark,
/area/template_noop)

(1,1,1) = {"
j
f
b
a"}(2,1,1) = {"
k
g
b
b"}(3,1,1) = {"
l
h
d
b"}(4,1,1) = {"
b
b
e
b"}(5,1,1) = {"
m
i
b
c"}