//MAP CONVERTED BY dmm2tgm.py THIS HEADER COMMENT PREVENTS RECONVERSION, DO NOT REMOVE
"a" = (
/obj/machinery/light/small{
	dir = 8
	},
/obj/machinery/photocopier{
	dir = 1
	},
/obj/effect/turf_decal/tile/neutral{
	dir = 4
	},
/obj/effect/turf_decal/tile/neutral{
	dir = 8
	},
/obj/effect/turf_decal/bot_white{
	dir = 4
	},
/obj/effect/decal/cleanable/dirt{
	dir = 4
	},
/obj/effect/decal/cleanable/cobweb{
	dir = 4
	},
/obj/structure/sign/poster/contraband/random{
	pixel_x = -32;
	dir = 1
	},
/turf/open/floor/plasteel/dark,
/area/template_noop)
"b" = (
/obj/effect/turf_decal/tile/neutral{
	dir = 4
	},
/obj/effect/turf_decal/tile/neutral{
	dir = 8
	},
/obj/effect/decal/cleanable/dirt{
	dir = 4
	},
/obj/effect/decal/cleanable/blood/old{
	dir = 4
	},
/turf/open/floor/plasteel/dark,
/area/template_noop)
"c" = (
/obj/structure/chair/sofa/right{
	color = "#c45c57";
	dir = 1
	},
/turf/open/floor/wood{
	icon_state = "wood-broken"
	},
/area/template_noop)
"d" = (
/obj/machinery/light/small{
	dir = 2
	},
/obj/structure/chair/sofa{
	color = "#c45c57";
	dir = 1
	},
/obj/structure/sign/poster/contraband/random{
	pixel_y = -32;
	dir = 1
	},
/turf/open/floor/wood,
/area/template_noop)
"e" = (
/obj/structure/chair/sofa/corner{
	color = "#c45c57";
	dir = 1;
	icon_state = "sofacorner"
	},
/obj/effect/decal/cleanable/cobweb/cobweb2{
	dir = 4
	},
/turf/open/floor/wood{
	icon_state = "wood-broken5"
	},
/area/template_noop)
"f" = (
/obj/effect/turf_decal/tile/neutral{
	dir = 4
	},
/obj/effect/turf_decal/tile/neutral{
	dir = 8
	},
/obj/effect/decal/cleanable/dirt{
	dir = 4
	},
/mob/living/simple_animal/hostile/retaliate/ghost,
/turf/open/floor/plasteel/dark,
/area/template_noop)
"g" = (
/obj/effect/turf_decal/tile/neutral{
	dir = 4
	},
/obj/effect/turf_decal/tile/neutral{
	dir = 8
	},
/obj/effect/decal/cleanable/dirt{
	dir = 4
	},
/turf/open/floor/plasteel/dark,
/area/template_noop)
"h" = (
/obj/structure/table/wood{
	dir = 1
	},
/obj/item/clipboard{
	dir = 1
	},
/obj/item/camera{
	dir = 1
	},
/turf/open/floor/wood,
/area/template_noop)
"i" = (
/obj/structure/table/wood{
	dir = 1
	},
/obj/item/folder{
	pixel_x = 4;
	pixel_y = -4;
	dir = 1
	},
/obj/item/storage/pill_bottle/dice{
	pixel_x = -4;
	dir = 1
	},
/obj/item/pen/red{
	pixel_x = 4;
	pixel_y = -4;
	dir = 1
	},
/turf/open/floor/wood{
	icon_state = "wood-broken7"
	},
/area/template_noop)
"j" = (
/obj/structure/chair/sofa/left{
	color = "#c45c57";
	dir = 8;
	icon_state = "sofaend_left"
	},
/obj/effect/decal/cleanable/blood/old{
	dir = 4
	},
/turf/open/floor/wood{
	icon_state = "wood-broken7"
	},
/area/template_noop)
"k" = (
/obj/structure/table/wood{
	dir = 1
	},
/obj/machinery/computer/libraryconsole/bookmanagement{
	pixel_y = -5;
	dir = 1
	},
/obj/effect/turf_decal/tile/neutral{
	dir = 4
	},
/obj/effect/turf_decal/tile/neutral{
	dir = 8
	},
/obj/effect/decal/cleanable/dirt{
	dir = 4
	},
/obj/effect/decal/cleanable/cobweb{
	dir = 4
	},
/obj/structure/noticeboard{
	dir = 4;
	pixel_x = -27
	},
/turf/open/floor/plasteel/dark,
/area/template_noop)
"l" = (
/obj/effect/turf_decal/tile/neutral{
	dir = 4
	},
/obj/effect/turf_decal/tile/neutral{
	dir = 8
	},
/obj/effect/decal/cleanable/dirt{
	dir = 4
	},
/obj/effect/decal/cleanable/blood/gibs/old{
	dir = 4
	},
/obj/effect/trap/trigger{
	dir = 1
	},
/turf/open/floor/plasteel/dark,
/area/template_noop)
"m" = (
/obj/effect/decal/cleanable/blood/old{
	dir = 4
	},
/obj/structure/sign/plaques/kiddie/library{
	pixel_x = 32;
	pixel_y = 32;
	dir = 1
	},
/turf/open/floor/wood,
/area/template_noop)
"n" = (
/turf/open/floor/wood{
	icon_state = "wood-broken6"
	},
/area/template_noop)
"o" = (
/obj/structure/bookcase/random/fiction{
	dir = 1
	},
/obj/effect/decal/cleanable/cobweb{
	dir = 4
	},
/turf/open/floor/plasteel/dark,
/area/template_noop)
"p" = (
/obj/structure/bookcase/random/fiction{
	dir = 1
	},
/turf/open/floor/plasteel/dark,
/area/template_noop)
"q" = (
/obj/item/kirbyplants{
	icon_state = "plant-05";
	dir = 1
	},
/obj/effect/turf_decal/tile/neutral{
	dir = 4
	},
/obj/effect/turf_decal/tile/neutral{
	dir = 8
	},
/obj/effect/decal/cleanable/dirt{
	dir = 4
	},
/turf/open/floor/plasteel/dark,
/area/template_noop)
"r" = (
/obj/structure/bookcase/random/reference{
	dir = 1
	},
/obj/effect/decal/cleanable/cobweb/cobweb2{
	dir = 4
	},
/turf/open/floor/plasteel/dark,
/area/template_noop)
"s" = (
/obj/structure/table/wood{
	dir = 1
	},
/obj/machinery/newscaster{
	pixel_x = 30;
	dir = 1
	},
/obj/effect/turf_decal/stripes/corner{
	dir = 1
	},
/obj/item/paper_bin{
	pixel_x = 4;
	pixel_y = -4;
	dir = 1
	},
/obj/item/pen{
	dir = 1
	},
/turf/open/floor/wood,
/area/template_noop)
"t" = (
/obj/effect/trap/nexus/darkness{
	dir = 1
	},
/turf/open/floor/wood{
	icon_state = "wood-broken3"
	},
/area/template_noop)

(1,1,1) = {"
o
k
f
a"}(2,1,1) = {"
p
g
l
b"}(3,1,1) = {"
q
t
h
c"}(4,1,1) = {"
r
m
i
d"}(5,1,1) = {"
s
n
j
e"}