//MAP CONVERTED BY dmm2tgm.py THIS HEADER COMMENT PREVENTS RECONVERSION, DO NOT REMOVE
"a" = (
/obj/effect/decal/cleanable/dirt,
/obj/machinery/chem_dispenser/drinks/beer,
/obj/structure/table/wood/poker,
/obj/structure/sign/poster/contraband/random{
	pixel_y = 32
	},
/obj/machinery/light/small{
	icon_state = "bulb";
	dir = 1
	},
/turf/open/floor/plating,
/area/template_noop)
"b" = (
/obj/structure/table/wood/poker,
/obj/item/reagent_containers/cup/glass/bottle/rum{
	pixel_x = 6;
	pixel_y = 3
	},
/obj/item/reagent_containers/cup/glass/bottle/whiskey{
	pixel_y = 7
	},
/obj/effect/decal/cleanable/dirt,
/turf/open/floor/wood,
/area/template_noop)
"c" = (
/obj/effect/decal/cleanable/dirt,
/turf/open/floor/wood,
/area/template_noop)
"d" = (
/obj/effect/decal/cleanable/dirt,
/obj/machinery/vending/boozeomat/all_access,
/obj/machinery/light/small{
	icon_state = "bulb";
	dir = 1
	},
/turf/open/floor/plating,
/area/template_noop)
"e" = (
/obj/structure/table/wood/poker,
/obj/item/reagent_containers/cup/glass/shaker,
/obj/item/reagent_containers/cup/beaker/cryoxadone,
/obj/item/reagent_containers/dropper,
/turf/open/floor/plating,
/area/template_noop)
"f" = (
/obj/effect/decal/cleanable/dirt,
/turf/open/floor/plating,
/area/template_noop)
"g" = (
/obj/effect/decal/cleanable/dirt,
/obj/effect/decal/cleanable/vomit/old,
/turf/open/floor/wood{
	broken = 1
	},
/area/template_noop)
"h" = (
/turf/open/floor/plating,
/area/template_noop)
"i" = (
/obj/structure/table/wood/poker,
/obj/item/flashlight/lamp,
/turf/open/floor/plating,
/area/template_noop)
"j" = (
/obj/structure/table/wood/poker,
/obj/effect/spawner/random/maintenance,
/turf/open/floor/wood{
	broken = 1
	},
/area/template_noop)
"k" = (
/obj/structure/table/wood/poker,
/obj/item/storage/box/matches{
	pixel_x = -3;
	pixel_y = 5
	},
/turf/open/floor/wood,
/area/template_noop)
"l" = (
/obj/structure/table/wood/poker,
/obj/effect/decal/cleanable/dirt,
/obj/effect/spawner/random/maintenance,
/turf/open/floor/wood,
/area/template_noop)
"m" = (
/obj/structure/chair/stool/bar,
/turf/open/floor/wood,
/area/template_noop)
"n" = (
/obj/structure/chair/stool/bar,
/turf/open/floor/wood{
	broken = 1
	},
/area/template_noop)
"o" = (
/obj/structure/chair/stool/bar,
/obj/effect/decal/cleanable/vomit/old,
/turf/open/floor/wood,
/area/template_noop)

(1,1,1) = {"
a
f
c
c
"}
(2,1,1) = {"
b
g
i
m
"}
(3,1,1) = {"
c
h
j
m
"}
(4,1,1) = {"
d
c
k
o
"}
(5,1,1) = {"
e
f
l
n
"}
