//MAP CONVERTED BY dmm2tgm.py THIS HEADER COMMENT PREVENTS RECONVERSION, DO NOT REMOVE
"c" = (
/obj/structure/chair/fancy/sofa/old/right{
	color = "#c45c57";
	dir = 2
	},
/turf/open/floor/wood{
	broken = 1
	},
/area/template_noop)
"d" = (
/obj/machinery/light/small{
	dir = 1
	},
/obj/structure/chair/fancy/sofa/old{
	color = "#c45c57"
	},
/obj/structure/sign/poster/contraband/random{
	pixel_y = 32
	},
/turf/open/floor/wood,
/area/template_noop)
"e" = (
/obj/structure/chair/fancy/sofa/old/corner/concave{
	color = "#c45c57";
	dir = 2;
	icon_state = "sofacorner"
	},
/obj/effect/decal/cleanable/cobweb/cobweb2,
/turf/open/floor/wood{
	broken = 1
	},
/area/template_noop)
"h" = (
/obj/structure/table/wood,
/obj/item/clipboard,
/obj/item/camera,
/turf/open/floor/wood,
/area/template_noop)
"i" = (
/obj/structure/table/wood,
/obj/item/folder{
	pixel_x = 4;
	pixel_y = 4
	},
/obj/item/storage/pill_bottle/dice{
	pixel_x = -4
	},
/obj/item/pen/red{
	pixel_x = 4;
	pixel_y = 4
	},
/turf/open/floor/wood{
	broken = 1
	},
/area/template_noop)
"j" = (
/obj/structure/chair/fancy/sofa/old/left{
	color = "#c45c57";
	dir = 8;
	icon_state = "sofaend_left"
	},
/obj/effect/decal/cleanable/blood/old,
/turf/open/floor/wood{
	broken = 1
	},
/area/template_noop)
"m" = (
/obj/effect/decal/cleanable/blood/old,
/obj/structure/sign/plaques/kiddie/library{
	pixel_x = 32;
	pixel_y = -32
	},
/turf/open/floor/wood,
/area/template_noop)
"n" = (
/turf/open/floor/wood{
	broken = 1
	},
/area/template_noop)
"o" = (
/obj/structure/bookcase/random/fiction,
/obj/effect/decal/cleanable/cobweb,
/turf/open/floor/iron/dark,
/area/template_noop)
"p" = (
/obj/structure/bookcase/random/fiction,
/turf/open/floor/iron/dark,
/area/template_noop)
"r" = (
/obj/structure/bookcase/random/reference,
/obj/effect/decal/cleanable/cobweb/cobweb2,
/turf/open/floor/iron/dark,
/area/template_noop)
"s" = (
/obj/structure/table/wood,
/obj/machinery/newscaster{
	pixel_x = 30
	},
/obj/effect/turf_decal/stripes/corner{
	dir = 8
	},
/obj/item/paper_bin{
	pixel_x = 4;
	pixel_y = 4
	},
/obj/item/pen,
/turf/open/floor/wood,
/area/template_noop)
"t" = (
/obj/effect/trap/nexus/darkness,
/turf/open/floor/wood{
	broken = 1
	},
/area/template_noop)
"v" = (
/obj/effect/decal/cleanable/dirt,
/obj/effect/decal/cleanable/blood/gibs/old,
/obj/effect/trap/trigger,
/obj/effect/turf_decal/tile/neutral/opposingcorners,
/turf/open/floor/iron/dark,
/area/template_noop)
"D" = (
/obj/effect/decal/cleanable/dirt,
/obj/effect/turf_decal/tile/neutral/opposingcorners,
/turf/open/floor/iron/dark,
/area/template_noop)
"I" = (
/obj/effect/decal/cleanable/dirt,
/obj/effect/decal/cleanable/blood/old,
/obj/effect/turf_decal/tile/neutral/opposingcorners,
/turf/open/floor/iron/dark,
/area/template_noop)
"N" = (
/obj/item/kirbyplants{
	icon_state = "plant-05"
	},
/obj/effect/decal/cleanable/dirt,
/obj/effect/turf_decal/tile/neutral/opposingcorners,
/turf/open/floor/iron/dark,
/area/template_noop)
"Q" = (
/obj/machinery/light/small{
	dir = 8
	},
/obj/machinery/photocopier,
/obj/effect/turf_decal/bot_white,
/obj/effect/decal/cleanable/dirt,
/obj/effect/decal/cleanable/cobweb,
/obj/structure/sign/poster/contraband/random{
	pixel_x = -32
	},
/obj/effect/turf_decal/tile/neutral/opposingcorners,
/turf/open/floor/iron/dark,
/area/template_noop)
"R" = (
/obj/structure/table/wood,
/obj/machinery/computer/libraryconsole/bookmanagement{
	pixel_y = 5
	},
/obj/effect/decal/cleanable/dirt,
/obj/effect/decal/cleanable/cobweb,
/obj/structure/noticeboard{
	dir = 4;
	pixel_x = -27
	},
/obj/effect/turf_decal/tile/neutral/opposingcorners,
/turf/open/floor/iron/dark,
/area/template_noop)
"X" = (
/obj/effect/decal/cleanable/dirt,
/mob/living/simple_animal/hostile/retaliate/ghost,
/obj/effect/turf_decal/tile/neutral/opposingcorners,
/turf/open/floor/iron/dark,
/area/template_noop)

(1,1,1) = {"
Q
X
R
o
"}
(2,1,1) = {"
I
v
D
p
"}
(3,1,1) = {"
c
h
t
N
"}
(4,1,1) = {"
d
i
m
r
"}
(5,1,1) = {"
e
j
n
s
"}
