//MAP CONVERTED BY dmm2tgm.py THIS HEADER COMMENT PREVENTS RECONVERSION, DO NOT REMOVE
"a" = (
/obj/machinery/light/small{
	dir = 8
	},
/obj/machinery/photocopier,
/obj/effect/turf_decal/tile/neutral,
/obj/effect/turf_decal/tile/neutral{
	dir = 1
	},
/obj/effect/turf_decal/bot_white,
/obj/effect/decal/cleanable/dirt,
/obj/effect/decal/cleanable/cobweb,
/obj/structure/sign/poster/contraband/random{
	pixel_x = -32
	},
/turf/open/floor/plasteel/dark,
/area/template_noop)
"b" = (
/obj/effect/turf_decal/tile/neutral,
/obj/effect/turf_decal/tile/neutral{
	dir = 1
	},
/obj/effect/decal/cleanable/dirt,
/obj/effect/decal/cleanable/blood/old,
/turf/open/floor/plasteel/dark,
/area/template_noop)
"c" = (
/obj/structure/chair/sofa/right{
	color = "#c45c57";
	dir = 2
	},
/turf/open/floor/wood{
	icon_state = "wood-broken"
	},
/area/template_noop)
"d" = (
/obj/machinery/light/small{
	dir = 1
	},
/obj/structure/chair/sofa{
	color = "#c45c57"
	},
/obj/structure/sign/poster/contraband/random{
	pixel_y = 32
	},
/turf/open/floor/wood,
/area/template_noop)
"e" = (
/obj/structure/chair/sofa/corner{
	color = "#c45c57";
	dir = 2;
	icon_state = "sofacorner"
	},
/obj/effect/decal/cleanable/cobweb/cobweb2,
/turf/open/floor/wood{
	icon_state = "wood-broken5"
	},
/area/template_noop)
"f" = (
/obj/effect/turf_decal/tile/neutral,
/obj/effect/turf_decal/tile/neutral{
	dir = 1
	},
/obj/effect/decal/cleanable/dirt,
/mob/living/simple_animal/hostile/retaliate/ghost,
/turf/open/floor/plasteel/dark,
/area/template_noop)
"g" = (
/obj/effect/turf_decal/tile/neutral,
/obj/effect/turf_decal/tile/neutral{
	dir = 1
	},
/obj/effect/decal/cleanable/dirt,
/turf/open/floor/plasteel/dark,
/area/template_noop)
"h" = (
/obj/structure/table/wood,
/obj/item/clipboard,
/obj/item/camera,
/turf/open/floor/wood,
/area/template_noop)
"i" = (
/obj/structure/table/wood,
/obj/item/folder{
	pixel_x = 4;
	pixel_y = 4
	},
/obj/item/storage/pill_bottle/dice{
	pixel_x = -4
	},
/obj/item/pen/red{
	pixel_x = 4;
	pixel_y = 4
	},
/turf/open/floor/wood{
	icon_state = "wood-broken7"
	},
/area/template_noop)
"j" = (
/obj/structure/chair/sofa/left{
	color = "#c45c57";
	dir = 8;
	icon_state = "sofaend_left"
	},
/obj/effect/decal/cleanable/blood/old,
/turf/open/floor/wood{
	icon_state = "wood-broken7"
	},
/area/template_noop)
"k" = (
/obj/structure/table/wood,
/obj/machinery/computer/libraryconsole/bookmanagement{
	pixel_y = 5
	},
/obj/effect/turf_decal/tile/neutral,
/obj/effect/turf_decal/tile/neutral{
	dir = 1
	},
/obj/effect/decal/cleanable/dirt,
/obj/effect/decal/cleanable/cobweb,
/obj/structure/noticeboard{
	dir = 4;
	pixel_x = -27
	},
/turf/open/floor/plasteel/dark,
/area/template_noop)
"l" = (
/turf/open/floor/wood{
	icon_state = "wood-broken3"
	},
/area/template_noop)
"m" = (
/obj/effect/decal/cleanable/blood/old,
/obj/structure/sign/plaques/kiddie/library{
	pixel_x = 32;
	pixel_y = -32
	},
/turf/open/floor/wood,
/area/template_noop)
"n" = (
/turf/open/floor/wood{
	icon_state = "wood-broken6"
	},
/area/template_noop)
"o" = (
/obj/structure/bookcase/random/fiction,
/obj/effect/decal/cleanable/cobweb,
/turf/open/floor/plasteel/dark,
/area/template_noop)
"p" = (
/obj/structure/bookcase/random/fiction,
/turf/open/floor/plasteel/dark,
/area/template_noop)
"q" = (
/obj/item/twohanded/required/kirbyplants{
	icon_state = "plant-05"
	},
/obj/effect/turf_decal/tile/neutral,
/obj/effect/turf_decal/tile/neutral{
	dir = 1
	},
/obj/effect/decal/cleanable/dirt,
/turf/open/floor/plasteel/dark,
/area/template_noop)
"r" = (
/obj/structure/bookcase/random/reference,
/obj/effect/decal/cleanable/cobweb/cobweb2,
/turf/open/floor/plasteel/dark,
/area/template_noop)
"s" = (
/obj/structure/table/wood,
/obj/machinery/newscaster{
	pixel_x = 30
	},
/obj/effect/turf_decal/stripes/corner{
	dir = 8
	},
/obj/item/paper_bin{
	pixel_x = 4;
	pixel_y = 4
	},
/obj/item/pen,
/turf/open/floor/wood,
/area/template_noop)
"w" = (
/obj/effect/turf_decal/tile/neutral,
/obj/effect/turf_decal/tile/neutral{
	dir = 1
	},
/obj/effect/decal/cleanable/dirt,
/obj/effect/decal/cleanable/blood/gibs/old,
/turf/open/floor/plasteel/dark,
/area/template_noop)

(1,1,1) = {"
a
f
k
o
"}
(2,1,1) = {"
b
w
g
p
"}
(3,1,1) = {"
c
h
l
q
"}
(4,1,1) = {"
d
i
m
r
"}
(5,1,1) = {"
e
j
n
s
"}
