"aA" = (/obj/machinery/atmospherics/pipe/simple/scrubbers/hidden{dir = 8},/turf/closed/wall/r_wall,/area/space)
"aP" = (/obj/structure/cable{icon_state = "4-8"},/turf/closed/wall/r_wall,/area/space)
"aU" = (/obj/structure/grille,/turf/open/floor/plating,/area/space)
"bu" = (/obj/effect/turf_decal/stripes/line{dir = 10},/obj/machinery/field/generator{anchored = 1},/turf/open/floor/plating/airless,/area/space)
"bL" = (/obj/structure/cable{icon_state = "1-2"},/turf/open/floor/plating,/area/space)
"bO" = (/obj/machinery/atmospherics/pipe/simple/supply/hidden{dir = 8},/turf/closed/wall/r_wall,/area/space)
"cB" = (/obj/structure/grille,/obj/structure/cable{icon_state = "4-8"},/turf/open/floor/plating,/area/space)
"ds" = (/obj/effect/turf_decal/stripes/line{dir = 10},/turf/open/floor/plating/airless,/area/space)
"dB" = (/obj/structure/cable{icon_state = "2-8"},/turf/open/floor/plating,/area/space)
"dE" = (/obj/structure/cable{icon_state = "1-8"},/obj/structure/cable{icon_state = "2-8"},/turf/open/floor/plating,/area/space)
"dH" = (/obj/structure/cable,/turf/open/floor/plating,/area/space)
"dP" = (/obj/structure/disposalpipe/segment{dir = 4},/obj/machinery/atmospherics/pipe/simple/supply/hidden{dir = 4},/obj/effect/turf_decal/stripes/line,/turf/open/floor/plasteel,/area/space)
"dU" = (/obj/effect/turf_decal/stripes/line{dir = 4},/turf/open/floor/plating/airless,/area/space)
"gu" = (/obj/effect/turf_decal/stripes/line{dir = 4},/obj/machinery/atmospherics/pipe/simple/supply/hidden{dir = 10},/turf/open/floor/plasteel,/area/space)
"gG" = (/obj/structure/cable{icon_state = "4-8"},/obj/effect/decal/cleanable/dirt/dust,/turf/open/floor/plating,/area/space)
"hn" = (/obj/effect/turf_decal/stripes/line{dir = 6},/obj/machinery/field/generator{anchored = 1},/turf/open/floor/plating/airless,/area/space)
"iD" = (/obj/structure/cable{icon_state = "0-2"},/turf/open/floor/plating,/area/space)
"iL" = (/obj/structure/cable{icon_state = "1-4"},/obj/machinery/button/door{id = "engpa"; name = "Engineering Chamber Shutters Control"; pixel_y = -26; req_access_txt = "11"},/obj/effect/decal/cleanable/oil,/turf/open/floor/plating,/area/space)
"iU" = (/obj/effect/decal/cleanable/oil,/turf/open/floor/plating,/area/space)
"iV" = (/obj/machinery/atmospherics/pipe/simple/scrubbers/hidden{dir = 5},/turf/closed/wall/r_wall,/area/space)
"jc" = (/obj/item/screwdriver{pixel_y = 10},/obj/item/radio/off,/obj/machinery/computer/security/telescreen/minisat{dir = 4; pixel_x = -29},/obj/effect/turf_decal/tile/red{dir = 1},/obj/effect/turf_decal/tile/red{dir = 8},/turf/open/floor/plasteel,/area/space)
"jJ" = (/obj/machinery/door/window/southright{dir = 4; name = "Engineering Deliveries"; req_access_txt = "10"},/obj/effect/turf_decal/delivery,/turf/open/floor/plasteel,/area/space)
"ku" = (/obj/effect/turf_decal/stripes/line{dir = 4},/obj/machinery/atmospherics/pipe/simple/supply/hidden,/obj/machinery/atmospherics/pipe/simple/scrubbers/hidden{dir = 4},/turf/open/floor/plasteel,/area/space)
"lb" = (/obj/machinery/particle_accelerator/control_box,/obj/structure/cable,/turf/open/floor/plating,/area/space)
"ls" = (/obj/effect/turf_decal/stripes/line{dir = 9},/turf/open/floor/plating/airless,/area/space)
"lM" = (/obj/structure/lattice,/turf/open/space/basic,/area/space)
"lU" = (/obj/structure/particle_accelerator/fuel_chamber{dir = 8},/turf/open/floor/plating,/area/space)
"lV" = (/obj/structure/rack,/obj/item/crowbar,/obj/item/tank/internals/emergency_oxygen/engi,/obj/item/stack/cable_coil/white,/obj/effect/turf_decal/bot,/obj/effect/turf_decal/stripes/line,/turf/open/floor/plasteel,/area/space)
"mk" = (/obj/effect/turf_decal/stripes/line{dir = 4},/obj/machinery/atmospherics/pipe/manifold/supply/hidden{dir = 8},/turf/open/floor/plasteel,/area/space)
"ml" = (/obj/machinery/door/poddoor/shutters/preopen{id = "engpa"; name = "Engineering Chamber Shutters"},/obj/effect/spawner/structure/window/reinforced,/obj/structure/cable{icon_state = "4-8"},/turf/open/floor/plating,/area/space)
"mt" = (/obj/effect/turf_decal/stripes/corner{dir = 1},/obj/machinery/atmospherics/pipe/manifold/scrubbers/hidden{dir = 8},/turf/open/floor/plasteel,/area/space)
"oc" = (/obj/structure/cable{icon_state = "2-8"},/obj/structure/cable{icon_state = "1-8"},/obj/structure/particle_accelerator/end_cap{dir = 4},/turf/open/floor/plating,/area/space)
"om" = (/obj/effect/turf_decal/stripes/line{dir = 6},/obj/machinery/atmospherics/pipe/manifold/supply/hidden,/turf/open/floor/plasteel,/area/space)
"oP" = (/obj/structure/disposalpipe/segment,/obj/structure/cable/yellow{icon_state = "1-8"},/turf/open/floor/plasteel,/area/space)
"oR" = (/obj/machinery/atmospherics/pipe/simple/scrubbers/hidden{dir = 6},/turf/closed/wall/r_wall,/area/space)
"pC" = (/obj/structure/grille,/obj/structure/cable{icon_state = "1-2"},/turf/open/floor/plating,/area/space)
"pH" = (/obj/structure/cable{icon_state = "1-2"},/obj/effect/decal/cleanable/dirt/dust,/turf/open/floor/plating,/area/space)
"pM" = (/obj/structure/cable{icon_state = "0-2"},/obj/effect/turf_decal/stripes/line,/turf/open/floor/plating,/area/space)
"pX" = (/turf/open/space/basic,/area/space)
"qd" = (/obj/structure/table,/obj/item/radio/intercom{dir = 4; pixel_y = 29},/obj/machinery/recharger{pixel_y = 4},/obj/effect/turf_decal/tile/red{dir = 1},/obj/effect/turf_decal/tile/red{dir = 4},/turf/open/floor/plasteel,/area/space)
"qj" = (/obj/effect/turf_decal/delivery,/obj/structure/closet/emcloset{anchored = 1},/obj/machinery/atmospherics/pipe/simple/supply/hidden{dir = 9},/turf/open/floor/plasteel,/area/space)
"qA" = (/obj/structure/disposalpipe/segment{dir = 9},/obj/machinery/atmospherics/pipe/simple/supply/hidden{dir = 4},/obj/effect/turf_decal/stripes/line,/turf/open/floor/plasteel,/area/space)
"qW" = (/obj/machinery/atmospherics/pipe/simple/scrubbers/hidden,/turf/closed/wall,/area/space)
"rv" = (/obj/structure/closet/toolcloset,/obj/effect/turf_decal/bot,/obj/effect/turf_decal/stripes/line{dir = 1},/turf/open/floor/plasteel,/area/space)
"rR" = (/obj/structure/closet/toolcloset,/obj/effect/turf_decal/bot,/obj/effect/turf_decal/stripes/line,/turf/open/floor/plasteel,/area/space)
"rV" = (/obj/structure/rack,/obj/item/clothing/gloves/color/black,/obj/item/wrench,/obj/item/clothing/glasses/meson/engine,/obj/effect/turf_decal/bot,/obj/effect/turf_decal/stripes/line,/obj/machinery/button/door{id = "engpa"; name = "Engineering Chamber Shutters Control"; pixel_y = -26; req_access_txt = "11"},/turf/open/floor/plasteel,/area/space)
"sc" = (/obj/structure/cable/yellow{icon_state = "1-2"},/obj/structure/disposalpipe/sorting/mail{sortType = 4},/obj/effect/landmark/start/station_engineer,/turf/open/floor/plasteel,/area/space)
"sF" = (/obj/effect/turf_decal/stripes/line{dir = 1},/turf/open/floor/plasteel,/area/space)
"sG" = (/obj/effect/turf_decal/stripes/line{dir = 5},/turf/open/floor/plating/airless,/area/space)
"sO" = (/obj/machinery/camera/emp_proof{c_tag = "Containment - Fore Starboard"; dir = 8; network = list("singularity")},/turf/open/floor/plating,/area/space)
"tc" = (/obj/effect/turf_decal/stripes/line{dir = 8},/obj/machinery/atmospherics/pipe/simple/supply/hidden{dir = 4},/turf/open/floor/plasteel,/area/space)
"td" = (/obj/structure/cable,/obj/effect/turf_decal/stripes/line{dir = 1},/turf/open/floor/plating,/area/space)
"tg" = (/obj/structure/grille,/obj/structure/cable{icon_state = "2-8"},/turf/open/floor/plating,/area/space)
"tq" = (/obj/machinery/atmospherics/pipe/simple/scrubbers/hidden{dir = 4},/obj/structure/cable/yellow{icon_state = "4-8"},/turf/open/floor/plasteel,/area/space)
"tJ" = (/obj/machinery/atmospherics/pipe/simple/scrubbers/hidden{dir = 9},/turf/closed/wall/r_wall,/area/space)
"tW" = (/obj/effect/turf_decal/stripes/corner,/turf/open/floor/plasteel,/area/space)
"ua" = (/obj/structure/cable{icon_state = "4-8"},/obj/structure/cable{icon_state = "2-8"},/turf/open/floor/plating,/area/space)
"wi" = (/obj/structure/disposalpipe/segment,/obj/structure/cable/yellow{icon_state = "1-2"},/obj/machinery/atmospherics/pipe/simple/supply/hidden{dir = 5},/obj/effect/turf_decal/stripes/line{dir = 1},/turf/open/floor/plasteel,/area/space)
"wA" = (/obj/effect/turf_decal/stripes/line{dir = 6},/obj/machinery/atmospherics/pipe/simple/scrubbers/hidden{dir = 4},/obj/machinery/atmospherics/pipe/simple/supply/hidden,/turf/open/floor/plasteel,/area/space)
"wG" = (/obj/structure/grille,/obj/structure/cable{icon_state = "1-4"},/turf/open/floor/plating,/area/space)
"xB" = (/obj/structure/grille,/obj/structure/cable{icon_state = "2-4"},/turf/open/floor/plating,/area/space)
"xH" = (/obj/machinery/door/poddoor/shutters/preopen{id = "engpa"; name = "Engineering Chamber Shutters"},/obj/effect/spawner/structure/window/reinforced,/turf/open/floor/plating,/area/space)
"yP" = (/obj/structure/rack,/obj/item/crowbar,/obj/item/wirecutters,/obj/item/stack/cable_coil/white,/obj/effect/turf_decal/bot,/obj/effect/turf_decal/stripes/line{dir = 1},/obj/machinery/button/door{id = "engpa"; name = "Engineering Chamber Shutters Control"; pixel_y = 26; req_access_txt = "11"},/turf/open/floor/plasteel,/area/space)
"yR" = (/obj/structure/grille,/obj/structure/cable{icon_state = "2-8"},/obj/structure/cable{icon_state = "4-8"},/turf/open/floor/plating,/area/space)
"yV" = (/obj/machinery/door/airlock/external{name = "External Containment Access"; req_access_txt = "10; 13"},/turf/open/space/basic,/area/space)
"zp" = (/obj/structure/particle_accelerator/power_box{dir = 4},/turf/open/floor/plating,/area/space)
"zB" = (/obj/effect/turf_decal/stripes/line{dir = 5},/obj/machinery/field/generator{anchored = 1},/turf/open/floor/plating/airless,/area/space)
"Ad" = (/obj/machinery/light_switch{pixel_x = 23},/obj/machinery/atmospherics/pipe/simple/supply/hidden{dir = 10},/obj/machinery/shower{dir = 8; name = "emergency shower"},/obj/structure/sign/warning/securearea{pixel_y = 32},/obj/effect/turf_decal/stripes/line{dir = 5},/turf/open/floor/plasteel,/area/space)
"Ao" = (/obj/machinery/atmospherics/pipe/simple/scrubbers/hidden,/turf/closed/wall/r_wall,/area/space)
"Ax" = (/turf/open/floor/plasteel,/area/space)
"Bk" = (/obj/structure/filingcabinet,/obj/structure/reagent_dispensers/peppertank{pixel_y = 30},/obj/machinery/airalarm{dir = 4; pixel_x = -23},/obj/effect/turf_decal/tile/red{dir = 1},/obj/effect/turf_decal/tile/red{dir = 4},/obj/effect/turf_decal/tile/red{dir = 8},/turf/open/floor/plasteel,/area/space)
"By" = (/obj/structure/rack,/obj/item/storage/belt/utility,/obj/item/weldingtool,/obj/item/clothing/head/welding,/obj/effect/turf_decal/bot,/obj/effect/turf_decal/stripes/line{dir = 1},/turf/open/floor/plasteel,/area/space)
"BB" = (/obj/structure/lattice/catwalk,/obj/structure/cable{icon_state = "1-2"},/turf/open/space/basic,/area/space)
"BV" = (/obj/effect/decal/cleanable/dirt/dust,/turf/open/floor/plating,/area/space)
"CE" = (/obj/machinery/door/airlock/external{name = "External Containment Access"; req_access_txt = "10; 13"},/obj/machinery/atmospherics/pipe/simple/scrubbers/hidden{dir = 9},/turf/open/floor/plasteel,/area/space)
"CQ" = (/obj/machinery/atmospherics/pipe/simple/scrubbers/hidden{dir = 9},/turf/closed/wall,/area/space)
"DQ" = (/obj/structure/table,/obj/item/book/manual/wiki/security_space_law,/obj/machinery/light{dir = 4},/obj/machinery/requests_console{department = "Security"; departmentType = 5; pixel_x = 30},/obj/effect/turf_decal/tile/red,/obj/effect/turf_decal/tile/red{dir = 4},/turf/open/floor/plasteel,/area/space)
"EJ" = (/obj/machinery/atmospherics/pipe/simple/supply/hidden{dir = 4},/turf/closed/wall/r_wall,/area/space)
"EO" = (/obj/structure/lattice/catwalk,/turf/open/space,/area/space)
"ES" = (/obj/structure/particle_accelerator/particle_emitter/left{dir = 4},/obj/effect/decal/cleanable/dirt/dust,/turf/open/floor/plating,/area/space)
"FJ" = (/obj/effect/turf_decal/stripes/line{dir = 6},/turf/open/floor/plating/airless,/area/space)
"Gm" = (/obj/effect/turf_decal/stripes/line{dir = 8},/turf/open/floor/plating/airless,/area/space)
"Gv" = (/obj/structure/cable/yellow{icon_state = "1-2"},/obj/structure/disposalpipe/segment,/obj/machinery/atmospherics/pipe/simple/scrubbers/hidden{dir = 4},/turf/open/floor/plasteel,/area/space)
"GY" = (/obj/structure/particle_accelerator/particle_emitter/center{dir = 4},/turf/open/floor/plating,/area/space)
"Hh" = (/obj/effect/turf_decal/delivery,/obj/machinery/door/poddoor/shutters/preopen{id = "engpa"; name = "Engineering Chamber Shutters"},/turf/open/floor/plasteel,/area/space)
"HB" = (/obj/structure/cable,/obj/machinery/power/tesla_coil,/turf/open/floor/plating,/area/space)
"HT" = (/obj/structure/grille,/obj/structure/cable{icon_state = "1-8"},/turf/open/floor/plating,/area/space)
"HZ" = (/obj/structure/sign/warning/securearea{pixel_y = 32},/obj/effect/turf_decal/stripes/line{dir = 9},/obj/structure/closet/radiation,/turf/open/floor/plasteel,/area/space)
"Iz" = (/obj/structure/cable{icon_state = "4-8"},/turf/open/floor/plating,/area/space)
"IA" = (/obj/structure/cable{icon_state = "1-2"},/obj/machinery/camera/emp_proof{c_tag = "Containment - Fore Port"; dir = 4; network = list("singularity")},/turf/open/floor/plating,/area/space)
"IE" = (/obj/effect/turf_decal/stripes/line{dir = 8},/obj/effect/turf_decal/stripes/line{dir = 4},/obj/effect/turf_decal/stripes/line{dir = 1},/obj/machinery/door/poddoor/shutters/preopen{id = "engpa"; name = "Engineering Chamber Shutters"},/turf/open/floor/plasteel,/area/space)
"IP" = (/obj/structure/lattice,/turf/open/space,/area/space)
"KC" = (/obj/effect/turf_decal/stripes/line{dir = 10},/obj/machinery/atmospherics/pipe/simple/scrubbers/hidden{dir = 4},/turf/open/floor/plasteel,/area/space)
"KM" = (/obj/structure/grille,/obj/structure/cable{icon_state = "1-8"},/obj/structure/cable{icon_state = "4-8"},/turf/open/floor/plating,/area/space)
"KV" = (/obj/structure/cable{icon_state = "2-4"},/obj/effect/decal/cleanable/dirt/dust,/obj/machinery/button/door{id = "engpa"; name = "Engineering Chamber Shutters Control"; pixel_y = 26; req_access_txt = "11"},/turf/open/floor/plating{icon_state = "platingdmg3"},/area/space)
"Lj" = (/obj/structure/cable{icon_state = "0-2"},/obj/machinery/power/tesla_coil,/turf/open/floor/plating,/area/space)
"LK" = (/obj/effect/turf_decal/stripes/line,/turf/open/floor/plating/airless,/area/space)
"Ml" = (/obj/effect/turf_decal/delivery,/obj/structure/closet/emcloset{anchored = 1},/obj/machinery/atmospherics/pipe/simple/scrubbers/hidden,/turf/open/floor/plasteel,/area/space)
"Mm" = (/obj/machinery/door/poddoor/shutters/preopen{id = "engpa"; name = "Engineering Chamber Shutters"},/turf/open/floor/plating,/area/space)
"MB" = (/obj/machinery/atmospherics/pipe/simple/supply/hidden{dir = 9},/turf/closed/wall/r_wall,/area/space)
"No" = (/obj/structure/cable{icon_state = "2-4"},/obj/structure/cable{icon_state = "1-4"},/turf/open/floor/plating,/area/space)
"NS" = (/obj/effect/turf_decal/stripes/line{dir = 8},/obj/effect/turf_decal/stripes/line{dir = 4},/obj/machinery/door/poddoor/shutters/preopen{id = "engpa"; name = "Engineering Chamber Shutters"},/turf/open/floor/plasteel,/area/space)
"Pi" = (/obj/effect/turf_decal/stripes/line,/obj/machinery/atmospherics/pipe/simple/scrubbers/hidden{dir = 4},/turf/open/floor/plasteel,/area/space)
"Pk" = (/obj/effect/turf_decal/stripes/line{dir = 1},/obj/effect/landmark/event_spawn,/turf/open/floor/plasteel,/area/space)
"PT" = (/obj/structure/table,/obj/item/paper_bin{pixel_x = -1; pixel_y = 5},/obj/item/pen,/obj/machinery/newscaster/security_unit{pixel_x = 30},/obj/effect/turf_decal/tile/red{dir = 1},/obj/effect/turf_decal/tile/red,/obj/effect/turf_decal/tile/red{dir = 4},/turf/open/floor/plasteel,/area/space)
"PY" = (/obj/machinery/atmospherics/pipe/simple/scrubbers/hidden{dir = 10},/turf/closed/wall/r_wall,/area/space)
"Qd" = (/obj/effect/turf_decal/stripes/line{dir = 8},/obj/effect/turf_decal/stripes/line{dir = 4},/obj/effect/turf_decal/stripes/line,/obj/machinery/door/poddoor/shutters/preopen{id = "engpa"; name = "Engineering Chamber Shutters"},/turf/open/floor/plasteel,/area/space)
"Qm" = (/turf/closed/wall,/area/space)
"QQ" = (/obj/structure/cable{icon_state = "1-8"},/turf/open/floor/plating{icon_state = "platingdmg3"},/area/space)
"Rj" = (/obj/item/wrench,/turf/open/floor/plating/airless,/area/space)
"RA" = (/obj/effect/turf_decal/stripes/line{dir = 1},/turf/open/floor/plating/airless,/area/space)
"RJ" = (/obj/machinery/atmospherics/pipe/simple/supply/hidden{dir = 5},/turf/closed/wall,/area/space)
"RO" = (/obj/machinery/atmospherics/pipe/simple/supply/hidden{dir = 4},/turf/open/floor/plasteel,/area/space)
"Si" = (/obj/structure/disposalpipe/segment{dir = 4},/obj/effect/turf_decal/stripes/line{dir = 8},/obj/machinery/atmospherics/pipe/simple/scrubbers/hidden,/turf/open/floor/plasteel,/area/space)
"Tg" = (/obj/machinery/disposal/bin,/obj/structure/disposalpipe/trunk{dir = 4},/obj/effect/turf_decal/delivery,/obj/structure/window/reinforced{dir = 1; pixel_y = 2},/turf/open/floor/plasteel,/area/space)
"Tq" = (/obj/effect/turf_decal/stripes/line,/turf/open/floor/plasteel,/area/space)
"US" = (/obj/machinery/atmospherics/pipe/simple/supply/hidden,/turf/open/floor/plasteel,/area/space)
"UW" = (/obj/machinery/door/airlock/external{name = "External Containment Access"; req_access_txt = "10; 13"},/turf/open/floor/plasteel,/area/space)
"Ve" = (/obj/structure/particle_accelerator/particle_emitter/right{dir = 4},/obj/effect/decal/cleanable/dirt/dust,/turf/open/floor/plating,/area/space)
"Vk" = (/obj/machinery/atmospherics/pipe/manifold/scrubbers/hidden{dir = 1},/turf/closed/wall/r_wall,/area/space)
"VN" = (/obj/machinery/power/rad_collector/anchored,/turf/open/floor/plating,/area/space)
"Wk" = (/turf/open/floor/plating,/area/space)
"Xv" = (/turf/closed/wall/r_wall,/area/space)
"XN" = (/obj/effect/turf_decal/stripes/corner{dir = 8},/turf/open/floor/plasteel,/area/space)
"Yi" = (/obj/effect/turf_decal/stripes/line{dir = 9},/obj/machinery/field/generator{anchored = 1},/turf/open/floor/plating/airless,/area/space)
"Zh" = (/obj/structure/cable/yellow{icon_state = "4-8"},/obj/machinery/atmospherics/pipe/simple/scrubbers/hidden{dir = 9},/turf/open/floor/plasteel,/area/space)
"Zs" = (/obj/structure/chair/office{dir = 4},/obj/effect/landmark/start/depsec/engineering,/turf/open/floor/plasteel,/area/space)
"ZE" = (/obj/machinery/atmospherics/components/binary/dp_vent_pump/high_volume{dir = 1},/turf/open/floor/plasteel,/area/space)

(1,1,1) = {"
jJHZwiAdXvXvXvXvXvXvAoXvXviVaAaAaAtJXv
TgSiscmkoRVkaAaAaAaAtJXvXvXvXvXvXvXvXv
PkmtGvkutJMlXvxByRcByRcByRcByRcBtgaUXv
tqZhoPUSUWZEyVbLtdWkbLaUpCaUbLWktdWkXv
dPdPqAombOMBXvbLWkWkbLWkbLWkbLWkWkWkXv
AxAxAxAxIEVNxHbLlMlMBBlMBBlMBBlMlMWkXv
AxAxAxAxNSVNxHbLWkWkdHWkHBWkdHWkWksOXv
rRrVTqlVQdVNxHbLYiIPIPEOpXEOIPIPzBWkXv
XvXvHhXvXvXvXvIAIPpXpXEOIPEOpXpXIPWkXv
XvKVuaIzIzdBxHbLIPpXEOEOEOEOEOpXIPWkXv
MmbLlbiUVepHxHbLEOEOEOlsRAsGEOEOEOWkXv
aPoclUzpGYNomldEpXIPEOGmRjdUEOIPpXWkXv
MmbLWkBVESbLxHbLEOEOEOdsLKFJEOEOEOWkXv
XviLgGIzIzQQxHbLIPpXEOEOEOEOEOpXIPWkXv
XvXvHhXvXvXvXvIAIPpXpXEOIPEOpXpXIPWkXv
rvyPsFByIEVNxHbLbuIPIPEOpXEOIPIPhnWkXv
AxAxAxAxNSVNxHbLWkWkiDWkLjWkiDWkWksOXv
TqXNAxtWQdVNxHbLlMlMBBlMBBlMBBlMlMWkXv
EJtcROguoRPYXvbLWkWkbLWkbLWkbLWkWkWkXv
oRKCPiwACEZEyVbLpMWkbLaUpCaUbLWkpMWkXv
qWQmQmRJbOqjXvwGKMcBKMcBKMcBKMcBHTaUXv
qWBkqdPTXvXvXvXvXvXvXvXvXvXvXvXvXvXvXv
CQjcZsDQXvXvXvXvXvXvXvXvXvXvXvXvXvXvXv
"}
