//MAP CONVERTED BY dmm2tgm.py THIS HEADER COMMENT PREVENTS RECONVERSION, DO NOT REMOVE
"a" = (
/obj/effect/decal/cleanable/blood/tracks{
	dir = 8;
	pixel_y = 8
	},
/obj/effect/decal/cleanable/blood/footprints,
/obj/effect/decal/cleanable/blood/footprints{
	dir = 1
	},
/obj/effect/trap/nexus/doorbolt,
/mob/living/simple_animal/hostile/retaliate/goat/rabid,
/turf/open/floor/iron/freezer,
/area/template_noop)
"d" = (
/obj/structure/closet/secure_closet/freezer/meat,
/obj/item/food/meat/slab/human,
/obj/item/food/meat/slab/human,
/obj/item/food/meat/slab/human,
/obj/item/food/meat/slab/human,
/obj/item/food/meat/slab/human,
/obj/item/food/meat/slab/human/mutant/psyphoza,
/obj/item/food/meat/slab/human/mutant/psyphoza,
/obj/item/food/meat/slab/human/mutant/psyphoza,
/obj/item/food/meat/slab/human/mutant/psyphoza,
/obj/item/food/meat/slab/human/mutant/psyphoza,
/obj/item/stack/sheet/animalhide/mothroach,
/obj/machinery/light/small{
	dir = 1
	},
/turf/open/floor/iron/freezer,
/area/template_noop)
"g" = (
/obj/machinery/food_cart,
/turf/open/floor/iron/freezer,
/area/template_noop)
"h" = (
/obj/structure/closet/secure_closet/freezer/meat,
/obj/effect/decal/cleanable/blood,
/obj/item/food/meat/slab/human/mutant/moth,
/obj/item/food/meat/slab/human/mutant/moth,
/obj/item/food/meat/slab/human/mutant/moth,
/obj/item/food/meat/slab/human/mutant/moth,
/obj/item/food/meat/slab/human/mutant/moth,
/obj/item/food/meat/slab/human/mutant/apid,
/obj/item/food/meat/slab/human/mutant/apid,
/obj/item/food/meat/slab/human/mutant/apid,
/obj/item/food/meat/slab/human/mutant/apid,
/obj/item/food/meat/slab/human/mutant/apid,
/obj/item/stack/sheet/animalhide/lizard,
/turf/open/floor/iron/freezer,
/area/template_noop)
"j" = (
/obj/structure/kitchenspike,
/obj/effect/decal/cleanable/blood,
/turf/open/floor/iron/freezer,
/area/template_noop)
"m" = (
/obj/effect/decal/cleanable/blood/tracks{
	dir = 8;
	pixel_y = 8
	},
/turf/open/floor/iron/freezer,
/area/template_noop)
"w" = (
/obj/effect/decal/cleanable/blood/tracks{
	dir = 8;
	pixel_y = 8
	},
/obj/effect/decal/cleanable/blood/splatter,
/turf/open/floor/iron/freezer,
/area/template_noop)
"x" = (
/obj/effect/decal/cleanable/blood/footprints,
/obj/effect/decal/cleanable/blood/footprints{
	dir = 1
	},
/obj/effect/trap/trigger/reusable,
/turf/open/floor/iron/freezer,
/area/template_noop)
"A" = (
/obj/effect/decal/cleanable/blood/tracks{
	dir = 8;
	pixel_y = 8
	},
/obj/effect/trap/trigger/reusable,
/turf/open/floor/iron/freezer,
/area/template_noop)
"F" = (
/obj/machinery/gibber,
/obj/effect/decal/cleanable/blood/gibs,
/turf/open/floor/iron/freezer,
/area/template_noop)
"K" = (
/obj/effect/decal/cleanable/blood/gibs,
/obj/effect/decal/cleanable/blood,
/obj/effect/trap/trigger/reusable,
/turf/open/floor/iron/freezer,
/area/template_noop)
"L" = (
/obj/structure/kitchenspike{
	contents = list(/obj/effect/mob_spawn/human)
	},
/turf/open/floor/iron/freezer,
/area/template_noop)
"R" = (
/obj/structure/reagent_dispensers/nutriment/fat/oil,
/turf/open/floor/iron/freezer,
/area/template_noop)
"Z" = (
/obj/effect/decal/cleanable/blood/tracks{
	dir = 8;
	pixel_y = 8
	},
/obj/item/stack/sheet/animalhide/monkey,
/obj/effect/trap/trigger/reusable,
/turf/open/floor/iron/freezer,
/area/template_noop)

(1,1,1) = {"
j
Z
F
"}
(2,1,1) = {"
L
m
j
"}
(3,1,1) = {"
K
a
x
"}
(4,1,1) = {"
d
w
g
"}
(5,1,1) = {"
h
A
R
"}
