//MAP CONVERTED BY dmm2tgm.py THIS HEADER COMMENT PREVENTS RECONVERSION, DO NOT REMOVE
"a" = (
/obj/structure/table{
	dir = 1
	},
/obj/item/flashlight/lamp{
	dir = 1
	},
/obj/effect/decal/cleanable/cobweb{
	dir = 4
	},
/obj/effect/turf_decal/tile/blue{
	dir = 8
	},
/obj/effect/turf_decal/tile/blue{
	dir = 4
	},
/obj/effect/turf_decal/tile/blue{
	dir = 2
	},
/obj/effect/turf_decal/tile/blue{
	dir = 1
	},
/turf/open/floor/plasteel/white,
/area/template_noop)
"b" = (
/obj/machinery/clonepod/experimental{
	dir = 1
	},
/obj/effect/turf_decal/tile/blue{
	dir = 8
	},
/obj/effect/turf_decal/tile/blue{
	dir = 4
	},
/obj/effect/turf_decal/tile/blue{
	dir = 2
	},
/obj/effect/turf_decal/tile/blue{
	dir = 1
	},
/turf/open/floor/plasteel/white,
/area/template_noop)
"c" = (
/obj/effect/turf_decal/tile/blue{
	dir = 8
	},
/obj/effect/turf_decal/tile/blue{
	dir = 4
	},
/obj/effect/turf_decal/tile/blue{
	dir = 2
	},
/obj/effect/turf_decal/tile/blue{
	dir = 1
	},
/turf/open/floor/plasteel/white,
/area/template_noop)
"d" = (
/obj/machinery/dna_scannernew{
	dir = 1
	},
/obj/effect/turf_decal/tile/blue{
	dir = 8
	},
/obj/effect/turf_decal/tile/blue{
	dir = 4
	},
/obj/effect/turf_decal/tile/blue{
	dir = 2
	},
/obj/effect/turf_decal/tile/blue{
	dir = 1
	},
/turf/open/floor/plasteel/white,
/area/template_noop)
"e" = (
/obj/machinery/computer/cloning/prototype{
	dir = 1
	},
/obj/machinery/light{
	dir = 2
	},
/obj/item/paper/fluff/ruins/exp_cloning/manual{
	dir = 1
	},
/obj/effect/turf_decal/tile/blue{
	dir = 8
	},
/obj/effect/turf_decal/tile/blue{
	dir = 4
	},
/obj/effect/turf_decal/tile/blue{
	dir = 2
	},
/obj/effect/turf_decal/tile/blue{
	dir = 1
	},
/obj/effect/decal/cleanable/cobweb/cobweb2{
	dir = 4
	},
/turf/open/floor/plasteel/white,
/area/template_noop)
"f" = (
/obj/effect/turf_decal/tile/blue{
	dir = 8
	},
/obj/effect/turf_decal/tile/blue{
	dir = 2
	},
/turf/open/floor/plasteel/white,
/area/template_noop)
"g" = (
/obj/structure/chair{
	dir = 2
	},
/obj/effect/turf_decal/tile/blue{
	dir = 8
	},
/obj/effect/turf_decal/tile/blue{
	dir = 2
	},
/turf/open/floor/plasteel/white,
/area/template_noop)
"h" = (
/obj/effect/turf_decal/tile/blue{
	dir = 8
	},
/turf/open/floor/plasteel/white,
/area/template_noop)
"i" = (
/obj/item/reagent_containers/food/drinks/bottle/synthflesh{
	dir = 1
	},
/obj/item/reagent_containers/food/drinks/bottle/synthflesh{
	dir = 1
	},
/obj/structure/closet{
	dir = 1
	},
/turf/open/floor/plasteel/white,
/area/template_noop)
"j" = (
/turf/open/floor/plasteel/white,
/area/template_noop)
"k" = (
/obj/effect/turf_decal/tile/blue{
	dir = 8
	},
/obj/effect/turf_decal/tile/blue{
	dir = 4
	},
/obj/effect/turf_decal/tile/blue{
	dir = 2
	},
/obj/effect/turf_decal/tile/blue{
	dir = 1
	},
/obj/effect/trap/nexus/trickyspawner/zombie{
	dir = 1
	},
/obj/effect/spawner/lootdrop/trap{
	dir = 1
	},
/turf/open/floor/plasteel/white,
/area/template_noop)

(1,1,1) = {"
i
f
a"}(2,1,1) = {"
j
g
b"}(3,1,1) = {"
j
k
c"}(4,1,1) = {"
j
g
d"}(5,1,1) = {"
j
h
e"}