//MAP CONVERTED BY dmm2tgm.py THIS HEADER COMMENT PREVENTS RECONVERSION, DO NOT REMOVE
"a" = (
/obj/structure/rack,
/obj/item/clothing/gloves/color/fyellow,
/obj/effect/spawner/lootdrop/maintenance,
/obj/structure/sink/kitchen{
	desc = "A sink used for washing one's hands and face. It looks rusty and home-made";
	name = "old sink";
	pixel_y = 28
	},
/obj/item/storage/belt/utility,
/turf/open/floor/plating,
/area/template_noop)
"b" = (
/obj/structure/table,
/obj/item/tank/internals/emergency_oxygen{
	pixel_x = -8
	},
/obj/item/tank/internals/emergency_oxygen{
	pixel_x = -8
	},
/obj/item/clothing/mask/breath{
	pixel_x = 4
	},
/obj/item/clothing/mask/breath{
	pixel_x = 4
	},
/obj/effect/decal/cleanable/cobweb,
/obj/structure/sign/warning/vacuum/external{
	pixel_y = 32
	},
/turf/open/floor/plating,
/area/template_noop)
"c" = (
/turf/open/floor/plating,
/area/template_noop)
"d" = (
/obj/structure/easel,
/turf/open/floor/plating{
	icon_state = "platingdmg3"
	},
/area/template_noop)
"e" = (
/obj/structure/closet,
/obj/effect/decal/cleanable/cobweb/cobweb2,
/obj/item/reagent_containers/food/drinks/beer{
	desc = "Takes you to a whole new level of thinking.";
	name = "Meta-Cider"
	},
/obj/effect/spawner/lootdrop/maintenance,
/turf/open/floor/plating,
/area/template_noop)
"f" = (
/obj/item/mmi,
/obj/structure/rack,
/obj/effect/spawner/lootdrop/maintenance,
/turf/open/floor/plating,
/area/template_noop)
"g" = (
/obj/structure/rack,
/obj/item/clothing/suit/poncho,
/obj/item/clothing/head/sombrero,
/obj/effect/spawner/lootdrop/maintenance,
/turf/open/floor/plating,
/area/template_noop)
"h" = (
/turf/open/floor/plating{
	icon_state = "panelscorched"
	},
/area/template_noop)
"i" = (
/obj/structure/rack,
/obj/item/book/manual/wiki/engineering_guide{
	pixel_x = 3;
	pixel_y = 4
	},
/obj/effect/spawner/lootdrop/maintenance,
/obj/item/storage/box/lights/mixed,
/turf/open/floor/plating,
/area/template_noop)
"j" = (
/obj/effect/trap/nexus/trickyspawner,
/obj/effect/spawner/lootdrop/trap,
/turf/open/floor/plating,
/area/template_noop)

(1,1,1) = {"
a
c
g
"}
(2,1,1) = {"
b
c
h
"}
(3,1,1) = {"
c
j
c
"}
(4,1,1) = {"
d
c
f
"}
(5,1,1) = {"
e
c
i
"}
