//MAP CONVERTED BY dmm2tgm.py THIS HEADER COMMENT PREVENTS RECONVERSION, DO NOT REMOVE
"a" = (
/obj/structure/closet/crate{
	dir = 1
	},
/obj/item/stock_parts/matter_bin{
	dir = 1
	},
/obj/item/stock_parts/matter_bin{
	dir = 1
	},
/obj/item/stock_parts/matter_bin{
	dir = 1
	},
/obj/effect/decal/cleanable/dirt{
	dir = 4
	},
/obj/item/stock_parts/matter_bin/super{
	dir = 1
	},
/turf/open/floor/plating,
/area/template_noop)
"b" = (
/obj/structure/closet/crate{
	dir = 1
	},
/obj/item/stock_parts/micro_laser{
	dir = 1
	},
/obj/item/stock_parts/micro_laser{
	dir = 1
	},
/obj/item/stock_parts/micro_laser{
	dir = 1
	},
/obj/effect/decal/cleanable/dirt{
	dir = 4
	},
/turf/open/floor/plating,
/area/template_noop)
"c" = (
/turf/open/floor/plating,
/area/template_noop)
"d" = (
/obj/structure/table{
	dir = 1
	},
/obj/item/stock_parts/manipulator{
	dir = 1
	},
/obj/item/stock_parts/manipulator{
	dir = 1
	},
/obj/item/stock_parts/manipulator{
	dir = 1
	},
/obj/machinery/light/broken{
	icon_state = "tube-broken";
	dir = 2
	},
/obj/item/stock_parts/cell/hyper{
	dir = 1
	},
/turf/open/floor/plating{
	icon_state = "platingdmg3"
	},
/area/template_noop)
"e" = (
/obj/structure/table{
	dir = 1
	},
/obj/item/storage/toolbox/mechanical{
	dir = 1
	},
/obj/effect/decal/cleanable/dirt{
	dir = 4
	},
/turf/open/floor/plating,
/area/template_noop)
"f" = (
/obj/effect/decal/cleanable/dirt{
	dir = 4
	},
/turf/open/floor/plating,
/area/template_noop)
"g" = (
/turf/open/floor/plating{
	icon_state = "panelscorched"
	},
/area/template_noop)
"h" = (
/obj/structure/rack{
	dir = 1
	},
/obj/item/stack/sheet/iron/ten{
	dir = 1
	},
/obj/item/stack/cable_coil/random/five,
/obj/effect/decal/cleanable/dirt{
	dir = 4
	},
/turf/open/floor/plating,
/area/template_noop)
"i" = (
/obj/structure/frame{
	dir = 1
	},
/obj/machinery/light/built{
	dir = 1
	},
/obj/effect/decal/cleanable/oil{
	dir = 4
	},
/turf/open/floor/plating,
/area/template_noop)
"j" = (
/obj/structure/closet{
	dir = 1
	},
/obj/item/stock_parts/capacitor{
	dir = 1
	},
/obj/item/stock_parts/capacitor{
	dir = 1
	},
/obj/item/stock_parts/capacitor{
	dir = 1
	},
/turf/open/floor/plating,
/area/template_noop)
"k" = (
/obj/structure/closet{
	dir = 1
	},
/obj/item/stock_parts/scanning_module{
	dir = 1
	},
/obj/item/stock_parts/scanning_module{
	dir = 1
	},
/obj/item/stock_parts/scanning_module{
	dir = 1
	},
/obj/effect/decal/cleanable/dirt{
	dir = 4
	},
/obj/item/stock_parts/scanning_module/phasic{
	dir = 1
	},
/turf/open/floor/plating,
/area/template_noop)

(1,1,1) = {"
h
f
a"}(2,1,1) = {"
i
g
b"}(3,1,1) = {"
f
f
c"}(4,1,1) = {"
j
f
d"}(5,1,1) = {"
k
f
e"}