"a" = (/obj/structure/table,/obj/item/flashlight/lamp,/obj/effect/decal/cleanable/cobweb,/obj/effect/turf_decal/tile/blue{dir = 1},/obj/effect/turf_decal/tile/blue,/obj/effect/turf_decal/tile/blue{dir = 4},/obj/effect/turf_decal/tile/blue{dir = 8},/turf/open/floor/plasteel/white,/area/template_noop)
"b" = (/obj/machinery/clonepod/experimental,/obj/effect/turf_decal/tile/blue{dir = 1},/obj/effect/turf_decal/tile/blue,/obj/effect/turf_decal/tile/blue{dir = 4},/obj/effect/turf_decal/tile/blue{dir = 8},/turf/open/floor/plasteel/white,/area/template_noop)
"c" = (/obj/effect/turf_decal/tile/blue{dir = 1},/obj/effect/turf_decal/tile/blue,/obj/effect/turf_decal/tile/blue{dir = 4},/obj/effect/turf_decal/tile/blue{dir = 8},/turf/open/floor/plasteel/white,/area/template_noop)
"d" = (/obj/machinery/dna_scannernew,/obj/effect/turf_decal/tile/blue{dir = 1},/obj/effect/turf_decal/tile/blue,/obj/effect/turf_decal/tile/blue{dir = 4},/obj/effect/turf_decal/tile/blue{dir = 8},/turf/open/floor/plasteel/white,/area/template_noop)
"e" = (/obj/machinery/computer/prototype_cloning,/obj/machinery/light{dir = 1},/obj/item/paper/fluff/ruins/exp_cloning/manual,/obj/effect/turf_decal/tile/blue{dir = 1},/obj/effect/turf_decal/tile/blue,/obj/effect/turf_decal/tile/blue{dir = 4},/obj/effect/turf_decal/tile/blue{dir = 8},/obj/effect/decal/cleanable/cobweb/cobweb2,/turf/open/floor/plasteel/white,/area/template_noop)
"f" = (/obj/effect/turf_decal/tile/blue{dir = 1},/obj/effect/turf_decal/tile/blue{dir = 4},/turf/open/floor/plasteel/white,/area/template_noop)
"g" = (/obj/structure/chair{dir = 1},/obj/effect/turf_decal/tile/blue{dir = 1},/obj/effect/turf_decal/tile/blue{dir = 4},/turf/open/floor/plasteel/white,/area/template_noop)
"h" = (/obj/effect/turf_decal/tile/blue{dir = 1},/turf/open/floor/plasteel/white,/area/template_noop)
"i" = (/obj/item/reagent_containers/food/drinks/bottle/synthflesh,/obj/item/reagent_containers/food/drinks/bottle/synthflesh,/obj/structure/closet,/turf/open/floor/plasteel/white,/area/template_noop)
"j" = (/turf/open/floor/plasteel/white,/area/template_noop)

(1,1,1) = {"
abcde
fgcgh
ijjjj
"}
