//MAP CONVERTED BY dmm2tgm.py THIS HEADER COMMENT PREVENTS RECONVERSION, DO NOT REMOVE
"aa" = (
/turf/template_noop,
/area/template_noop)
"ab" = (
/obj/structure/grille,
/obj/structure/window/shuttle,
/turf/open/floor/plating,
/area/shuttle/exploration)
"ac" = (
/turf/closed/wall/mineral/titanium,
/area/shuttle/exploration)
"ad" = (
/obj/docking_port/stationary{
	dir = 4
	},
/obj/machinery/door/airlock/external/glass,
/obj/machinery/atmospherics/pipe/simple/dark/hidden{
	dir = 6
	},
/obj/docking_port/mobile{
	dir = 4
	},
/turf/open/floor/mineral/plastitanium,
/area/shuttle/exploration)
"ae" = (
/obj/machinery/atmospherics/pipe/simple/dark/hidden{
	dir = 1
	},
/turf/closed/wall/mineral/titanium,
/area/shuttle/exploration)
"af" = (
/obj/machinery/atmospherics/pipe/simple/dark/hidden{
	dir = 5
	},
/turf/closed/wall/mineral/titanium/nodiagonal,
/area/shuttle/exploration)
"ag" = (
/obj/structure/fans/tiny,
/obj/machinery/door/poddoor/shutters,
/obj/machinery/button/door{
	pixel_y = 24
	},
/turf/open/floor/mineral/titanium,
/area/shuttle/exploration)
"ah" = (
/obj/structure/fans/tiny,
/obj/machinery/door/poddoor/shutters,
/turf/open/floor/mineral/titanium,
/area/shuttle/exploration)
"ai" = (
/turf/closed/wall/mineral/plastitanium,
/area/shuttle/exploration)
"aj" = (
/obj/structure/table,
/obj/machinery/recharger,
/turf/open/floor/mineral/plastitanium,
/area/shuttle/exploration)
"ak" = (
/turf/closed/wall/mineral/titanium/nodiagonal,
/area/shuttle/exploration)
"al" = (
/obj/structure/closet/emcloset/anchored,
/obj/item/tank/internals/air,
/obj/item/clothing/mask/breath,
/obj/item/clothing/suit/space/hardsuit/skinsuit,
/obj/machinery/advanced_airlock_controller/directional/east{
	req_access_txt = "24"
	},
/obj/machinery/light/small{
	dir = 1
	},
/turf/open/floor/mineral/plastitanium,
/area/shuttle/exploration)
"am" = (
/obj/machinery/atmospherics/components/binary/dp_vent_pump{
	dir = 8
	},
/turf/open/floor/mineral/plastitanium,
/area/shuttle/exploration)
"an" = (
/obj/machinery/atmospherics/components/unary/tank/air{
	dir = 4
	},
/turf/open/floor/mineral/plastitanium,
/area/shuttle/exploration)
"ao" = (
/obj/machinery/atmospherics/pipe/simple/dark/hidden{
	dir = 4
	},
/turf/closed/wall/mineral/titanium/nodiagonal,
/area/shuttle/exploration)
"ap" = (
/obj/machinery/power/apc/auto_name/north{
	req_access_txt = "11";
	dir = 2
	},
/obj/structure/cable/yellow{
	icon_state = "0-4"
	},
/obj/machinery/power/terminal{
	dir = 1
	},
/turf/open/floor/mineral/titanium,
/area/shuttle/exploration)
"aq" = (
/obj/structure/closet/crate/science,
/obj/item/circuitboard/computer/exploration_shuttle,
/obj/item/stack/sheet/mineral/plasma/five,
/turf/open/floor/mineral/titanium,
/area/shuttle/exploration)
"ar" = (
/obj/machinery/atmospherics/components/unary/portables_connector/visible{
	dir = 4
	},
/turf/open/floor/mineral/titanium,
/area/shuttle/exploration)
"as" = (
/turf/closed/wall/mineral/plastitanium/nodiagonal,
/area/shuttle/exploration)
"at" = (
/obj/machinery/computer/shuttle_flight/custom_shuttle{
	req_access_txt = "49"
	},
/turf/open/floor/mineral/plastitanium,
/area/shuttle/exploration)
"au" = (
/obj/structure/chair/comfy/shuttle{
	dir = 1
	},
/turf/open/floor/mineral/plastitanium,
/area/shuttle/exploration)
"av" = (
/obj/machinery/door/airlock/external/glass,
/obj/machinery/atmospherics/pipe/simple/dark/hidden{
	dir = 10
	},
/turf/open/floor/mineral/plastitanium,
/area/shuttle/exploration)
"aw" = (
/obj/machinery/atmospherics/pipe/manifold/dark/hidden{
	dir = 4
	},
/turf/closed/wall/mineral/titanium/nodiagonal,
/area/shuttle/exploration)
"ax" = (
/obj/machinery/atmospherics/pipe/simple/dark/hidden{
	dir = 9
	},
/turf/closed/wall/mineral/titanium/nodiagonal,
/area/shuttle/exploration)
"ay" = (
/obj/structure/cable/yellow{
	icon_state = "4-8"
	},
/turf/open/floor/mineral/titanium,
/area/shuttle/exploration)
"az" = (
/turf/open/floor/mineral/titanium,
/area/shuttle/exploration)
"aA" = (
/obj/machinery/atmospherics/pipe/manifold/purple/visible{
	dir = 1
	},
/turf/open/floor/mineral/titanium,
/area/shuttle/exploration)
"aB" = (
/obj/structure/window/reinforced/survival_pod{
	dir = 1
	},
/obj/machinery/atmospherics/components/unary/shuttle/heater{
	dir = 1
	},
/turf/open/floor/plating,
/area/shuttle/exploration)
"aC" = (
/obj/machinery/shuttle/engine/plasma{
	dir = 1
	},
/turf/open/floor/plating,
/area/shuttle/exploration)
"aD" = (
/turf/open/floor/mineral/plastitanium,
/area/shuttle/exploration)
"aE" = (
/obj/machinery/door/airlock/shuttle,
/obj/machinery/door/firedoor/border_only,
/obj/machinery/door/firedoor/border_only{
	dir = 1
	},
/turf/open/floor/mineral/plastitanium,
/area/shuttle/exploration)
"aF" = (
/obj/machinery/telecomms/relay/preset/exploration{
	autolinkers = list()
	},
/turf/open/floor/mineral/titanium,
/area/shuttle/exploration)
"aG" = (
/obj/structure/cable/yellow{
	icon_state = "2-8"
	},
/turf/open/floor/mineral/titanium,
/area/shuttle/exploration)
"aH" = (
/obj/structure/cable/yellow{
	icon_state = "0-1"
	},
/turf/open/floor/plating,
/area/shuttle/exploration)
"aI" = (
/obj/machinery/atmospherics/pipe/manifold/purple/visible{
	dir = 1
	},
/obj/machinery/power/port_gen/pacman,
/turf/open/floor/mineral/titanium,
/area/shuttle/exploration)
"aJ" = (
/obj/machinery/computer/objective,
/turf/open/floor/mineral/plastitanium,
/area/shuttle/exploration)
"aK" = (
/obj/machinery/holopad,
/turf/open/floor/mineral/titanium,
/area/shuttle/exploration)
"aL" = (
/mob/living/simple_animal/chicken/turkey{
	pixel_x = -6;
	pixel_y = 6
	},
/turf/open/floor/mineral/titanium,
/area/shuttle/exploration)
"aM" = (
/obj/machinery/door/airlock/shuttle,
/obj/machinery/door/firedoor/border_only,
/obj/machinery/door/firedoor/border_only{
	dir = 1
	},
/turf/open/floor/mineral/titanium,
/area/shuttle/exploration)
"aN" = (
/obj/machinery/atmospherics/pipe/manifold/purple/visible{
	dir = 1
	},
/obj/structure/closet/crate,
/obj/item/radio/headset/headset_exploration,
/obj/item/radio/headset/headset_exploration,
/obj/item/wrench,
/obj/item/pickaxe,
/obj/item/mining_scanner,
/turf/open/floor/mineral/titanium,
/area/shuttle/exploration)
"aO" = (
/obj/structure/table,
/obj/item/storage/toolbox/mechanical,
/obj/item/screwdriver,
/obj/item/wrench,
/obj/item/weldingtool,
/obj/item/crowbar,
/obj/item/analyzer,
/obj/item/wirecutters,
/obj/item/multitool,
/obj/item/gps/mining,
/turf/open/floor/mineral/plastitanium,
/area/shuttle/exploration)
"aP" = (
/obj/structure/chair/comfy/shuttle{
	dir = 8
	},
/obj/machinery/light/small{
	dir = 4
	},
/turf/open/floor/mineral/titanium,
/area/shuttle/exploration)
"aQ" = (
/obj/structure/chair/comfy/shuttle{
	dir = 8
	},
/turf/open/floor/mineral/titanium,
/area/shuttle/exploration)
"aR" = (
/obj/machinery/light/small{
	dir = 1
	},
/turf/open/floor/mineral/titanium,
/area/shuttle/exploration)
"aS" = (
/obj/machinery/portable_atmospherics/canister,
/turf/open/floor/mineral/titanium,
/area/shuttle/exploration)
"aT" = (
/obj/machinery/atmospherics/components/unary/plasma_refiner{
	dir = 8
	},
/turf/open/floor/mineral/titanium,
/area/shuttle/exploration)

(1,1,1) = {"
aa
aa
aa
aa
aa
aa
aa
aa
aa
aa
aa
aa
aa
aa
aa
"}
(2,1,1) = {"
aa
aa
aa
aa
aa
aa
aa
aa
aa
aa
aa
aa
aa
aa
aa
"}
(3,1,1) = {"
aa
aa
aa
ab
ab
ac
ac
ad
ae
af
ag
ah
ac
ai
aa
"}
(4,1,1) = {"
aa
aa
ab
ab
aj
ak
al
am
an
ao
ap
aq
ar
as
ai
"}
(5,1,1) = {"
aa
aa
ab
at
au
ak
ak
av
aw
ax
ay
az
aA
aB
aC
"}
(6,1,1) = {"
aa
aa
ab
aD
aD
aE
az
az
aF
ab
aG
aH
aI
aB
aC
"}
(7,1,1) = {"
aa
aa
ab
aJ
au
ak
az
aK
aL
aM
az
az
aN
aB
aC
"}
(8,1,1) = {"
aa
aa
ab
ab
aO
ak
aP
aQ
aP
ak
aR
aS
aT
as
ai
"}
(9,1,1) = {"
aa
aa
aa
ab
ab
ac
ac
ab
ac
ak
ag
ah
ac
ai
aa
"}
(10,1,1) = {"
aa
aa
aa
aa
aa
aa
aa
aa
aa
aa
aa
aa
aa
aa
aa
"}
(11,1,1) = {"
aa
aa
aa
aa
aa
aa
aa
aa
aa
aa
aa
aa
aa
aa
aa
"}
(12,1,1) = {"
aa
aa
aa
aa
aa
aa
aa
aa
aa
aa
aa
aa
aa
aa
aa
"}
