//MAP CONVERTED BY dmm2tgm.py THIS HEADER COMMENT PREVENTS RECONVERSION, DO NOT REMOVE
"a" = (
/obj/structure/shuttle/engine/propulsion,
/turf/closed/wall/mineral/titanium,
/area/shuttle/science)
"b" = (
/obj/structure/chair/fancy/shuttle{
	dir = 1
	},
/obj/machinery/atmospherics/pipe/simple/scrubbers/hidden/layer4{
	dir = 4
	},
/obj/machinery/atmospherics/pipe/simple/supply/hidden/layer2,
/turf/open/floor/mineral/titanium/white,
/area/shuttle/science)
"c" = (
/obj/machinery/button/door{
	id = "sciencecargo";
	name = "Cargo Blast Door Toggle";
	pixel_x = -24
	},
/obj/structure/table/reinforced,
/obj/machinery/light{
	dir = 8;
	light_color = "#e8eaff"
	},
/obj/item/storage/toolbox/mechanical,
/obj/item/clothing/glasses/science,
/turf/open/floor/mineral/titanium/purple,
/area/shuttle/science)
"d" = (
/obj/effect/spawner/structure/window/shuttle,
/turf/open/floor/plating,
/area/shuttle/science)
"f" = (
/obj/machinery/atmospherics/pipe/simple/supply/hidden/layer2{
	dir = 4
	},
/turf/closed/wall/mineral/titanium,
/area/shuttle/science)
"g" = (
/obj/machinery/computer/shuttle_flight/science,
/turf/open/floor/mineral/titanium/white,
/area/shuttle/science)
"h" = (
/obj/machinery/light{
	dir = 8;
	light_color = "#e8eaff"
	},
/obj/effect/turf_decal/box,
/turf/open/floor/mineral/titanium/white,
/area/shuttle/science)
"k" = (
/obj/machinery/atmospherics/components/unary/vent_scrubber/on/layer4{
	dir = 8
	},
/obj/machinery/atmospherics/pipe/simple/supply/hidden/layer2{
	dir = 9
	},
/turf/open/floor/mineral/titanium/white,
/area/shuttle/science)
"l" = (
/obj/machinery/atmospherics/components/unary/vent_pump/on/layer2{
	dir = 4
	},
/obj/machinery/atmospherics/pipe/manifold/scrubbers/hidden/layer4{
	dir = 8
	},
/turf/open/floor/mineral/titanium/white,
/area/shuttle/science)
"n" = (
/obj/structure/table/reinforced,
/obj/machinery/light{
	dir = 4
	},
/obj/item/toy/plush/moth/random,
/obj/machinery/atmospherics/pipe/simple/supply/hidden/layer2{
	dir = 4
	},
/turf/open/floor/mineral/titanium/purple,
/area/shuttle/science)
"o" = (
/obj/structure/closet/crate/science,
/obj/item/circuitboard/computer/shuttle/science_shuttle,
/obj/item/stack/sheet/glass,
/obj/item/stack/sheet/glass,
/obj/item/stack/cable_coil/orange,
/obj/item/storage/toolbox/electrical,
/obj/effect/turf_decal/box,
/obj/item/pickaxe/emergency,
/turf/open/floor/mineral/titanium/purple,
/area/shuttle/science)
"r" = (
/obj/machinery/door/airlock/titanium,
/obj/docking_port/mobile{
	dir = 8;
	dwidth = 6;
	height = 6;
	id = "science";
	name = "science shuttle";
	port_direction = 4;
	width = 9
	},
/obj/structure/cable/yellow{
	icon_state = "4-8"
	},
/obj/machinery/atmospherics/pipe/simple/scrubbers/hidden/layer4{
	dir = 4
	},
/turf/open/floor/mineral/titanium/white,
/area/shuttle/science)
"s" = (
/obj/structure/cable/yellow,
/obj/machinery/power/apc/auto_name/east,
/turf/open/floor/mineral/titanium/purple,
/area/shuttle/science)
"t" = (
/turf/closed/wall/mineral/titanium/nodiagonal,
/area/shuttle/science)
"u" = (
/obj/effect/turf_decal/box,
/obj/machinery/portable_atmospherics/canister/air,
/turf/open/floor/mineral/titanium/purple,
/area/shuttle/science)
"v" = (
/obj/machinery/atmospherics/components/unary/vent_scrubber/on/layer4{
	dir = 8
	},
/obj/machinery/atmospherics/pipe/manifold/supply/hidden/layer2{
	dir = 4
	},
/turf/open/floor/mineral/titanium/white,
/area/shuttle/science)
"x" = (
/obj/structure/cable/yellow{
	icon_state = "2-4"
	},
/obj/machinery/atmospherics/pipe/simple/scrubbers/hidden/layer4{
	dir = 4
	},
/turf/open/floor/mineral/titanium/white,
/area/shuttle/science)
"y" = (
/turf/closed/wall/mineral/titanium,
/area/shuttle/science)
"A" = (
/obj/machinery/modular_computer/console/preset/research,
/obj/machinery/atmospherics/pipe/simple/supply/hidden/layer2{
	dir = 6
	},
/turf/open/floor/mineral/titanium/white,
/area/shuttle/science)
"G" = (
/obj/machinery/door/airlock/titanium/glass,
/obj/machinery/atmospherics/pipe/simple/supply/hidden/layer2,
/turf/open/floor/mineral/titanium/white,
/area/shuttle/science)
"H" = (
/obj/machinery/door/poddoor{
	id = "sciencecargo"
	},
/turf/open/floor/mineral/titanium/white,
/area/shuttle/science)
"I" = (
/obj/structure/shuttle/engine/heater,
/turf/closed/wall/mineral/titanium,
/area/shuttle/science)
"J" = (
/obj/effect/turf_decal/box,
/turf/open/floor/mineral/titanium/white,
/area/shuttle/science)
"K" = (
/turf/open/floor/mineral/titanium/purple,
/area/shuttle/science)
"M" = (
/obj/machinery/atmospherics/components/unary/vent_pump/on/layer2{
	dir = 4
	},
/obj/machinery/atmospherics/pipe/simple/scrubbers/hidden/layer4{
	dir = 5
	},
/turf/open/floor/mineral/titanium/white,
/area/shuttle/science)
"N" = (
/obj/structure/tank_dispenser/oxygen,
/turf/open/floor/mineral/titanium/purple,
/area/shuttle/science)
"Q" = (
/obj/structure/chair/fancy/shuttle{
	dir = 1
	},
/obj/machinery/atmospherics/pipe/simple/scrubbers/hidden/layer4{
	dir = 6
	},
/turf/open/floor/mineral/titanium/white,
/area/shuttle/science)
"S" = (
/turf/open/floor/mineral/titanium/white,
/area/shuttle/science)
"T" = (
/obj/machinery/door/airlock/titanium/glass,
/obj/machinery/atmospherics/pipe/simple/scrubbers/hidden/layer4{
	dir = 1
	},
/turf/open/floor/mineral/titanium/white,
/area/shuttle/science)
"W" = (
/obj/machinery/airalarm/unlocked{
	pixel_x = -25;
	dir = 4
	},
/turf/open/floor/mineral/titanium/purple,
/area/shuttle/science)

(1,1,1) = {"
y
y
y
y
y
y
y
I
a
"}
(2,1,1) = {"
d
c
S
W
t
N
h
o
y
"}
(3,1,1) = {"
d
g
Q
l
T
M
J
J
y
"}
(4,1,1) = {"
d
A
b
v
G
k
J
J
y
"}
(5,1,1) = {"
d
n
x
s
t
K
J
u
y
"}
(6,1,1) = {"
y
f
r
y
t
H
H
I
a
"}
