//MAP CONVERTED BY dmm2tgm.py THIS HEADER COMMENT PREVENTS RECONVERSION, DO NOT REMOVE
"aa" = (
/turf/template_noop,
/area/template_noop)
"ac" = (
/obj/effect/spawner/structure/window/reinforced,
/obj/structure/cable/yellow{
	icon_state = "4-8"
	},
/turf/open/floor/plating,
/area/ruin/space/has_grav/abandonedzoo)
"ag" = (
/obj/effect/spawner/structure/window/reinforced,
/turf/open/floor/plating,
/area/ruin/space/has_grav/abandonedzoo)
"ah" = (
/turf/closed/mineral,
/area/ruin/space/has_grav/abandonedzoo)
"ai" = (
/turf/open/floor/plating/asteroid,
/area/ruin/space/has_grav/abandonedzoo)
"aj" = (
/obj/structure/flora/rock,
/turf/open/floor/plating/asteroid,
/area/ruin/space/has_grav/abandonedzoo)
"al" = (
/obj/structure/flora/ausbushes/genericbush,
/turf/open/floor/grass,
/area/ruin/space/has_grav/abandonedzoo)
"am" = (
/mob/living/simple_animal/hostile/poison/bees,
/mob/living/simple_animal/hostile/poison/bees,
/mob/living/simple_animal/hostile/poison/bees,
/mob/living/simple_animal/hostile/poison/bees,
/mob/living/simple_animal/hostile/poison/bees,
/mob/living/simple_animal/hostile/poison/bees,
/turf/open/floor/grass,
/area/ruin/space/has_grav/abandonedzoo)
"an" = (
/mob/living/simple_animal/hostile/poison/bees,
/turf/open/floor/grass,
/area/ruin/space/has_grav/abandonedzoo)
"ao" = (
/obj/structure/flora/ausbushes/lavendergrass,
/turf/open/floor/grass,
/area/ruin/space/has_grav/abandonedzoo)
"ap" = (
/mob/living/simple_animal/hostile/asteroid/goldgrub{
	will_burrow = 0
	},
/turf/open/floor/plating/asteroid,
/area/ruin/space/has_grav/abandonedzoo)
"aq" = (
/obj/structure/flora/ausbushes/grassybush,
/turf/open/floor/grass,
/area/ruin/space/has_grav/abandonedzoo)
"ar" = (
/obj/structure/flora/rock/pile,
/turf/open/floor/plating/asteroid,
/area/ruin/space/has_grav/abandonedzoo)
"as" = (
/mob/living/simple_animal/hostile/asteroid/basilisk,
/turf/open/floor/plating/asteroid,
/area/ruin/space/has_grav/abandonedzoo)
"at" = (
/turf/closed/wall/r_wall,
/area/ruin/space/has_grav/abandonedzoo)
"au" = (
/obj/structure/flora/ausbushes/leafybush,
/mob/living/simple_animal/hostile/poison/bees,
/turf/open/floor/grass,
/area/ruin/space/has_grav/abandonedzoo)
"av" = (
/obj/structure/flora/ausbushes/brflowers,
/turf/open/floor/grass,
/area/ruin/space/has_grav/abandonedzoo)
"aA" = (
/obj/structure/flora/ausbushes/ywflowers,
/turf/open/floor/grass,
/area/ruin/space/has_grav/abandonedzoo)
"aC" = (
/obj/structure/flora/ausbushes/ppflowers,
/turf/open/floor/grass,
/area/ruin/space/has_grav/abandonedzoo)
"aD" = (
/obj/machinery/door/airlock/highsecurity{
	name = "Bio Containment";
	req_one_access_txt = "47"
	},
/obj/structure/cable/yellow{
	icon_state = "2-8"
	},
/obj/structure/cable/yellow{
	icon_state = "2-4"
	},
/turf/open/floor/iron/dark/side,
/area/ruin/space/has_grav/abandonedzoo)
"aG" = (
/obj/structure/table/reinforced,
/obj/item/gun/energy/floragun,
/turf/open/floor/iron/dark/side,
/area/ruin/space/has_grav/abandonedzoo)
"aI" = (
/obj/structure/table/reinforced,
/obj/machinery/computer/records/medical/laptop{
	dir = 8;
	pixel_y = 1
	},
/turf/open/floor/iron/dark/side,
/area/ruin/space/has_grav/abandonedzoo)
"aL" = (
/obj/structure/cable/yellow{
	icon_state = "1-2"
	},
/turf/open/floor/iron/dark/side,
/area/ruin/space/has_grav/abandonedzoo)
"aN" = (
/obj/structure/table/reinforced,
/obj/item/folder,
/turf/open/floor/iron/dark/side,
/area/ruin/space/has_grav/abandonedzoo)
"aS" = (
/obj/machinery/power/apc/unlocked{
	dir = 8;
	environ = 0;
	equipment = 0;
	lighting = 0;
	name = "Worn-out APC";
	pixel_x = -25
	},
/obj/structure/rack,
/obj/item/melee/baton/security/cattleprod,
/obj/effect/spawner/random/maintenance,
/obj/structure/cable/yellow{
	icon_state = "0-2"
	},
/turf/open/floor/iron/dark/side,
/area/ruin/space/has_grav/abandonedzoo)
"aT" = (
/obj/structure/rack,
/obj/item/clothing/suit/space/hardsuit/medical,
/obj/item/tank/internals/emergency_oxygen/double,
/turf/open/floor/iron/dark/side,
/area/ruin/space/has_grav/abandonedzoo)
"aV" = (
/obj/machinery/smartfridge/chemistry,
/turf/open/floor/iron/dark/side,
/area/ruin/space/has_grav/abandonedzoo)
"aW" = (
/obj/structure/table/reinforced,
/obj/item/gun/syringe,
/turf/open/floor/iron/dark/side,
/area/ruin/space/has_grav/abandonedzoo)
"aY" = (
/obj/structure/table/reinforced,
/obj/item/gun/energy/temperature{
	pin = /obj/item/firing_pin
	},
/turf/open/floor/iron/dark/side,
/area/ruin/space/has_grav/abandonedzoo)
"aZ" = (
/obj/structure/table/reinforced,
/obj/item/cultivator,
/obj/item/shovel,
/turf/open/floor/iron/dark/side,
/area/ruin/space/has_grav/abandonedzoo)
"be" = (
/obj/structure/reagent_dispensers/fueltank,
/obj/structure/cable/yellow{
	icon_state = "1-4"
	},
/turf/open/floor/iron/dark/side,
/area/ruin/space/has_grav/abandonedzoo)
"bf" = (
/obj/machinery/power/smes/magical{
	desc = "A high-capacity superconducting magnetic energy storage (SMES) unit.";
	name = "power storage unit"
	},
/obj/structure/cable/yellow{
	icon_state = "0-4"
	},
/obj/structure/cable/yellow{
	icon_state = "0-8"
	},
/turf/open/floor/iron/dark/side,
/area/ruin/space/has_grav/abandonedzoo)
"bh" = (
/obj/machinery/disposal/bin,
/obj/structure/disposalpipe/trunk,
/turf/open/floor/iron/dark/side,
/area/ruin/space/has_grav/abandonedzoo)
"bk" = (
/obj/structure/table/optable,
/turf/open/floor/iron/dark/side,
/area/ruin/space/has_grav/abandonedzoo)
"bl" = (
/obj/machinery/computer/operating{
	dir = 8
	},
/turf/open/floor/iron/dark/side,
/area/ruin/space/has_grav/abandonedzoo)
"bm" = (
/obj/structure/closet/wardrobe/science_white,
/obj/structure/disposalpipe/segment,
/turf/open/floor/iron/dark/side,
/area/ruin/space/has_grav/abandonedzoo)
"bn" = (
/obj/structure/table/reinforced,
/obj/item/food/carrotfries,
/turf/open/floor/iron/dark/side,
/area/ruin/space/has_grav/abandonedzoo)
"bp" = (
/obj/structure/bed,
/obj/item/bedsheet/green,
/obj/structure/disposalpipe/segment,
/turf/open/floor/iron/dark/side,
/area/ruin/space/has_grav/abandonedzoo)
"br" = (
/obj/structure/table/reinforced,
/obj/machinery/microwave,
/turf/open/floor/iron/dark/side,
/area/ruin/space/has_grav/abandonedzoo)
"bt" = (
/obj/machinery/light/directional/south,
/mob/living/simple_animal/hostile/poison/bees,
/turf/open/floor/grass,
/area/ruin/space/has_grav/abandonedzoo)
"bu" = (
/obj/structure/flora/ausbushes/sunnybush,
/turf/open/floor/plating,
/area/ruin/space/has_grav/abandonedzoo)
"bv" = (
/turf/open/floor/plating,
/area/ruin/space/has_grav/abandonedzoo)
"bx" = (
/obj/structure/flora/ausbushes/palebush,
/turf/open/floor/plating,
/area/ruin/space/has_grav/abandonedzoo)
"by" = (
/obj/structure/disposalpipe/segment{
	dir = 6
	},
/turf/closed/wall/r_wall,
/area/ruin/space/has_grav/abandonedzoo)
"bA" = (
/obj/structure/table/reinforced,
/obj/machinery/reagentgrinder,
/turf/open/floor/iron/dark/side,
/area/ruin/space/has_grav/abandonedzoo)
"bB" = (
/obj/structure/alien/weeds,
/turf/open/floor/plating/airless,
/area/ruin/space/has_grav/abandonedzoo)
"bD" = (
/obj/item/clothing/mask/facehugger/dead,
/turf/open/floor/plating/airless,
/area/ruin/space/has_grav/abandonedzoo)
"bE" = (
/obj/structure/flora/ausbushes/sparsegrass,
/turf/open/floor/plating,
/area/ruin/space/has_grav/abandonedzoo)
"bF" = (
/obj/structure/disposalpipe/segment,
/turf/closed/wall/r_wall,
/area/ruin/space/has_grav/abandonedzoo)
"bH" = (
/obj/structure/alien/resin/wall,
/turf/open/floor/plating/airless,
/area/ruin/space/has_grav/abandonedzoo)
"bI" = (
/obj/structure/flora/ausbushes/reedbush,
/turf/open/floor/plating,
/area/ruin/space/has_grav/abandonedzoo)
"bJ" = (
/mob/living/simple_animal/crab{
	faction = list("carp")
	},
/turf/open/floor/plating,
/area/ruin/space/has_grav/abandonedzoo)
"bN" = (
/obj/structure/grille/broken,
/obj/item/stack/cable_coil/cut/yellow,
/obj/item/shard{
	icon_state = "small"
	},
/turf/open/floor/plating/airless,
/area/ruin/space/has_grav/abandonedzoo)
"bO" = (
/obj/item/shard,
/turf/open/floor/plating/airless,
/area/ruin/space/has_grav/abandonedzoo)
"bT" = (
/obj/structure/grille,
/obj/item/shard{
	icon_state = "medium"
	},
/turf/open/floor/plating/airless,
/area/ruin/space/has_grav/abandonedzoo)
"bU" = (
/obj/structure/grille/broken,
/turf/open/floor/plating/airless,
/area/ruin/space/has_grav/abandonedzoo)
"bW" = (
/obj/item/shard,
/turf/template_noop,
/area/template_noop)
"bX" = (
/turf/open/floor/plating/airless,
/area/ruin/space/has_grav/abandonedzoo)
"ct" = (
/obj/structure/window/reinforced/spawner/directional/west,
/turf/template_noop,
/area/misc/space/nearstation)
"cu" = (
/obj/machinery/power/shieldwallgen/anchored,
/obj/structure/cable/yellow{
	icon_state = "0-8"
	},
/obj/structure/cable/yellow{
	icon_state = "2-8"
	},
/turf/open/floor/plating/airless,
/area/ruin/space/has_grav/abandonedzoo)
"cT" = (
/obj/machinery/power/shieldwallgen,
/turf/template_noop,
/area/template_noop)
"dE" = (
/obj/machinery/light/small/directional/west,
/obj/effect/turf_decal/tile/green/fourcorners/contrasted,
/turf/open/floor/iron/dark,
/area/ruin/space/has_grav/abandonedzoo)
"dP" = (
/obj/machinery/light/directional/north,
/mob/living/simple_animal/hostile/carp,
/turf/open/floor/plating,
/area/ruin/space/has_grav/abandonedzoo)
"em" = (
/obj/structure/chair/office/light{
	dir = 8
	},
/obj/effect/turf_decal/tile/green/fourcorners/contrasted,
/turf/open/floor/iron/dark,
/area/ruin/space/has_grav/abandonedzoo)
"eY" = (
/obj/structure/cable/yellow{
	icon_state = "2-4"
	},
/obj/structure/cable/yellow{
	icon_state = "1-4"
	},
/turf/open/floor/iron/dark/side,
/area/ruin/space/has_grav/abandonedzoo)
"hp" = (
/obj/machinery/power/shieldwallgen/anchored,
/obj/structure/cable/yellow{
	icon_state = "2-8"
	},
/obj/structure/cable/yellow{
	icon_state = "0-8"
	},
/turf/open/floor/plating,
/area/ruin/space/has_grav/abandonedzoo)
"if" = (
/obj/machinery/power/shieldwallgen/anchored,
/obj/structure/cable/yellow{
	icon_state = "1-8"
	},
/obj/structure/cable/yellow{
	icon_state = "0-8"
	},
/turf/open/floor/plating,
/area/ruin/space/has_grav/abandonedzoo)
"in" = (
/obj/structure/table/reinforced,
/obj/item/storage/box/syringes{
	pixel_x = 5;
	pixel_y = 5
	},
/obj/item/storage/box/beakers,
/obj/machinery/light/directional/east,
/turf/open/floor/iron/dark/side,
/area/ruin/space/has_grav/abandonedzoo)
"iM" = (
/obj/structure/disposalpipe/trunk{
	dir = 1
	},
/obj/structure/disposaloutlet,
/turf/open/floor/plating/airless,
/area/misc/space/nearstation)
"kh" = (
/obj/structure/alien/weeds/node,
/obj/machinery/light/directional/north,
/turf/open/floor/plating/airless,
/area/ruin/space/has_grav/abandonedzoo)
"kj" = (
/obj/effect/spawner/structure/window/reinforced,
/obj/structure/cable/yellow{
	icon_state = "1-2"
	},
/turf/open/floor/plating,
/area/ruin/space/has_grav/abandonedzoo)
"lE" = (
/obj/machinery/power/shieldwallgen/anchored,
/obj/structure/cable/yellow{
	icon_state = "2-8"
	},
/obj/structure/cable/yellow{
	icon_state = "0-8"
	},
/turf/open/floor/plating/airless,
/area/ruin/space/has_grav/abandonedzoo)
"ov" = (
/obj/effect/turf_decal/tile/green/fourcorners/contrasted,
/turf/open/floor/iron/dark,
/area/ruin/space/has_grav/abandonedzoo)
"oM" = (
/obj/machinery/power/shieldwallgen/anchored,
/obj/structure/cable/yellow{
	icon_state = "0-4"
	},
/obj/structure/cable/yellow{
	icon_state = "2-4"
	},
/turf/open/floor/plating/airless,
/area/ruin/space/has_grav/abandonedzoo)
"ss" = (
/obj/structure/flora/rock,
/obj/machinery/light/directional/south,
/turf/open/floor/plating/asteroid,
/area/ruin/space/has_grav/abandonedzoo)
"sC" = (
/obj/structure/cable/yellow{
	icon_state = "1-8"
	},
/obj/structure/cable/yellow{
	icon_state = "2-8"
	},
/turf/open/floor/iron/dark/side,
/area/ruin/space/has_grav/abandonedzoo)
"tt" = (
/obj/structure/table/reinforced,
/obj/item/reagent_containers/hypospray/medipen/stimpack,
/obj/item/reagent_containers/cup/bottle/mutagen,
/turf/open/floor/iron/dark/side,
/area/ruin/space/has_grav/abandonedzoo)
"tx" = (
/obj/structure/table/reinforced,
/obj/item/surgicaldrill,
/obj/item/hemostat,
/obj/item/scalpel,
/obj/item/surgical_drapes,
/obj/item/retractor,
/obj/item/cautery,
/obj/item/circular_saw,
/obj/machinery/light/directional/south,
/turf/open/floor/iron/dark/side,
/area/ruin/space/has_grav/abandonedzoo)
"uc" = (
/obj/machinery/power/terminal,
/obj/effect/turf_decal/tile/green/fourcorners/contrasted,
/turf/open/floor/iron/dark,
/area/ruin/space/has_grav/abandonedzoo)
"vm" = (
/obj/structure/cable/yellow{
	icon_state = "1-2"
	},
/obj/effect/turf_decal/tile/green/fourcorners/contrasted,
/turf/open/floor/iron/dark,
/area/ruin/space/has_grav/abandonedzoo)
"vA" = (
/obj/machinery/door/airlock/hatch{
	name = "Bio-Research Station"
	},
/obj/effect/turf_decal/tile/green/fourcorners/contrasted,
/turf/open/floor/iron/dark,
/area/ruin/space/has_grav/abandonedzoo)
"wF" = (
/obj/machinery/power/shieldwallgen,
/obj/structure/cable/yellow{
	icon_state = "2-4"
	},
/obj/structure/cable/yellow{
	icon_state = "0-4"
	},
/turf/open/floor/plating,
/area/ruin/space/has_grav/abandonedzoo)
"wR" = (
/obj/structure/table/reinforced,
/obj/item/clipboard,
/obj/item/clothing/mask/surgical,
/obj/item/razor,
/obj/machinery/light/directional/west,
/turf/open/floor/iron/dark/side,
/area/ruin/space/has_grav/abandonedzoo)
"zd" = (
/obj/machinery/door/airlock/hatch{
	name = "Bio-Research Station"
	},
/obj/structure/cable/yellow{
	icon_state = "4-8"
	},
/obj/effect/turf_decal/tile/green/fourcorners/contrasted,
/turf/open/floor/iron/dark,
/area/ruin/space/has_grav/abandonedzoo)
"Af" = (
/obj/structure/window/reinforced/spawner/directional/east,
/turf/template_noop,
/area/misc/space/nearstation)
"Al" = (
/obj/machinery/power/shieldwallgen/anchored,
/obj/structure/cable/yellow{
	icon_state = "1-4"
	},
/obj/structure/cable/yellow{
	icon_state = "0-4"
	},
/turf/open/floor/plating/airless,
/area/ruin/space/has_grav/abandonedzoo)
"AX" = (
/obj/machinery/door/airlock/highsecurity{
	name = "Bio Containment";
	req_one_access_txt = "47"
	},
/obj/structure/cable/yellow{
	icon_state = "1-8"
	},
/obj/structure/cable/yellow{
	icon_state = "1-4"
	},
/turf/open/floor/iron/dark/side,
/area/ruin/space/has_grav/abandonedzoo)
"Bn" = (
/obj/machinery/power/shieldwallgen,
/obj/structure/cable/yellow{
	icon_state = "2-8"
	},
/obj/structure/cable/yellow{
	icon_state = "0-8"
	},
/turf/open/floor/plating/airless,
/area/ruin/space/has_grav/abandonedzoo)
"BQ" = (
/obj/structure/disposalpipe/segment,
/turf/open/floor/plating/airless,
/area/misc/space/nearstation)
"Cn" = (
/obj/machinery/light/small/directional/east,
/obj/effect/turf_decal/tile/green/fourcorners/contrasted,
/turf/open/floor/iron/dark,
/area/ruin/space/has_grav/abandonedzoo)
"Do" = (
/obj/machinery/door/airlock/external,
/obj/effect/mapping_helpers/airlock/cyclelink_helper{
	dir = 1
	},
/obj/effect/turf_decal/tile/green/fourcorners/contrasted,
/turf/open/floor/iron/dark,
/area/ruin/space/has_grav/abandonedzoo)
"Eg" = (
/obj/structure/rack,
/obj/item/crowbar,
/obj/item/shield/riot,
/obj/machinery/light/directional/north,
/turf/open/floor/iron/dark/side,
/area/ruin/space/has_grav/abandonedzoo)
"Ew" = (
/turf/template_noop,
/area/misc/space/nearstation)
"FJ" = (
/obj/structure/cable/yellow{
	icon_state = "4-8"
	},
/obj/effect/turf_decal/tile/green/fourcorners/contrasted,
/turf/open/floor/iron/dark,
/area/ruin/space/has_grav/abandonedzoo)
"Gn" = (
/obj/machinery/power/shieldwallgen/anchored,
/obj/structure/cable/yellow{
	icon_state = "0-4"
	},
/obj/structure/cable/yellow{
	icon_state = "1-4"
	},
/turf/open/floor/plating/airless,
/area/ruin/space/has_grav/abandonedzoo)
"GU" = (
/obj/structure/lattice,
/turf/template_noop,
/area/misc/space/nearstation)
"Hx" = (
/obj/machinery/door/airlock/highsecurity{
	name = "Bio Containment";
	req_one_access_txt = "47"
	},
/obj/structure/cable/yellow{
	icon_state = "2-4"
	},
/obj/structure/cable/yellow{
	icon_state = "2-8"
	},
/turf/open/floor/iron/dark/side,
/area/ruin/space/has_grav/abandonedzoo)
"HN" = (
/obj/structure/cable/yellow{
	icon_state = "2-8"
	},
/obj/structure/cable/yellow{
	icon_state = "1-2"
	},
/obj/effect/turf_decal/tile/green/fourcorners/contrasted,
/turf/open/floor/iron/dark,
/area/ruin/space/has_grav/abandonedzoo)
"IR" = (
/obj/machinery/light/small/directional/east,
/obj/structure/cable/yellow{
	icon_state = "1-2"
	},
/turf/open/floor/iron/dark/side,
/area/ruin/space/has_grav/abandonedzoo)
"KF" = (
/obj/structure/table/reinforced,
/obj/item/reagent_containers/cup/bottle/random_virus,
/obj/item/reagent_containers/dropper,
/turf/open/floor/iron/dark/side,
/area/ruin/space/has_grav/abandonedzoo)
"LY" = (
/obj/machinery/power/shieldwallgen/anchored,
/obj/structure/cable/yellow{
	icon_state = "1-8"
	},
/obj/structure/cable/yellow{
	icon_state = "0-8"
	},
/turf/open/floor/plating/airless,
/area/ruin/space/has_grav/abandonedzoo)
"Nn" = (
/obj/machinery/power/shieldwallgen/anchored,
/obj/structure/cable/yellow{
	icon_state = "2-4"
	},
/obj/structure/cable/yellow{
	icon_state = "0-4"
	},
/turf/open/floor/plating/airless,
/area/ruin/space/has_grav/abandonedzoo)
"Ph" = (
/obj/machinery/door/airlock/external,
/obj/effect/mapping_helpers/airlock/cyclelink_helper,
/obj/effect/turf_decal/tile/green/fourcorners/contrasted,
/turf/open/floor/iron/dark,
/area/ruin/space/has_grav/abandonedzoo)
"Pw" = (
/obj/structure/cable/yellow{
	icon_state = "1-4"
	},
/obj/machinery/power/shieldwallgen,
/obj/structure/cable/yellow{
	icon_state = "0-4"
	},
/turf/open/floor/plating/airless,
/area/ruin/space/has_grav/abandonedzoo)
"PR" = (
/obj/machinery/light/small/directional/west,
/obj/structure/cable/yellow{
	icon_state = "1-2"
	},
/turf/open/floor/iron/dark/side,
/area/ruin/space/has_grav/abandonedzoo)
"Rp" = (
/obj/machinery/power/shieldwallgen/anchored,
/obj/structure/cable/yellow{
	icon_state = "1-4"
	},
/obj/structure/cable/yellow{
	icon_state = "0-4"
	},
/turf/open/floor/plating,
/area/ruin/space/has_grav/abandonedzoo)
"RL" = (
/obj/structure/reagent_dispensers/watertank,
/obj/machinery/light/directional/south,
/obj/structure/cable/yellow{
	icon_state = "1-8"
	},
/turf/open/floor/iron/dark/side,
/area/ruin/space/has_grav/abandonedzoo)
"Vo" = (
/obj/structure/table/reinforced,
/obj/item/grenade/chem_grenade/antiweed{
	pixel_x = 3;
	pixel_y = 5
	},
/obj/item/grenade/chem_grenade/antiweed{
	pixel_x = 4
	},
/obj/item/grenade/chem_grenade/antiweed{
	pixel_x = -3;
	pixel_y = -1
	},
/obj/machinery/light/directional/north,
/turf/open/floor/iron/dark/side,
/area/ruin/space/has_grav/abandonedzoo)
"VW" = (
/obj/machinery/door/airlock/highsecurity{
	name = "Bio Containment";
	req_one_access_txt = "47"
	},
/obj/structure/cable/yellow{
	icon_state = "1-4"
	},
/obj/structure/cable/yellow{
	icon_state = "1-8"
	},
/turf/open/floor/iron/dark/side,
/area/ruin/space/has_grav/abandonedzoo)
"XP" = (
/obj/structure/cable/yellow{
	icon_state = "2-4"
	},
/obj/effect/turf_decal/tile/green/fourcorners/contrasted,
/turf/open/floor/iron/dark,
/area/ruin/space/has_grav/abandonedzoo)
"Zd" = (
/obj/machinery/portable_thermomachine,
/obj/structure/disposalpipe/segment{
	dir = 9
	},
/obj/machinery/light/directional/west,
/turf/open/floor/iron/dark/side,
/area/ruin/space/has_grav/abandonedzoo)
"Zz" = (
/obj/machinery/light/small/directional/west,
/obj/item/stack/cable_coil/cut/yellow,
/obj/item/stack/tile/iron{
	pixel_x = 3;
	pixel_y = -4
	},
/obj/item/wirecutters,
/turf/open/floor/plating,
/area/ruin/space/has_grav/abandonedzoo)

(1,1,1) = {"
oM
kj
kj
kj
kj
Gn
aa
aa
aa
aa
aa
aa
Nn
kj
kj
kj
kj
Al
aa
"}
(2,1,1) = {"
ac
ah
ai
ar
ah
ac
Af
Af
Af
Af
Af
Af
ac
bu
bv
bI
bv
ac
aa
"}
(3,1,1) = {"
ac
ah
ap
ai
ai
aD
aL
IR
aL
eY
IR
aL
VW
bv
bv
bJ
bv
ac
aa
"}
(4,1,1) = {"
ac
ai
ah
ai
ss
ac
at
at
vA
zd
at
at
ac
dP
bv
bv
bv
ac
aa
"}
(5,1,1) = {"
ac
aj
ai
as
ar
ac
at
aS
vm
HN
be
at
ac
bx
bE
bv
bv
ac
aa
"}
(6,1,1) = {"
lE
kj
kj
kj
kj
if
at
aT
ov
uc
bf
at
hp
kj
kj
kj
kj
LY
aa
"}
(7,1,1) = {"
aa
aa
aa
at
at
at
at
Eg
ov
XP
RL
at
at
by
bF
BQ
BQ
iM
aa
"}
(8,1,1) = {"
aa
aa
aa
ag
wR
aG
aN
aV
ov
FJ
bh
bm
bp
Zd
at
at
at
aa
aa
"}
(9,1,1) = {"
aa
aa
aa
ag
ov
ov
em
ov
ov
FJ
ov
ov
ov
ov
Ph
dE
Do
aa
aa
"}
(10,1,1) = {"
aa
aa
aa
ag
ov
ov
ov
ov
ov
FJ
ov
ov
ov
ov
Ph
Cn
Do
aa
aa
"}
(11,1,1) = {"
aa
aa
aa
ag
in
aI
KF
aW
ov
FJ
tt
bn
br
bA
at
at
at
aa
aa
"}
(12,1,1) = {"
aa
aa
aa
at
at
at
at
Vo
ov
FJ
tx
at
at
at
at
aa
aa
aa
aa
"}
(13,1,1) = {"
Nn
kj
kj
kj
kj
Rp
at
aY
ov
FJ
bk
at
wF
kj
kj
kj
kj
Pw
aa
"}
(14,1,1) = {"
ac
al
an
an
aA
ac
at
aZ
ov
FJ
bl
at
ac
bB
bB
bD
bH
ac
aa
"}
(15,1,1) = {"
ac
am
am
ao
bt
ac
at
at
vA
zd
at
at
ac
kh
bH
bH
bX
bT
aa
"}
(16,1,1) = {"
ac
an
aq
au
am
Hx
aL
PR
aL
sC
Zz
aL
AX
bD
bB
bX
bO
bU
bW
"}
(17,1,1) = {"
ac
ao
an
av
aC
ac
ct
ct
ct
ct
ct
ct
ac
bB
bB
bX
bX
GU
aa
"}
(18,1,1) = {"
cu
kj
kj
kj
kj
LY
aa
aa
aa
aa
aa
aa
Bn
kj
kj
bN
GU
Ew
aa
"}
(19,1,1) = {"
aa
aa
aa
aa
aa
aa
aa
aa
aa
aa
aa
aa
aa
aa
aa
aa
aa
cT
aa
"}
