//MAP CONVERTED BY dmm2tgm.py THIS HEADER COMMENT PREVENTS RECONVERSION, DO NOT REMOVE
"a" = (
/turf/template_noop,
/area/template_noop)
"b" = (
/turf/closed/mineral,
/area/ruin/unpowered)
"c" = (
/turf/closed/mineral/random/high_chance,
/area/ruin/unpowered)
"d" = (
/turf/open/floor/plating/asteroid/airless,
/area/ruin/unpowered)
"e" = (
/obj/effect/decal/remains/xeno{
	dir = 4
	},
/turf/open/floor/plating/asteroid/airless,
/area/ruin/unpowered)
"f" = (
/obj/effect/decal/remains/robot{
	dir = 4
	},
/turf/open/floor/plating/asteroid/airless,
/area/ruin/unpowered)

(1,1,1) = {"
a
a
a
a
a
a
a
a
a
a
a
a
a
a
a
a
a
a
a"}(2,1,1) = {"
a
a
a
a
a
a
a
a
a
a
a
a
a
a
a
a
a
a
a"}(3,1,1) = {"
a
a
b
b
b
b
b
b
a
a
a
a
a
a
a
a
a
a
a"}(4,1,1) = {"
c
c
b
b
b
b
b
b
b
b
b
b
b
a
a
a
a
a
a"}(5,1,1) = {"
c
c
b
d
d
d
b
d
b
b
b
b
b
b
b
b
a
a
a"}(6,1,1) = {"
c
c
b
d
d
d
d
d
d
d
d
b
d
b
b
b
b
a
a"}(7,1,1) = {"
c
c
b
d
d
d
b
d
d
d
d
d
d
d
c
c
b
b
a"}(8,1,1) = {"
c
c
b
b
d
c
c
c
d
d
d
d
d
f
c
c
b
b
a"}(9,1,1) = {"
c
c
b
d
d
c
c
c
c
c
c
c
d
d
c
c
b
b
a"}(10,1,1) = {"
c
c
b
b
b
c
c
c
c
c
c
c
d
d
c
c
b
b
a"}(11,1,1) = {"
c
c
b
d
d
c
c
c
c
c
c
c
d
d
c
c
b
b
a"}(12,1,1) = {"
c
c
b
d
b
c
c
c
d
d
d
b
d
d
c
c
b
b
a"}(13,1,1) = {"
c
c
b
d
d
d
b
d
d
d
d
b
d
d
c
c
b
b
a"}(14,1,1) = {"
c
c
b
d
e
d
b
d
d
d
d
b
d
b
b
b
b
a
a"}(15,1,1) = {"
c
c
b
d
d
d
b
d
b
b
b
b
b
b
b
b
a
a
a"}(16,1,1) = {"
c
c
b
b
b
b
b
b
b
b
b
b
b
a
a
a
a
a
a"}(17,1,1) = {"
a
a
b
b
b
b
b
b
a
a
a
a
a
a
a
a
a
a
a"}(18,1,1) = {"
a
a
a
a
a
a
a
a
a
a
a
a
a
a
a
a
a
a
a"}(19,1,1) = {"
a
a
a
a
a
a
a
a
a
a
a
a
a
a
a
a
a
a
a"}