//MAP CONVERTED BY dmm2tgm.py THIS HEADER COMMENT PREVENTS RECONVERSION, DO NOT REMOVE
"aa" = (
/turf/template_noop,
/area/template_noop)
"ab" = (
/turf/closed/mineral/random/low_chance,
/area/ruin/unpowered)
"ac" = (
/turf/open/floor/grass,
/area/ruin/space/has_grav/powered)
"ad" = (
/turf/closed/wall/r_wall,
/area/ruin/space/has_grav/powered)
"ae" = (
/turf/open/floor/wood,
/area/ruin/space/has_grav/powered)
"af" = (
/turf/open/floor/plasteel/checker,
/area/ruin/space/has_grav/powered)
"ag" = (
/turf/open/floor/holofloor/beach,
/area/ruin/space/has_grav/powered)
"ah" = (
/turf/open/floor/holofloor/beach/coast_t,
/area/ruin/space/has_grav/powered)
"ai" = (
/turf/open/floor/holofloor/beach/water,
/area/ruin/space/has_grav/powered)
"aj" = (
/turf/open/floor/plating/asteroid/airless,
/area/ruin/unpowered)
"ak" = (
/obj/machinery/door/airlock/wood/glass{
	dir = 1
	},
/turf/open/floor/wood,
/area/ruin/space/has_grav/powered)
"al" = (
/obj/machinery/door/airlock/wood{
	dir = 1
	},
/turf/open/floor/wood,
/area/ruin/space/has_grav/powered)
"am" = (
/obj/machinery/computer{
	dir = 8
	},
/turf/open/floor/wood,
/area/ruin/space/has_grav/powered)
"an" = (
/obj/machinery/computer{
	dir = 4
	},
/turf/open/floor/wood,
/area/ruin/space/has_grav/powered)
"ao" = (
/obj/structure/bed/dogbed{
	dir = 1
	},
/turf/open/floor/wood,
/area/ruin/space/has_grav/powered)
"ap" = (
/mob/living/simple_animal/pet/dog/pug,
/turf/open/floor/wood,
/area/ruin/space/has_grav/powered)
"aq" = (
/mob/living/simple_animal/pet/dog/corgi/exoticcorgi,
/turf/open/floor/grass,
/area/ruin/space/has_grav/powered)
"ar" = (
/mob/living/simple_animal/pet/dog/corgi/seccie,
/turf/open/floor/grass,
/area/ruin/space/has_grav/powered)
"as" = (
/mob/living/simple_animal/pet/dog/corgi/puppy,
/turf/open/floor/wood,
/area/ruin/space/has_grav/powered)
"at" = (
/mob/living/simple_animal/pet/dog/bullterrier,
/turf/open/floor/grass,
/area/ruin/space/has_grav/powered)
"au" = (
/obj/machinery/hydroponics{
	dir = 1
	},
/turf/open/floor/plasteel/checker,
/area/ruin/space/has_grav/powered)
"av" = (
/obj/structure/flora/junglebush{
	dir = 1
	},
/turf/open/floor/grass,
/area/ruin/space/has_grav/powered)
"aw" = (
/mob/living/simple_animal/pet/dog/corgi/seccie,
/turf/open/floor/wood,
/area/ruin/space/has_grav/powered)
"ax" = (
/obj/item/reagent_containers/food/snacks/nugget/dog{
	dir = 1
	},
/turf/open/floor/grass,
/area/ruin/space/has_grav/powered)
"ay" = (
/mob/living/simple_animal/pet/dog/corgi/puppy,
/turf/open/floor/holofloor/beach/coast_t,
/area/ruin/space/has_grav/powered)
"az" = (
/mob/living/simple_animal/pet/dog/corgi/chef,
/turf/open/floor/plasteel/checker,
/area/ruin/space/has_grav/powered)
"aA" = (
/obj/machinery/grill{
	dir = 1
	},
/turf/open/floor/plasteel/checker,
/area/ruin/space/has_grav/powered)
"aB" = (
/obj/item/toy/plush/snakeplushie{
	dir = 1
	},
/turf/open/floor/wood,
/area/ruin/space/has_grav/powered)
"aC" = (
/obj/structure/flora/tree/jungle/small{
	dir = 1
	},
/turf/open/floor/grass,
/area/ruin/space/has_grav/powered)
"aD" = (
/obj/structure/flora/grass/jungle/b{
	dir = 1
	},
/turf/open/floor/grass,
/area/ruin/space/has_grav/powered)
"aE" = (
/obj/structure/flora/junglebush/b{
	dir = 1
	},
/turf/open/floor/grass,
/area/ruin/space/has_grav/powered)
"aF" = (
/obj/structure/flora/junglebush/c{
	dir = 1
	},
/turf/open/floor/grass,
/area/ruin/space/has_grav/powered)
"aG" = (
/obj/structure/flora/grass/green{
	dir = 1
	},
/turf/open/floor/grass,
/area/ruin/space/has_grav/powered)
"aH" = (
/obj/item/toy/plush/lizardplushie{
	dir = 1
	},
/turf/open/floor/wood,
/area/ruin/space/has_grav/powered)
"aI" = (
/obj/item/toy/plush/slimeplushie{
	dir = 1
	},
/turf/open/floor/wood,
/area/ruin/space/has_grav/powered)
"aJ" = (
/obj/structure/flora/grass/both{
	dir = 1
	},
/turf/open/floor/grass,
/area/ruin/space/has_grav/powered)
"aK" = (
/obj/machinery/power/rtg/advanced{
	dir = 1
	},
/turf/open/floor/wood,
/area/ruin/space/has_grav/powered)
"aL" = (
/obj/structure/flora/tree/palm{
	dir = 1
	},
/turf/open/floor/holofloor/beach,
/area/ruin/space/has_grav/powered)
"aM" = (
/obj/structure/closet/secure_closet/freezer{
	dir = 1
	},
/obj/item/reagent_containers/food/snacks/nugget/dog{
	dir = 1
	},
/obj/item/reagent_containers/food/snacks/nugget/dog{
	dir = 1
	},
/obj/item/reagent_containers/food/snacks/nugget/dog{
	dir = 1
	},
/obj/item/reagent_containers/food/snacks/nugget/dog{
	dir = 1
	},
/obj/item/reagent_containers/food/snacks/nugget/dog{
	dir = 1
	},
/turf/open/floor/plasteel/checker,
/area/ruin/space/has_grav/powered)
"aN" = (
/obj/structure/closet/crate/wooden{
	dir = 1
	},
/obj/item/stack/sheet/mineral/coal/ten{
	dir = 1
	},
/turf/open/floor/plasteel/checker,
/area/ruin/space/has_grav/powered)
"aO" = (
/obj/effect/overlay/coconut{
	dir = 1
	},
/turf/open/floor/holofloor/beach,
/area/ruin/space/has_grav/powered)
"aP" = (
/obj/item/pool/rubber_ring{
	dir = 1
	},
/turf/open/floor/holofloor/beach/water,
/area/ruin/space/has_grav/powered)
"aQ" = (
/obj/structure/table/wood{
	dir = 1
	},
/obj/item/folder{
	dir = 1
	},
/obj/item/pen{
	dir = 1
	},
/turf/open/floor/wood,
/area/ruin/space/has_grav/powered)
"aR" = (
/obj/item/pickaxe{
	dir = 1
	},
/turf/open/floor/plating/asteroid/airless,
/area/ruin/unpowered)
"aS" = (
/obj/item/paper/fluff/ruins/asteroid10/welcome{
	dir = 1
	},
/turf/open/floor/plating/asteroid/airless,
/area/ruin/unpowered)
"aT" = (
/obj/machinery/light{
	dir = 4
	},
/turf/open/floor/wood,
/area/ruin/space/has_grav/powered)
"aU" = (
/obj/machinery/light{
	dir = 1
	},
/turf/open/floor/wood,
/area/ruin/space/has_grav/powered)
"aV" = (
/obj/machinery/light{
	dir = 2
	},
/turf/open/floor/plasteel/checker,
/area/ruin/space/has_grav/powered)
"aW" = (
/obj/machinery/light{
	dir = 8
	},
/turf/open/floor/wood,
/area/ruin/space/has_grav/powered)
"aX" = (
/obj/machinery/light{
	dir = 2
	},
/turf/open/floor/holofloor/beach,
/area/ruin/space/has_grav/powered)
"aY" = (
/obj/machinery/light{
	dir = 8
	},
/turf/open/floor/holofloor/beach/coast_t,
/area/ruin/space/has_grav/powered)
"aZ" = (
/obj/machinery/light{
	dir = 4
	},
/turf/open/floor/plasteel/checker,
/area/ruin/space/has_grav/powered)
"ba" = (
/obj/machinery/portable_atmospherics/canister/air{
	dir = 1
	},
/turf/open/floor/wood,
/area/ruin/space/has_grav/powered)
"bb" = (
/obj/structure/sink/puddle{
	dir = 1
	},
/turf/open/floor/grass,
/area/ruin/space/has_grav/powered)
"bc" = (
/obj/machinery/light/floor{
	dir = 1
	},
/turf/open/floor/grass,
/area/ruin/space/has_grav/powered)
"bd" = (
/obj/machinery/portable_atmospherics/canister/air{
	dir = 1
	},
/turf/open/floor/holofloor/beach,
/area/ruin/space/has_grav/powered)
"be" = (
/obj/structure/table/wood{
	dir = 1
	},
/obj/item/storage/toolbox/mechanical{
	dir = 1
	},
/turf/open/floor/wood,
/area/ruin/space/has_grav/powered)
"bf" = (
/obj/structure/table/wood{
	dir = 1
	},
/obj/item/flashlight/seclite{
	dir = 1
	},
/turf/open/floor/wood,
/area/ruin/space/has_grav/powered)
"bg" = (
/obj/structure/closet/emcloset/anchored{
	dir = 1
	},
/turf/open/floor/wood,
/area/ruin/space/has_grav/powered)
"bh" = (
/obj/item/reagent_containers/food/snacks/nugget/dog{
	dir = 1
	},
/turf/open/floor/wood,
/area/ruin/space/has_grav/powered)

(1,1,1) = {"
aa
aa
aa
aa
aa
aa
aa
aa
aa
aa
aa
aa
aa
aa
aa
aa
aa
aa
aa
aa
aa
aa
aa
aa
aa
aa
aa
aa
aa
aa
aa
aa
aa"}(2,1,1) = {"
aa
aa
aa
ab
aa
aa
aa
aa
aa
aa
aa
aa
aa
aa
ab
ab
ab
ab
ab
ab
aa
aa
aa
aa
aa
aa
aa
aa
aa
aa
aa
aa
aa"}(3,1,1) = {"
aa
aa
ab
ab
ab
aa
aa
aa
aa
aa
ab
ab
ab
aj
ab
ab
ab
ab
ab
ab
ab
aa
aa
aa
aa
aa
aa
aa
aa
aa
aa
aa
aa"}(4,1,1) = {"
aa
aa
ab
ab
ab
aa
aa
aa
aa
ab
ab
ab
ab
aj
ab
ab
ab
ab
ab
ab
ab
ab
aa
aa
aa
aa
aa
aa
aa
aa
aa
aa
aa"}(5,1,1) = {"
aa
aa
aa
ab
aa
aa
aa
aa
ab
ab
ab
ab
ab
aj
ab
ab
ab
ab
ab
ab
ab
ab
ab
aa
aa
aa
aa
aa
aa
aa
aa
aa
aa"}(6,1,1) = {"
aa
aa
aa
aa
aa
aa
aa
aj
aj
ab
ab
ab
ab
ab
ab
ab
ab
ab
ab
ab
ab
ab
ab
aa
aa
aa
aa
aa
aa
aa
aa
aa
aa"}(7,1,1) = {"
aa
aa
aa
aa
aa
aa
ab
ab
ab
ab
ab
ab
ab
ab
ab
ab
ab
ab
ab
ab
ab
ab
aj
aa
aa
aa
aa
aa
aa
aa
aa
aa
aa"}(8,1,1) = {"
aa
aa
aa
aa
aa
ab
ab
ab
ab
ab
ab
ab
ab
ab
ab
aj
aj
ab
ab
ab
ab
aj
aj
aj
aa
aa
aa
aa
aa
aa
aa
aa
aa"}(9,1,1) = {"
aa
aa
aa
aa
aa
ab
ab
ab
ab
ab
ab
ab
ab
ab
aj
aj
aj
aj
ab
ab
aR
aj
aj
aj
aa
aa
aa
aa
aa
aa
aa
aa
aa"}(10,1,1) = {"
aa
aa
aa
aa
aj
ab
ab
ab
ab
ab
ab
ad
ad
ad
ad
ad
aj
aj
ab
ab
ab
aj
aj
aj
aa
aa
aa
aa
aa
aa
aa
aa
aa"}(11,1,1) = {"
aa
aa
aa
aj
aj
ab
ab
ab
ab
ad
ad
au
au
ad
ao
aH
ad
ad
ab
ab
ab
ab
aj
aj
aa
aa
aa
aa
aa
aa
aa
aa
aa"}(12,1,1) = {"
aa
aa
aj
aj
ab
ab
ab
ab
ad
aM
aM
af
af
ad
ae
ae
ao
ae
ad
ab
ab
ab
aj
aa
aa
aa
aa
aa
aa
aa
aa
aa
aa"}(13,1,1) = {"
aa
ab
ab
ab
ab
ab
ab
ad
aN
af
af
af
aV
ad
ae
ae
ae
ae
ao
ad
ab
ab
aa
aa
aa
aa
aa
aa
aa
aa
aa
aa
aa"}(14,1,1) = {"
ab
ab
ab
ab
ab
ab
ad
au
af
af
az
af
af
ak
bh
ae
aw
ae
ae
aB
ad
ab
ab
aa
aa
aa
aa
aa
aa
aa
aa
aa
aa"}(15,1,1) = {"
ab
ab
ab
ab
ab
ab
ad
au
af
aZ
af
af
aA
ad
aU
ae
as
ap
ae
ao
ad
ab
ab
aa
aa
aa
aa
aa
aa
aa
aa
aa
aa"}(16,1,1) = {"
ab
ab
ab
ab
aj
ad
ad
ad
ad
ad
ad
al
ad
ad
aI
ae
ae
ae
ae
ae
ae
ad
ab
aa
aa
aa
aa
aa
aa
aa
aa
aa
aa"}(17,1,1) = {"
ab
ab
ab
aj
aj
al
aW
ba
an
bf
aQ
ae
aW
al
ae
bh
aT
ae
ae
ae
ao
ad
ab
ab
aa
aa
aa
aa
aa
aa
aa
aa
aa"}(18,1,1) = {"
ab
ab
ab
aj
aS
al
ae
ae
aw
bh
ae
ae
aK
ad
ad
ad
ad
ak
ad
ad
ad
ad
ab
ab
aa
aa
aa
aa
aa
aa
aa
aa
aa"}(19,1,1) = {"
ab
ab
ab
aR
aj
al
aT
bg
am
am
be
ae
aT
al
aJ
aD
aG
ac
aE
av
av
ad
ab
ab
aa
aa
aa
aa
aa
aa
aa
aa
aa"}(20,1,1) = {"
ab
ab
ab
ab
aj
ad
ad
ad
ad
ad
ad
al
ad
ad
aG
bc
ac
ax
aD
aC
av
ad
ab
ab
ab
aa
aa
aa
aa
aa
aa
aa
aa"}(21,1,1) = {"
ab
ab
ab
ab
ab
ab
ad
ai
ai
ai
aY
ag
bd
ad
aG
ac
aG
ar
bb
aD
ad
ab
ab
ab
ab
aa
aa
aa
aa
aa
aa
aa
aa"}(22,1,1) = {"
ab
ab
ab
ab
ab
ab
ad
ai
aP
ai
ay
ag
ag
ak
ac
ax
at
aq
aF
av
ad
ab
ab
ab
ab
aa
aa
aa
aa
aa
aa
aa
aa"}(23,1,1) = {"
aa
ab
ab
ab
ab
ab
ab
ad
ai
ai
ay
ag
aX
ad
aD
bb
aD
aD
av
ad
ab
ab
ab
ab
ab
aa
aa
aa
aa
aa
aa
aa
aa"}(24,1,1) = {"
aa
aa
ab
ab
ab
ab
ab
ab
ad
ai
ah
ag
aO
ad
av
aC
aF
aF
ad
ab
ab
ab
ab
aj
aa
aa
aa
aa
aa
aa
aa
aa
aa"}(25,1,1) = {"
aa
aa
aa
ab
ab
ab
ab
ab
ab
ad
ad
ag
aL
ad
av
av
ad
ad
ab
ab
ab
ab
aj
aj
aa
aa
aa
aa
aa
aa
aa
aa
aa"}(26,1,1) = {"
aa
aa
aa
aa
ab
ab
ab
ab
ab
ab
ab
ad
ad
ad
ad
ad
ab
ab
ab
ab
ab
aj
aj
aj
aa
aa
aa
aa
aa
aa
aa
aa
aa"}(27,1,1) = {"
aa
aj
aj
aa
aa
ab
ab
ab
ab
ab
ab
ab
ab
ab
ab
ab
ab
ab
ab
ab
aj
aj
aj
aa
aa
aa
aa
aa
aa
aa
aa
aa
aa"}(28,1,1) = {"
aa
aj
aj
aj
aa
aa
ab
ab
ab
ab
ab
ab
ab
ab
ab
ab
ab
ab
ab
aj
aj
ab
ab
aa
aa
aa
aa
aa
aa
aa
aa
aa
aa"}(29,1,1) = {"
aa
aa
aj
aj
aa
aa
ab
ab
ab
ab
ab
ab
ab
ab
ab
ab
ab
ab
aj
aj
ab
ab
ab
ab
aa
aa
aa
aa
aa
aa
aa
aa
aa"}(30,1,1) = {"
aa
aa
aj
aa
aa
aa
aa
ab
ab
ab
ab
ab
ab
ab
ab
ab
ab
aj
aj
ab
ab
ab
ab
ab
aa
aa
aa
aa
aa
aa
aa
aa
aa"}(31,1,1) = {"
aa
aa
aa
aa
aa
aa
aa
aa
ab
ab
ab
ab
ab
ab
ab
ab
aj
aj
ab
ab
ab
ab
ab
aa
aa
aa
aa
aa
aa
aa
aa
aa
aa"}(32,1,1) = {"
aa
aa
aa
aa
aa
aj
aa
aa
aa
ab
ab
ab
ab
ab
ab
aj
aj
aj
aa
ab
ab
ab
aa
aa
aa
aa
aa
aa
aa
aa
aa
aa
aa"}(33,1,1) = {"
aa
aa
aa
aa
aa
aa
aa
aa
aa
aa
aa
ab
ab
ab
ab
aa
aa
aa
aa
aa
aa
aa
aa
aa
aa
aa
aa
aa
aa
aa
aa
aa
aa"}