//MAP CONVERTED BY dmm2tgm.py THIS HEADER COMMENT PREVENTS RECONVERSION, DO NOT REMOVE
"a" = (
/turf/template_noop,
/area/template_noop)
"b" = (
/turf/open/floor/plating/asteroid/airless,
/area/ruin/unpowered)
"c" = (
/turf/closed/mineral/random/high_chance,
/area/ruin/unpowered)
"d" = (
/turf/closed/mineral,
/area/ruin/unpowered)

(1,1,1) = {"
a
a
a
a
a
a
a
a
a
a
a
a
a
a
a
a
a
a
"}
(2,1,1) = {"
a
a
a
a
a
a
d
d
a
a
a
a
a
a
a
d
a
a
"}
(3,1,1) = {"
a
a
a
a
a
a
d
d
a
a
a
a
a
a
d
d
a
a
"}
(4,1,1) = {"
a
a
c
a
a
a
a
a
a
c
c
c
a
a
d
d
a
a
"}
(5,1,1) = {"
a
a
c
c
c
c
a
a
a
a
c
c
c
a
a
a
a
a
"}
(6,1,1) = {"
a
a
c
c
c
c
c
a
a
a
c
c
c
a
a
a
a
a
"}
(7,1,1) = {"
a
a
c
c
c
c
c
c
a
a
c
c
c
c
a
a
a
a
"}
(8,1,1) = {"
a
a
c
c
c
c
c
c
a
a
c
c
c
c
a
a
b
a
"}
(9,1,1) = {"
a
a
a
c
c
c
c
c
a
a
a
c
c
c
a
a
a
a
"}
(10,1,1) = {"
a
a
a
a
c
c
c
c
a
a
a
c
c
c
a
a
a
a
"}
(11,1,1) = {"
a
a
a
a
a
a
c
a
a
a
a
c
c
c
c
a
a
a
"}
(12,1,1) = {"
a
a
a
a
a
a
a
a
a
b
a
c
c
c
c
a
a
a
"}
(13,1,1) = {"
a
a
d
d
a
a
a
a
a
a
a
a
c
c
c
a
a
a
"}
(14,1,1) = {"
a
a
d
d
d
a
a
b
a
a
a
a
c
c
c
a
a
a
"}
(15,1,1) = {"
a
a
d
d
a
a
a
a
a
a
a
c
c
c
c
a
a
a
"}
(16,1,1) = {"
a
a
a
a
a
a
a
a
a
b
a
c
c
c
c
a
a
a
"}
(17,1,1) = {"
a
a
a
b
a
a
c
a
a
a
a
c
c
c
a
a
b
a
"}
(18,1,1) = {"
a
a
a
a
a
c
c
a
b
a
a
c
c
c
a
a
a
a
"}
(19,1,1) = {"
a
a
a
a
a
c
c
a
a
a
c
c
c
c
a
a
a
a
"}
(20,1,1) = {"
a
b
a
a
c
c
a
a
a
a
c
c
c
c
a
b
a
a
"}
(21,1,1) = {"
a
a
a
a
c
c
a
d
a
a
c
c
c
a
a
a
a
a
"}
(22,1,1) = {"
a
a
a
c
c
a
d
d
d
a
c
c
c
a
b
a
a
a
"}
(23,1,1) = {"
a
a
a
c
a
a
a
d
a
c
c
c
a
a
a
a
a
a
"}
(24,1,1) = {"
a
a
a
a
a
a
a
a
a
a
a
a
a
a
a
a
a
a
"}
(25,1,1) = {"
a
a
a
a
a
a
a
a
a
a
a
a
a
a
a
a
a
a
"}
