//MAP CONVERTED BY dmm2tgm.py THIS HEADER COMMENT PREVENTS RECONVERSION, DO NOT REMOVE
"a" = (
/turf/template_noop,
/area/template_noop)
"b" = (
/turf/closed/mineral,
/area/ruin/unpowered)
"c" = (
/turf/open/floor/plating/asteroid/airless,
/area/ruin/unpowered)
"d" = (
/turf/closed/mineral/random/high_chance,
/area/ruin/unpowered)

(1,1,1) = {"
a
a
a
a
a
c
c
c
a
a
a
a
a
a
a
a
a
a
a
a"}(2,1,1) = {"
a
a
a
a
c
b
b
b
a
a
a
a
a
a
a
a
a
a
a
a"}(3,1,1) = {"
a
a
a
c
b
b
b
a
a
a
a
a
a
a
a
a
a
a
a
a"}(4,1,1) = {"
a
a
c
d
d
d
d
a
a
a
c
a
a
a
a
a
a
a
a
a"}(5,1,1) = {"
a
a
c
d
d
d
d
a
a
a
c
c
a
a
a
a
a
a
a
a"}(6,1,1) = {"
a
c
d
d
d
d
d
d
a
a
c
c
c
a
a
a
a
a
a
a"}(7,1,1) = {"
a
c
d
d
d
d
d
d
a
a
a
c
c
a
a
a
a
a
a
a"}(8,1,1) = {"
a
c
d
d
d
d
d
d
a
a
a
a
a
a
a
a
d
d
a
a"}(9,1,1) = {"
c
b
d
d
d
d
d
d
a
a
a
a
a
a
a
d
d
d
d
a"}(10,1,1) = {"
c
b
b
d
d
d
d
d
c
a
a
a
a
a
a
d
d
d
d
a"}(11,1,1) = {"
a
c
b
b
b
d
d
d
c
a
a
a
a
a
a
a
d
d
a
a"}(12,1,1) = {"
a
c
b
b
b
d
d
d
d
d
d
a
a
a
a
a
a
a
a
a"}(13,1,1) = {"
a
c
b
b
d
d
d
d
d
d
d
d
d
d
a
a
a
a
a
a"}(14,1,1) = {"
a
a
c
b
d
d
d
d
d
d
d
d
d
d
d
a
a
a
b
b"}(15,1,1) = {"
a
a
c
d
d
d
d
d
d
d
d
d
d
d
d
b
b
b
b
c"}(16,1,1) = {"
a
a
a
c
d
d
d
d
d
d
d
d
d
d
d
d
b
b
c
a"}(17,1,1) = {"
a
a
a
a
c
d
d
d
d
d
d
d
d
d
d
b
b
c
a
a"}(18,1,1) = {"
a
a
a
a
a
c
c
d
d
d
d
d
d
d
d
c
c
a
a
a"}(19,1,1) = {"
a
a
a
a
a
a
a
c
c
c
d
d
c
c
c
a
a
a
a
a"}(20,1,1) = {"
a
a
a
a
a
a
a
a
a
a
c
c
a
a
a
a
a
a
a
a"}