//MAP CONVERTED BY dmm2tgm.py THIS HEADER COMMENT PREVENTS RECONVERSION, DO NOT REMOVE
"a" = (
/turf/template_noop,
/area/template_noop)
"c" = (
/turf/open/floor/plating/asteroid/airless,
/area/ruin/unpowered/no_grav)
"e" = (
/turf/closed/wall,
/area/ruin/unpowered)
"f" = (
/turf/closed/wall/rust,
/area/ruin/unpowered)
"g" = (
/turf/open/floor/plating,
/area/ruin/unpowered)
"h" = (
/obj/structure/closet/crate,
/turf/open/floor/plating,
/area/ruin/unpowered)
"i" = (
/obj/effect/spawner/random/structure/crate_abandoned,
/turf/open/floor/plating,
/area/ruin/unpowered)
"j" = (
/obj/structure/barricade/wooden,
/obj/structure/door_assembly,
/turf/open/floor/plating,
/area/ruin/unpowered)
"k" = (
/obj/structure/table,
/obj/item/storage/toolbox/electrical,
/turf/open/floor/plating,
/area/ruin/unpowered)
"l" = (
/obj/structure/closet/crate,
/obj/effect/spawner/random/maintenance,
/turf/open/floor/plating,
/area/ruin/unpowered)
"m" = (
/obj/effect/decal/remains/human,
/turf/open/floor/plating,
/area/ruin/unpowered)
"n" = (
/obj/structure/table,
/obj/item/storage/toolbox/syndicate,
/turf/open/floor/plating,
/area/ruin/unpowered)
"o" = (
/obj/structure/table,
/turf/open/floor/plating,
/area/ruin/unpowered)
"p" = (
/turf/open/floor/plating/asteroid,
/area/ruin/unpowered)
"q" = (
/obj/structure/barricade/wooden,
/turf/open/floor/plating,
/area/ruin/unpowered)
"r" = (
/obj/structure/barricade/wooden,
/obj/machinery/door/airlock/external,
/turf/open/floor/plating/asteroid/airless,
/area/ruin/unpowered)
"s" = (
/obj/machinery/door/airlock/external,
/turf/open/floor/plating,
/area/ruin/unpowered)
"V" = (
/turf/closed/mineral,
/area/ruin/unpowered/no_grav)
"W" = (
/turf/closed/mineral,
/area/ruin/unpowered)

(1,1,1) = {"
a
a
a
a
a
a
a
a
a
a
a
a
a
a
a
a
a
a
a
a
a
a
a
a
a
a
a
a
a
a
a
V
V
V
a
a
a
a
"}
(2,1,1) = {"
a
a
a
a
a
a
a
a
a
a
a
a
a
a
a
a
a
a
a
a
a
a
a
a
a
a
a
a
a
a
a
V
V
V
a
a
a
a
"}
(3,1,1) = {"
a
a
a
a
a
a
a
a
a
a
a
a
a
a
a
a
a
a
V
a
a
a
a
a
a
a
a
a
a
a
a
a
a
V
a
a
a
V
"}
(4,1,1) = {"
a
a
a
a
a
a
a
a
a
a
a
a
a
a
a
a
a
a
a
a
a
a
a
a
a
a
a
a
a
a
a
a
a
a
a
a
a
a
"}
(5,1,1) = {"
a
a
a
a
a
a
a
a
a
c
c
c
c
a
a
a
a
a
a
a
a
a
V
a
a
a
a
a
a
a
a
a
a
a
a
a
V
a
"}
(6,1,1) = {"
a
a
a
a
a
a
a
c
c
c
c
c
c
a
a
a
a
a
a
a
a
a
a
a
a
a
a
a
a
a
a
a
a
a
a
a
a
a
"}
(7,1,1) = {"
a
a
a
a
a
a
V
V
V
V
V
c
c
c
c
a
a
a
a
a
a
a
a
a
V
V
V
a
a
a
a
a
a
a
a
a
a
a
"}
(8,1,1) = {"
a
a
a
a
a
V
V
V
V
V
V
c
c
c
c
c
c
c
a
a
a
a
a
a
V
V
V
a
a
a
a
a
a
a
a
a
a
a
"}
(9,1,1) = {"
a
a
a
a
a
V
V
V
V
V
V
V
V
V
c
c
c
c
c
a
a
a
a
a
a
V
V
V
V
a
a
a
a
a
a
a
a
a
"}
(10,1,1) = {"
a
a
a
a
a
V
V
V
V
V
V
V
V
V
V
V
V
c
c
a
a
a
a
a
a
V
V
V
V
a
a
a
a
a
a
a
a
a
"}
(11,1,1) = {"
a
a
a
a
V
V
V
V
V
V
V
V
V
V
V
V
V
c
c
c
c
a
a
a
a
a
a
a
a
a
a
a
a
a
a
a
a
a
"}
(12,1,1) = {"
a
a
a
a
V
V
V
V
V
V
V
V
V
V
V
V
V
V
c
c
c
a
a
a
a
a
a
a
a
a
a
a
a
a
a
a
a
a
"}
(13,1,1) = {"
a
a
a
a
V
V
V
V
V
V
V
V
V
V
V
V
V
V
c
c
c
c
c
a
a
a
a
a
a
a
a
a
a
a
a
a
a
a
"}
(14,1,1) = {"
a
a
a
a
V
V
V
V
V
W
W
f
f
e
f
e
e
e
W
V
c
c
c
a
a
a
a
a
a
a
a
a
a
a
a
a
a
a
"}
(15,1,1) = {"
a
a
a
a
V
V
V
V
V
W
g
i
i
m
g
f
g
g
W
V
c
c
c
a
a
a
a
a
a
a
a
a
a
a
a
a
a
a
"}
(16,1,1) = {"
a
a
a
a
a
a
V
V
V
e
g
g
g
g
h
f
g
g
e
V
c
c
c
a
a
a
a
a
a
a
a
a
a
a
a
a
a
a
"}
(17,1,1) = {"
a
a
a
a
a
a
V
V
V
e
g
g
k
n
i
e
g
g
W
V
c
c
c
c
a
a
a
a
a
a
V
V
V
a
a
a
a
a
"}
(18,1,1) = {"
a
a
a
a
a
a
V
V
V
f
e
j
f
f
e
e
p
l
e
V
V
V
c
c
c
c
c
a
a
a
V
V
V
V
V
a
a
a
"}
(19,1,1) = {"
a
a
a
a
a
a
a
V
V
W
g
g
l
h
l
e
g
g
f
V
V
V
c
c
c
c
c
c
c
c
c
c
V
V
V
a
a
a
"}
(20,1,1) = {"
a
a
a
a
a
a
a
V
V
W
g
g
g
g
g
e
g
p
f
V
V
V
c
c
c
c
c
c
c
c
c
c
V
V
V
V
V
a
"}
(21,1,1) = {"
a
a
a
a
a
a
a
V
V
e
g
g
g
g
g
j
g
g
e
V
V
V
c
c
c
c
c
c
c
c
c
c
c
c
V
V
V
a
"}
(22,1,1) = {"
a
a
a
a
a
a
a
a
V
e
h
h
g
o
g
e
g
p
e
e
e
V
c
c
c
c
c
c
c
c
c
c
c
c
V
V
V
V
"}
(23,1,1) = {"
a
a
a
a
a
a
a
a
V
W
f
f
j
f
g
e
p
q
r
q
s
c
c
c
c
c
c
c
c
c
c
c
c
c
V
V
V
V
"}
(24,1,1) = {"
a
a
a
a
a
a
a
a
a
W
i
h
g
f
l
e
e
W
e
e
e
V
c
c
c
c
c
c
c
c
c
c
c
c
V
V
V
V
"}
(25,1,1) = {"
a
V
a
a
a
a
a
a
a
V
V
e
f
e
V
V
V
V
V
V
V
V
c
c
c
c
c
c
c
c
c
c
c
c
c
V
V
V
"}
(26,1,1) = {"
a
a
a
a
a
a
a
a
a
V
V
V
V
V
V
V
V
V
V
V
V
V
V
V
V
c
c
c
c
c
c
c
c
c
c
c
V
V
"}
(27,1,1) = {"
a
a
a
a
a
a
a
a
a
V
V
V
V
V
V
V
V
V
V
V
V
V
V
V
V
V
c
c
c
c
c
c
c
c
c
c
V
V
"}
(28,1,1) = {"
a
a
a
a
a
a
a
a
a
V
V
V
V
V
V
V
V
V
V
V
V
V
V
V
V
V
c
c
c
c
c
c
c
c
c
c
V
V
"}
(29,1,1) = {"
a
a
a
a
a
a
a
a
a
V
V
V
V
V
V
V
V
V
V
V
V
V
V
V
V
c
c
c
c
c
c
c
c
c
c
c
V
V
"}
(30,1,1) = {"
a
V
V
a
a
a
a
a
a
a
V
V
V
V
V
V
V
V
V
V
V
V
V
V
V
c
c
c
c
c
c
c
c
c
V
V
V
V
"}
(31,1,1) = {"
V
V
V
a
a
a
a
a
a
a
V
V
V
V
V
V
V
V
V
V
V
V
V
V
V
V
c
c
c
c
c
c
c
c
V
V
V
a
"}
(32,1,1) = {"
V
V
V
V
a
a
a
a
a
a
a
a
V
V
V
V
V
V
V
V
V
V
V
V
V
V
c
c
c
c
c
c
V
V
V
V
V
a
"}
(33,1,1) = {"
a
V
V
V
a
a
a
a
a
a
a
a
V
V
V
V
V
V
V
V
V
V
V
V
V
V
V
V
V
V
c
c
V
V
V
V
V
a
"}
(34,1,1) = {"
V
a
a
a
a
a
a
V
a
a
a
a
a
a
V
V
V
V
V
V
V
V
V
V
V
V
V
V
V
V
V
V
V
V
V
V
a
a
"}
(35,1,1) = {"
V
a
a
a
a
a
a
a
a
a
a
a
a
a
V
V
V
V
V
V
V
V
V
V
V
V
V
V
V
V
V
V
V
V
V
V
a
a
"}
(36,1,1) = {"
a
a
a
a
V
a
a
a
a
a
a
a
a
a
a
a
a
a
a
V
V
V
V
V
V
V
V
V
V
V
V
V
V
V
V
V
a
a
"}
(37,1,1) = {"
a
a
a
a
a
a
a
a
a
a
a
a
a
a
a
a
a
a
a
a
a
a
a
a
a
a
V
V
V
V
V
V
V
a
a
a
a
a
"}
