//MAP CONVERTED BY dmm2tgm.py THIS HEADER COMMENT PREVENTS RECONVERSION, DO NOT REMOVE
"a" = (
/turf/template_noop,
/area/template_noop)
"b" = (
/turf/closed/mineral/random,
/area/ruin/space/has_grav)
"c" = (
/turf/open/floor/plating/asteroid/airless,
/area/ruin/space/has_grav)
"d" = (
/obj/structure/marker_beacon{
	light_color = "#FFE8AA";
	light_range = 20;
	dir = 1
	},
/turf/open/floor/plating/asteroid/airless,
/area/ruin/space/has_grav)
"e" = (
/obj/structure/flora/ausbushes/fullgrass{
	dir = 1
	},
/turf/open/floor/plating/asteroid/airless,
/area/ruin/space/has_grav)
"f" = (
/obj/structure/flora/ausbushes/ywflowers{
	dir = 1
	},
/turf/open/floor/plating/asteroid/airless,
/area/ruin/space/has_grav)
"h" = (
/mob/living/simple_animal/pet/gondola,
/turf/open/floor/plating/asteroid/airless,
/area/ruin/space/has_grav)
"i" = (
/obj/structure/flora/ausbushes/sparsegrass{
	dir = 1
	},
/turf/open/floor/plating/asteroid/airless,
/area/ruin/space/has_grav)
"j" = (
/obj/effect/overlay/coconut{
	dir = 1
	},
/turf/open/floor/plating/asteroid/airless,
/area/ruin/space/has_grav)
"k" = (
/obj/effect/overlay/palmtree_l{
	dir = 1
	},
/turf/open/floor/plating/asteroid/airless,
/area/ruin/space/has_grav)
"l" = (
/obj/structure/flora/ausbushes/stalkybush{
	dir = 1
	},
/turf/open/floor/plating/asteroid/airless,
/area/ruin/space/has_grav)
"m" = (
/obj/structure/flora/ausbushes/grassybush{
	dir = 1
	},
/turf/open/floor/plating/asteroid/airless,
/area/ruin/space/has_grav)
"n" = (
/obj/structure/flora/ausbushes/reedbush{
	dir = 1
	},
/turf/open/floor/plating/asteroid/airless,
/area/ruin/space/has_grav)
"o" = (
/obj/structure/flora/ausbushes/lavendergrass{
	dir = 1
	},
/turf/open/floor/plating/asteroid/airless,
/area/ruin/space/has_grav)
"p" = (
/obj/structure/flora/ausbushes/brflowers{
	dir = 1
	},
/turf/open/floor/plating/asteroid/airless,
/area/ruin/space/has_grav)
"q" = (
/obj/structure/flora/ausbushes/fernybush{
	dir = 1
	},
/turf/open/floor/plating/asteroid/airless,
/area/ruin/space/has_grav)
"r" = (
/obj/effect/overlay/palmtree_r{
	dir = 1
	},
/turf/open/floor/plating/asteroid/airless,
/area/ruin/space/has_grav)
"s" = (
/obj/structure/flora/junglebush/large{
	dir = 1
	},
/turf/open/floor/plating/asteroid/airless,
/area/ruin/space/has_grav)
"t" = (
/obj/structure/flora/ausbushes/sunnybush{
	dir = 1
	},
/turf/open/floor/plating/asteroid/airless,
/area/ruin/space/has_grav)
"u" = (
/obj/machinery/door/airlock/survival_pod/glass{
	dir = 4
	},
/obj/effect/mapping_helpers/airlock/cyclelink_helper{
	dir = 1
	},
/turf/open/floor/plating/asteroid/airless,
/area/ruin/space/has_grav)
"T" = (
/obj/machinery/door/airlock/survival_pod/glass{
	dir = 4
	},
/obj/effect/mapping_helpers/airlock/cyclelink_helper{
	dir = 2
	},
/turf/open/floor/plating/asteroid/airless,
/area/ruin/space/has_grav)

(1,1,1) = {"
a
a
a
b
b
b
b
b
b
a
a
a
a
a
a
a
a
a
a
a
a
a
a
a
a
a
a
a
a
a
a
a
a
a
a"}(2,1,1) = {"
a
a
b
b
b
b
b
b
b
b
b
a
a
a
a
a
a
a
a
a
a
a
a
a
a
a
a
a
a
b
b
a
a
a
a"}(3,1,1) = {"
c
b
b
b
b
b
b
b
b
b
b
b
b
b
b
b
a
a
a
a
a
a
a
a
a
a
a
a
b
b
b
b
b
a
a"}(4,1,1) = {"
b
b
b
b
b
c
b
b
b
b
b
b
b
b
b
b
b
b
b
b
a
a
a
a
a
a
a
a
a
a
b
b
b
b
a"}(5,1,1) = {"
b
b
b
c
c
c
c
c
c
c
b
b
b
b
b
b
b
b
b
b
b
a
a
a
a
a
a
a
a
a
a
b
b
b
a"}(6,1,1) = {"
b
b
c
h
c
c
c
f
c
c
c
c
b
b
b
b
b
b
b
b
b
b
b
b
b
b
a
a
a
a
a
a
a
a
a"}(7,1,1) = {"
c
b
b
b
b
b
c
r
c
o
c
c
c
c
b
b
b
b
b
b
b
b
b
b
b
b
b
a
a
a
a
a
a
a
a"}(8,1,1) = {"
c
b
b
b
c
c
c
c
j
c
c
c
c
c
c
c
c
b
c
b
b
b
b
b
b
b
b
b
b
a
a
a
a
a
a"}(9,1,1) = {"
c
b
b
b
c
c
m
c
c
c
c
k
c
c
j
c
c
q
c
c
k
c
b
b
b
b
b
b
b
b
a
a
a
a
a"}(10,1,1) = {"
c
b
b
b
c
c
c
i
c
c
c
c
c
c
s
c
c
c
c
c
b
b
b
b
b
b
b
b
b
b
b
b
a
a
a"}(11,1,1) = {"
c
b
b
b
c
d
c
l
c
h
c
j
c
c
d
c
c
f
n
i
c
b
b
b
b
b
b
b
b
b
b
b
b
a
a"}(12,1,1) = {"
c
b
b
b
c
c
o
i
c
c
c
c
c
c
c
h
c
o
o
c
c
c
c
b
b
b
b
b
b
b
b
b
b
a
a"}(13,1,1) = {"
c
b
b
b
b
c
c
c
c
s
c
c
c
c
c
c
q
c
i
c
c
c
c
b
b
b
b
b
b
b
b
b
b
b
a"}(14,1,1) = {"
c
b
b
b
b
b
c
c
c
c
c
c
c
i
m
c
c
c
l
c
c
c
c
h
b
b
b
b
b
b
b
b
b
b
a"}(15,1,1) = {"
c
b
b
b
b
c
c
c
c
c
c
c
c
o
i
c
c
c
c
c
b
b
b
b
b
b
b
b
b
b
b
b
b
b
a"}(16,1,1) = {"
c
b
b
b
c
c
c
c
r
c
c
c
c
p
o
c
c
c
b
b
b
b
b
b
b
b
b
b
b
b
b
b
b
b
a"}(17,1,1) = {"
c
b
b
c
c
c
c
c
c
c
c
c
c
c
n
e
c
b
b
b
b
b
b
b
b
b
b
b
b
b
b
b
b
b
a"}(18,1,1) = {"
b
b
b
c
c
i
c
c
c
t
i
c
c
c
c
c
c
b
b
b
b
b
c
e
c
b
b
b
b
b
b
b
b
b
a"}(19,1,1) = {"
T
c
u
c
c
c
c
c
c
f
c
c
c
j
r
c
b
b
b
b
c
c
c
c
c
c
b
b
b
b
b
b
b
b
a"}(20,1,1) = {"
b
b
b
b
c
c
c
c
c
c
c
c
c
c
c
c
c
c
c
c
c
c
d
c
c
h
b
b
b
b
b
b
b
c
a"}(21,1,1) = {"
b
b
b
c
c
c
c
c
h
c
d
c
c
c
c
c
q
c
c
i
i
c
k
c
c
c
b
b
b
b
b
b
c
c
a"}(22,1,1) = {"
b
b
b
c
c
r
c
c
c
c
c
c
c
c
c
c
c
c
c
l
c
c
c
c
c
c
b
b
b
b
b
b
c
c
a"}(23,1,1) = {"
b
b
b
c
c
c
c
c
s
c
c
c
s
h
c
c
c
c
c
c
c
c
c
j
c
c
b
b
b
b
b
b
c
c
a"}(24,1,1) = {"
b
b
b
c
c
c
c
c
c
c
m
c
c
c
c
c
c
c
c
c
h
c
c
c
c
c
e
b
b
b
b
c
c
a
a"}(25,1,1) = {"
a
b
b
b
c
c
c
c
c
m
n
c
c
c
c
c
c
l
i
c
c
c
c
c
c
c
c
c
b
b
b
c
c
a
a"}(26,1,1) = {"
a
b
b
b
c
j
c
c
k
c
c
c
c
c
c
f
c
i
p
m
c
c
c
c
c
c
c
c
b
b
b
c
c
a
a"}(27,1,1) = {"
a
a
b
b
b
c
c
c
c
c
c
c
c
i
m
d
c
c
c
c
c
c
c
c
c
c
c
b
b
b
b
c
c
a
a"}(28,1,1) = {"
a
a
b
b
b
b
c
c
c
c
c
c
p
l
i
c
c
c
c
c
c
e
c
c
c
c
c
b
b
b
c
c
a
a
a"}(29,1,1) = {"
a
c
c
b
b
b
c
c
c
i
c
c
c
c
c
c
c
c
c
c
c
c
c
c
e
c
c
c
b
b
c
c
a
a
a"}(30,1,1) = {"
a
c
c
c
b
b
b
c
c
c
c
c
c
c
j
c
c
c
c
c
b
c
c
c
i
c
f
d
c
b
b
c
a
a
a"}(31,1,1) = {"
b
b
c
c
c
b
b
b
b
c
c
c
c
c
c
r
c
c
c
b
b
b
c
c
c
c
c
c
b
b
b
b
a
a
a"}(32,1,1) = {"
b
b
b
c
c
b
b
b
b
b
b
b
b
b
b
b
b
b
b
b
b
b
b
c
c
c
c
c
c
b
b
b
a
a
a"}(33,1,1) = {"
a
b
b
b
a
a
b
b
b
b
b
b
b
b
b
b
b
b
b
b
b
b
b
b
b
b
c
c
c
c
b
b
a
a
a"}(34,1,1) = {"
a
b
b
b
a
a
a
a
a
a
a
b
b
b
b
b
c
c
c
c
c
b
b
b
b
b
b
b
b
b
b
b
a
a
a"}(35,1,1) = {"
a
a
a
a
a
a
a
a
a
a
a
a
a
a
a
a
a
a
a
a
a
a
b
b
b
b
b
b
b
b
b
a
a
a
a"}