//MAP CONVERTED BY dmm2tgm.py THIS HEADER COMMENT PREVENTS RECONVERSION, DO NOT REMOVE
"aa" = (
/turf/template_noop,
/area/template_noop)
"ac" = (
/turf/open/floor/plating/asteroid/airless,
/area/ruin/unpowered/no_grav)
"ad" = (
/turf/closed/wall,
/area/ruin/space/has_grav/powered/cat_man)
"ae" = (
/obj/structure/closet/crate,
/obj/item/storage/toolbox,
/obj/item/storage/toolbox/mechanical,
/turf/open/floor/plating,
/area/ruin/space/has_grav/powered/cat_man)
"af" = (
/obj/machinery/portable_thermomachine,
/turf/open/floor/plating,
/area/ruin/space/has_grav/powered/cat_man)
"ag" = (
/obj/structure/reagent_dispensers/watertank,
/turf/open/floor/plating,
/area/ruin/space/has_grav/powered/cat_man)
"ah" = (
/turf/open/floor/plating,
/area/ruin/space/has_grav/powered/cat_man)
"ai" = (
/obj/structure/janitorialcart,
/obj/item/mop,
/obj/item/reagent_containers/cup/bucket,
/obj/effect/decal/cleanable/cobweb/cobweb2,
/turf/open/floor/plating,
/area/ruin/space/has_grav/powered/cat_man)
"aj" = (
/obj/structure/table,
/obj/item/reagent_containers/spray/cleaner,
/turf/open/floor/plating,
/area/ruin/space/has_grav/powered/cat_man)
"ak" = (
/obj/structure/mopbucket,
/turf/open/floor/plating,
/area/ruin/space/has_grav/powered/cat_man)
"al" = (
/obj/machinery/atmospherics/pipe/smart/simple/green/hidden{
	dir = 6
	},
/obj/effect/decal/cleanable/dirt,
/obj/effect/decal/cleanable/cobweb,
/obj/structure/closet/emcloset,
/turf/open/floor/plating,
/area/ruin/space/has_grav/powered/cat_man)
"am" = (
/obj/machinery/atmospherics/pipe/smart/simple/green/hidden{
	dir = 4
	},
/turf/open/floor/plating,
/area/ruin/space/has_grav/powered/cat_man)
"an" = (
/obj/machinery/atmospherics/pipe/smart/simple/green/hidden{
	dir = 4
	},
/obj/effect/decal/cleanable/dirt,
/turf/open/floor/plating,
/area/ruin/space/has_grav/powered/cat_man)
"ao" = (
/obj/machinery/atmospherics/pipe/smart/manifold/green/hidden{
	dir = 1
	},
/obj/effect/decal/cleanable/dirt,
/turf/open/floor/plating,
/area/ruin/space/has_grav/powered/cat_man)
"ap" = (
/obj/machinery/atmospherics/pipe/smart/simple/green/hidden{
	dir = 10
	},
/obj/effect/decal/cleanable/dirt,
/turf/open/floor/plating,
/area/ruin/space/has_grav/powered/cat_man)
"aq" = (
/obj/machinery/door/airlock/maintenance_hatch{
	name = "Misc Supplies";
	req_access_txt = "201"
	},
/turf/open/floor/plating,
/area/ruin/space/has_grav/powered/cat_man)
"ar" = (
/obj/machinery/door/airlock/maintenance_hatch{
	name = "Custodial Supplies";
	req_access_txt = "201"
	},
/turf/open/floor/plating,
/area/ruin/space/has_grav/powered/cat_man)
"as" = (
/obj/machinery/atmospherics/pipe/smart/simple/green/hidden,
/turf/closed/wall,
/area/ruin/space/has_grav/powered/cat_man)
"at" = (
/obj/machinery/atmospherics/pipe/smart/simple/green/hidden,
/turf/open/floor/plating,
/area/ruin/space/has_grav/powered/cat_man)
"au" = (
/obj/machinery/door/airlock/external,
/obj/effect/mapping_helpers/airlock/cyclelink_helper{
	dir = 4
	},
/turf/open/floor/plating,
/area/ruin/space/has_grav/powered/cat_man)
"av" = (
/obj/machinery/light/small,
/turf/open/floor/plating,
/area/ruin/space/has_grav/powered/cat_man)
"ay" = (
/obj/effect/decal/cleanable/dirt,
/turf/open/floor/plating,
/area/ruin/space/has_grav/powered/cat_man)
"az" = (
/obj/effect/decal/cleanable/dirt,
/obj/effect/decal/cleanable/blood/old,
/obj/machinery/light/small{
	dir = 1
	},
/obj/machinery/atmospherics/components/unary/vent_pump/on{
	dir = 1
	},
/turf/open/floor/plating,
/area/ruin/space/has_grav/powered/cat_man)
"aA" = (
/obj/effect/decal/cleanable/dirt,
/obj/effect/decal/cleanable/dirt,
/obj/structure/bed/dogbed{
	name = "kitty bed"
	},
/turf/open/floor/plating,
/area/ruin/space/has_grav/powered/cat_man)
"aB" = (
/obj/effect/decal/cleanable/dirt,
/obj/machinery/atmospherics/components/unary/vent_pump/on{
	dir = 1
	},
/turf/open/floor/plating,
/area/ruin/space/has_grav/powered/cat_man)
"aC" = (
/obj/effect/decal/cleanable/dirt,
/obj/effect/decal/cleanable/dirt,
/obj/machinery/light/small{
	dir = 1
	},
/turf/open/floor/plating,
/area/ruin/space/has_grav/powered/cat_man)
"aD" = (
/obj/structure/bed/dogbed{
	name = "kitty bed"
	},
/obj/effect/decal/cleanable/dirt,
/turf/open/floor/plating,
/area/ruin/space/has_grav/powered/cat_man)
"aE" = (
/obj/machinery/atmospherics/pipe/smart/simple/green/hidden,
/obj/effect/decal/cleanable/dirt,
/turf/open/floor/plating,
/area/ruin/space/has_grav/powered/cat_man)
"aI" = (
/turf/open/floor/iron,
/area/ruin/space/has_grav/powered/cat_man)
"aJ" = (
/obj/effect/decal/cleanable/dirt,
/obj/effect/decal/cleanable/dirt,
/turf/open/floor/plating,
/area/ruin/space/has_grav/powered/cat_man)
"aK" = (
/obj/effect/decal/cleanable/dirt,
/obj/item/reagent_containers/cup/bowl,
/turf/open/floor/plating,
/area/ruin/space/has_grav/powered/cat_man)
"aL" = (
/obj/effect/decal/cleanable/dirt,
/obj/effect/decal/cleanable/dirt,
/obj/item/reagent_containers/cup/bowl,
/turf/open/floor/plating,
/area/ruin/space/has_grav/powered/cat_man)
"aM" = (
/obj/machinery/atmospherics/pipe/smart/simple/green/hidden{
	dir = 5
	},
/obj/effect/decal/cleanable/dirt,
/turf/open/floor/plating,
/area/ruin/space/has_grav/powered/cat_man)
"aN" = (
/obj/machinery/door/airlock{
	name = "Private Quarters"
	},
/turf/open/floor/carpet,
/area/ruin/space/has_grav/powered/cat_man)
"aP" = (
/obj/effect/spawner/structure/window/reinforced,
/obj/machinery/door/poddoor/preopen{
	id = "meow";
	name = "kitty Protection Door"
	},
/turf/open/floor/plating,
/area/ruin/space/has_grav/powered/cat_man)
"aQ" = (
/obj/effect/decal/cleanable/dirt,
/obj/machinery/door/poddoor/preopen{
	id = "meow";
	name = "kitty Protection Door"
	},
/obj/machinery/door/window{
	name = "kitty Door";
	req_access_txt = "200"
	},
/turf/open/floor/plating,
/area/ruin/space/has_grav/powered/cat_man)
"aR" = (
/obj/structure/bed/dogbed{
	name = "kitty bed"
	},
/mob/living/simple_animal/pet/cat/space,
/turf/open/floor/carpet,
/area/ruin/space/has_grav/powered/cat_man)
"aS" = (
/turf/open/floor/carpet,
/area/ruin/space/has_grav/powered/cat_man)
"aT" = (
/obj/structure/dresser,
/turf/open/floor/carpet,
/area/ruin/space/has_grav/powered/cat_man)
"aY" = (
/obj/structure/bed/dogbed{
	name = "kitty bed"
	},
/obj/effect/decal/cleanable/dirt,
/obj/effect/mob_spawn/human/corpse/damaged{
	head = /obj/item/clothing/head/costume/kitty
	},
/turf/open/floor/plating,
/area/ruin/space/has_grav/powered/cat_man)
"aZ" = (
/obj/effect/spawner/structure/window/reinforced,
/turf/open/floor/plating,
/area/ruin/space/has_grav/powered/cat_man)
"ba" = (
/obj/structure/table/wood,
/obj/item/flashlight/lamp,
/turf/open/floor/carpet,
/area/ruin/space/has_grav/powered/cat_man)
"bc" = (
/obj/machinery/button/door{
	id = "meow";
	name = "Emergency Kitty Lockdown";
	pixel_x = -24
	},
/turf/open/floor/iron,
/area/ruin/space/has_grav/powered/cat_man)
"bd" = (
/obj/structure/table/reinforced,
/obj/item/hemostat,
/obj/item/cautery{
	pixel_x = 4
	},
/turf/open/floor/iron,
/area/ruin/space/has_grav/powered/cat_man)
"be" = (
/obj/item/organ/tail/cat,
/obj/effect/decal/cleanable/blood/old,
/turf/open/floor/iron/white/corner,
/area/ruin/space/has_grav/powered/cat_man)
"bf" = (
/turf/open/floor/iron/white/side,
/area/ruin/space/has_grav/powered/cat_man)
"bg" = (
/turf/open/floor/iron/white/corner{
	dir = 8
	},
/area/ruin/space/has_grav/powered/cat_man)
"bi" = (
/obj/effect/decal/cleanable/dirt,
/obj/machinery/door/poddoor/preopen{
	id = "meow";
	name = "kitty Protection Door"
	},
/obj/machinery/door/window/westleft{
	name = "kitty Door";
	req_access_txt = "200"
	},
/turf/open/floor/plating,
/area/ruin/space/has_grav/powered/cat_man)
"bj" = (
/obj/effect/decal/cleanable/dirt,
/obj/item/toy/cattoy,
/turf/open/floor/plating,
/area/ruin/space/has_grav/powered/cat_man)
"bk" = (
/obj/effect/decal/cleanable/dirt,
/obj/machinery/atmospherics/components/unary/vent_pump/on{
	dir = 4
	},
/turf/open/floor/plating,
/area/ruin/space/has_grav/powered/cat_man)
"bl" = (
/obj/effect/decal/cleanable/dirt,
/obj/effect/decal/cleanable/dirt,
/obj/effect/decal/cleanable/dirt,
/obj/effect/decal/cleanable/vomit/old,
/obj/machinery/atmospherics/pipe/smart/simple/green/hidden{
	dir = 4
	},
/turf/open/floor/plating,
/area/ruin/space/has_grav/powered/cat_man)
"bm" = (
/obj/machinery/atmospherics/pipe/smart/simple/green/hidden{
	dir = 4
	},
/turf/closed/wall,
/area/ruin/space/has_grav/powered/cat_man)
"bn" = (
/obj/machinery/atmospherics/pipe/smart/manifold/green/hidden{
	dir = 4
	},
/obj/effect/decal/cleanable/dirt,
/turf/open/floor/plating,
/area/ruin/space/has_grav/powered/cat_man)
"bo" = (
/obj/structure/table/wood,
/turf/open/floor/carpet,
/area/ruin/space/has_grav/powered/cat_man)
"bp" = (
/obj/structure/chair/wood/wings{
	dir = 8
	},
/turf/open/floor/carpet,
/area/ruin/space/has_grav/powered/cat_man)
"bq" = (
/obj/machinery/light{
	dir = 8
	},
/turf/open/floor/iron,
/area/ruin/space/has_grav/powered/cat_man)
"br" = (
/obj/structure/table/reinforced,
/obj/item/scalpel{
	pixel_y = 12
	},
/turf/open/floor/iron,
/area/ruin/space/has_grav/powered/cat_man)
"bs" = (
/mob/living/simple_animal/hostile/cat_butcherer,
/turf/open/floor/iron/white/side{
	dir = 4
	},
/area/ruin/space/has_grav/powered/cat_man)
"bt" = (
/obj/structure/table/optable,
/obj/effect/mob_spawn/human/corpse/damaged,
/obj/item/organ/ears/cat,
/obj/effect/decal/cleanable/blood/old,
/turf/open/floor/iron/white,
/area/ruin/space/has_grav/powered/cat_man)
"bu" = (
/obj/structure/table/reinforced,
/obj/item/clothing/gloves/color/latex,
/obj/item/surgical_drapes,
/turf/open/floor/iron/white/side{
	dir = 8
	},
/area/ruin/space/has_grav/powered/cat_man)
"bw" = (
/obj/structure/table/wood,
/obj/item/paper_bin,
/obj/item/pen,
/turf/open/floor/carpet,
/area/ruin/space/has_grav/powered/cat_man)
"bx" = (
/obj/structure/rack,
/obj/item/melee/baton/cattleprod,
/obj/item/melee/baton/cattleprod,
/obj/item/restraints/handcuffs,
/obj/item/restraints/handcuffs,
/turf/open/floor/carpet,
/area/ruin/space/has_grav/powered/cat_man)
"by" = (
/obj/structure/bed,
/turf/open/floor/carpet,
/area/ruin/space/has_grav/powered/cat_man)
"bz" = (
/obj/structure/table/reinforced,
/obj/item/retractor,
/obj/item/razor,
/turf/open/floor/iron,
/area/ruin/space/has_grav/powered/cat_man)
"bA" = (
/turf/open/floor/iron/white/corner{
	dir = 4
	},
/area/ruin/space/has_grav/powered/cat_man)
"bB" = (
/turf/open/floor/iron/white/side{
	dir = 1
	},
/area/ruin/space/has_grav/powered/cat_man)
"bC" = (
/turf/open/floor/iron/white/corner{
	dir = 1
	},
/area/ruin/space/has_grav/powered/cat_man)
"bD" = (
/obj/structure/bed/dogbed{
	name = "kitty bed"
	},
/obj/effect/decal/cleanable/dirt,
/obj/effect/decal/cleanable/dirt,
/turf/open/floor/plating,
/area/ruin/space/has_grav/powered/cat_man)
"bH" = (
/obj/effect/decal/cleanable/dirt,
/obj/effect/decal/cleanable/dirt,
/obj/effect/decal/cleanable/blood/old,
/obj/machinery/light/small,
/obj/machinery/atmospherics/components/unary/vent_pump/on{
	dir = 4
	},
/turf/open/floor/plating,
/area/ruin/space/has_grav/powered/cat_man)
"bI" = (
/obj/effect/decal/cleanable/dirt,
/obj/effect/decal/cleanable/dirt,
/obj/effect/decal/cleanable/dirt,
/obj/machinery/atmospherics/pipe/smart/simple/green/hidden{
	dir = 4
	},
/turf/open/floor/plating,
/area/ruin/space/has_grav/powered/cat_man)
"bN" = (
/obj/machinery/door/firedoor,
/turf/open/floor/iron,
/area/ruin/space/has_grav/powered/cat_man)
"bO" = (
/obj/effect/decal/cleanable/dirt,
/obj/machinery/door/poddoor/preopen{
	id = "meow";
	name = "kitty Protection Door"
	},
/obj/machinery/door/window/northleft{
	name = "kitty Door";
	req_access_txt = "200"
	},
/turf/open/floor/plating,
/area/ruin/space/has_grav/powered/cat_man)
"bP" = (
/obj/effect/decal/cleanable/dirt,
/obj/effect/decal/cleanable/blood/old,
/turf/open/floor/plating,
/area/ruin/space/has_grav/powered/cat_man)
"bQ" = (
/obj/effect/decal/cleanable/dirt,
/obj/effect/decal/cleanable/dirt,
/obj/item/toy/cattoy,
/turf/open/floor/plating,
/area/ruin/space/has_grav/powered/cat_man)
"bR" = (
/obj/machinery/atmospherics/pipe/smart/simple/green/hidden{
	dir = 6
	},
/obj/effect/decal/cleanable/cobweb,
/turf/open/floor/plating,
/area/ruin/space/has_grav/powered/cat_man)
"bS" = (
/obj/machinery/atmospherics/pipe/smart/simple/green/hidden{
	dir = 9
	},
/obj/effect/decal/cleanable/dirt,
/turf/open/floor/plating,
/area/ruin/space/has_grav/powered/cat_man)
"bU" = (
/obj/effect/decal/cleanable/dirt,
/obj/machinery/atmospherics/pipe/smart/simple/green/hidden{
	dir = 6
	},
/turf/open/floor/plating,
/area/ruin/space/has_grav/powered/cat_man)
"bV" = (
/obj/effect/decal/cleanable/dirt,
/obj/machinery/light/small,
/obj/machinery/atmospherics/components/unary/vent_pump/on{
	dir = 8
	},
/turf/open/floor/plating,
/area/ruin/space/has_grav/powered/cat_man)
"bW" = (
/obj/effect/decal/cleanable/dirt,
/obj/effect/decal/cleanable/dirt,
/obj/structure/bed/dogbed{
	name = "kitty bed"
	},
/obj/effect/mob_spawn/human/corpse/damaged{
	head = /obj/item/clothing/head/costume/kitty
	},
/turf/open/floor/plating,
/area/ruin/space/has_grav/powered/cat_man)
"bY" = (
/obj/machinery/door/airlock/maintenance_hatch{
	req_access_txt = "201"
	},
/turf/open/floor/plating,
/area/ruin/space/has_grav/powered/cat_man)
"bZ" = (
/obj/machinery/atmospherics/pipe/smart/simple/green/hidden{
	dir = 5
	},
/turf/open/floor/plating,
/area/ruin/space/has_grav/powered/cat_man)
"ca" = (
/obj/machinery/atmospherics/pipe/smart/manifold/green/hidden{
	dir = 1
	},
/turf/open/floor/plating,
/area/ruin/space/has_grav/powered/cat_man)
"cb" = (
/obj/machinery/atmospherics/pipe/smart/manifold/green/hidden,
/obj/effect/decal/cleanable/dirt,
/turf/open/floor/plating,
/area/ruin/space/has_grav/powered/cat_man)
"cc" = (
/obj/machinery/atmospherics/pipe/smart/simple/green/hidden{
	dir = 9
	},
/turf/open/floor/plating,
/area/ruin/space/has_grav/powered/cat_man)
"cd" = (
/obj/machinery/light/small{
	dir = 8
	},
/obj/machinery/atmospherics/components/unary/portables_connector/visible{
	dir = 4
	},
/obj/machinery/portable_atmospherics/canister/oxygen,
/turf/open/floor/plating,
/area/ruin/space/has_grav/powered/cat_man)
"ce" = (
/obj/machinery/atmospherics/pipe/smart/simple/dark/hidden{
	dir = 10
	},
/turf/open/floor/plating,
/area/ruin/space/has_grav/powered/cat_man)
"cf" = (
/obj/machinery/atmospherics/components/binary/valve{
	name = "kitty sleep gas"
	},
/turf/open/floor/plating,
/area/ruin/space/has_grav/powered/cat_man)
"cg" = (
/obj/machinery/door/airlock/maintenance_hatch{
	name = "Portable Atmos Equipment";
	req_access_txt = "201"
	},
/turf/open/floor/plating/airless,
/area/ruin/space/has_grav/powered/cat_man)
"ch" = (
/obj/machinery/atmospherics/components/unary/thermomachine/freezer{
	dir = 4
	},
/turf/open/floor/plating,
/area/ruin/space/has_grav/powered/cat_man)
"ci" = (
/obj/effect/decal/cleanable/dirt,
/obj/machinery/atmospherics/pipe/smart/manifold/dark/hidden{
	dir = 4
	},
/turf/open/floor/plating,
/area/ruin/space/has_grav/powered/cat_man)
"cj" = (
/obj/machinery/atmospherics/pipe/smart/simple/green/hidden{
	dir = 5
	},
/obj/structure/table,
/obj/item/storage/toolbox/mechanical,
/obj/item/wrench,
/turf/open/floor/plating,
/area/ruin/space/has_grav/powered/cat_man)
"ck" = (
/obj/effect/spawner/structure/window/reinforced,
/obj/machinery/atmospherics/pipe/smart/simple/green/hidden{
	dir = 4
	},
/turf/open/floor/plating,
/area/ruin/space/has_grav/powered/cat_man)
"cl" = (
/obj/machinery/atmospherics/components/unary/vent_pump/siphon/monitored{
	dir = 8;
	id_tag = "n2o_out_cat";
	name = "n2o out"
	},
/turf/open/floor/plating/airless,
/area/ruin/space/has_grav/powered/cat_man)
"cm" = (
/turf/open/floor/plating/airless,
/area/ruin/space/has_grav/powered/cat_man)
"cn" = (
/obj/machinery/portable_atmospherics/pump,
/turf/open/floor/plating/airless,
/area/ruin/space/has_grav/powered/cat_man)
"co" = (
/obj/machinery/atmospherics/pipe/smart/simple/dark/hidden,
/turf/closed/wall,
/area/ruin/space/has_grav/powered/cat_man)
"cp" = (
/obj/machinery/door/airlock{
	name = "Limb Storage";
	req_access_txt = "200"
	},
/turf/open/floor/iron/freezer,
/area/ruin/space/has_grav/powered/cat_man)
"cq" = (
/obj/machinery/atmospherics/miner/n2o,
/turf/open/floor/plating/airless,
/area/ruin/space/has_grav/powered/cat_man)
"cr" = (
/obj/machinery/portable_atmospherics/scrubber,
/turf/open/floor/plating/airless,
/area/ruin/space/has_grav/powered/cat_man)
"cs" = (
/obj/machinery/atmospherics/components/unary/vent_pump/siphon/monitored{
	dir = 1;
	id_tag = "o2_out_cat";
	name = "freezer vent"
	},
/obj/structure/closet/crate/freezer{
	name = "cat hide"
	},
/obj/item/stack/sheet/animalhide/human,
/obj/item/stack/sheet/animalhide/human,
/obj/item/stack/sheet/animalhide/human,
/obj/item/stack/sheet/animalhide/human,
/obj/item/stack/sheet/animalhide/human,
/obj/item/stack/sheet/animalhide/human,
/obj/item/stack/sheet/animalhide/human,
/obj/item/stack/sheet/animalhide/human,
/obj/item/stack/sheet/animalhide/human,
/obj/item/stack/sheet/animalhide/human,
/obj/item/stack/sheet/animalhide/human,
/turf/open/floor/iron/freezer,
/area/ruin/space/has_grav/powered/cat_man)
"ct" = (
/turf/open/floor/iron/freezer,
/area/ruin/space/has_grav/powered/cat_man)
"cu" = (
/obj/structure/closet/crate/freezer{
	name = "cat ears"
	},
/obj/item/organ/ears/cat,
/obj/item/organ/ears/cat,
/obj/item/organ/ears/cat,
/obj/item/organ/ears/cat,
/obj/item/organ/ears/cat,
/obj/item/organ/ears/cat,
/turf/open/floor/iron/freezer,
/area/ruin/space/has_grav/powered/cat_man)
"cw" = (
/obj/machinery/light/small,
/turf/open/floor/iron/freezer,
/area/ruin/space/has_grav/powered/cat_man)
"cx" = (
/obj/structure/closet/crate/freezer{
	name = "cat tails"
	},
/obj/item/organ/tail/cat,
/obj/item/organ/tail/cat,
/obj/item/organ/tail/cat,
/obj/item/organ/tail/cat,
/obj/item/organ/tail/cat,
/obj/item/organ/tail/cat,
/turf/open/floor/iron/freezer,
/area/ruin/space/has_grav/powered/cat_man)
"fs" = (
/obj/effect/decal/cleanable/dirt,
/obj/item/kirbyplants/random,
/obj/effect/turf_decal/tile/neutral/half/contrasted{
	dir = 4
	},
/turf/open/floor/iron,
/area/ruin/space/has_grav/powered/cat_man)
"ho" = (
/obj/machinery/firealarm{
	dir = 4;
	pixel_x = 24
	},
/obj/effect/turf_decal/tile/neutral/half/contrasted,
/turf/open/floor/iron,
/area/ruin/space/has_grav/powered/cat_man)
"hz" = (
/obj/effect/decal/cleanable/dirt,
/obj/effect/decal/cleanable/dirt,
/obj/item/reagent_containers/cup/bowl,
/obj/item/food/meat/slab/synthmeat{
	desc = "A slab of cat meat. Tastes like furball.";
	name = "cat meat"
	},
/obj/machinery/light/small{
	dir = 1
	},
/turf/open/floor/plating,
/area/ruin/space/has_grav/powered/cat_man)
"ml" = (
/obj/structure/reagent_dispensers/water_cooler,
/obj/effect/turf_decal/tile/neutral/half/contrasted{
	dir = 4
	},
/turf/open/floor/iron,
/area/ruin/space/has_grav/powered/cat_man)
"mA" = (
/obj/effect/decal/cleanable/dirt,
/obj/effect/turf_decal/tile/neutral/half/contrasted{
	dir = 4
	},
/turf/open/floor/iron,
/area/ruin/space/has_grav/powered/cat_man)
"mI" = (
/turf/closed/mineral,
/area/ruin/unpowered/no_grav)
"nI" = (
/obj/structure/closet/crate/freezer{
	name = "cat meat"
	},
/obj/item/food/meat/slab/synthmeat{
	desc = "A slab of cat meat. Tastes like furball.";
	name = "cat meat"
	},
/obj/item/food/meat/slab/synthmeat{
	desc = "A slab of cat meat. Tastes like furball.";
	name = "cat meat"
	},
/obj/item/food/meat/slab/synthmeat{
	desc = "A slab of cat meat. Tastes like furball.";
	name = "cat meat"
	},
/obj/item/food/meat/slab/synthmeat{
	desc = "A slab of cat meat. Tastes like furball.";
	name = "cat meat"
	},
/obj/item/food/meat/slab/synthmeat{
	desc = "A slab of cat meat. Tastes like furball.";
	name = "cat meat"
	},
/obj/item/food/meat/slab/synthmeat{
	desc = "A slab of cat meat. Tastes like furball.";
	name = "cat meat"
	},
/obj/item/food/meat/slab/synthmeat{
	desc = "A slab of cat meat. Tastes like furball.";
	name = "cat meat"
	},
/obj/item/food/meat/slab/synthmeat{
	desc = "A slab of cat meat. Tastes like furball.";
	name = "cat meat"
	},
/turf/open/floor/iron/freezer,
/area/ruin/space/has_grav/powered/cat_man)
"nY" = (
/obj/effect/decal/cleanable/dirt,
/obj/item/kirbyplants/random,
/obj/effect/turf_decal/tile/neutral/half/contrasted{
	dir = 8
	},
/turf/open/floor/iron,
/area/ruin/space/has_grav/powered/cat_man)
"rY" = (
/obj/effect/decal/cleanable/dirt,
/obj/effect/turf_decal/tile/neutral/half/contrasted{
	dir = 8
	},
/turf/open/floor/iron,
/area/ruin/space/has_grav/powered/cat_man)
"tk" = (
/obj/machinery/firealarm{
	dir = 1;
	pixel_y = -24
	},
/obj/effect/turf_decal/tile/neutral/half/contrasted{
	dir = 8
	},
/turf/open/floor/iron,
/area/ruin/space/has_grav/powered/cat_man)
"tT" = (
/obj/effect/turf_decal/tile/neutral/half/contrasted{
	dir = 8
	},
/turf/open/floor/iron,
/area/ruin/space/has_grav/powered/cat_man)
"Bj" = (
/obj/effect/decal/cleanable/dirt,
/obj/effect/turf_decal/tile/neutral/half/contrasted,
/turf/open/floor/iron,
/area/ruin/space/has_grav/powered/cat_man)
"Bl" = (
/obj/machinery/door/airlock/external,
/obj/effect/mapping_helpers/airlock/cyclelink_helper{
	dir = 1
	},
/turf/open/floor/plating,
/area/ruin/space/has_grav/powered/cat_man)
"Bm" = (
/obj/item/kirbyplants/random,
/obj/effect/turf_decal/tile/neutral/half/contrasted{
	dir = 8
	},
/turf/open/floor/iron,
/area/ruin/space/has_grav/powered/cat_man)
"Bo" = (
/obj/effect/decal/cleanable/dirt,
/obj/effect/turf_decal/tile/neutral/anticorner/contrasted,
/turf/open/floor/iron,
/area/ruin/space/has_grav/powered/cat_man)
"BQ" = (
/obj/structure/chair,
/obj/effect/turf_decal/tile/neutral/half/contrasted{
	dir = 4
	},
/turf/open/floor/iron,
/area/ruin/space/has_grav/powered/cat_man)
"Cr" = (
/obj/machinery/light{
	dir = 4
	},
/obj/structure/closet/cabinet,
/obj/item/gps{
	gpstag = "kitty"
	},
/turf/open/floor/carpet,
/area/ruin/space/has_grav/powered/cat_man)
"CZ" = (
/obj/effect/turf_decal/tile/neutral/anticorner/contrasted{
	dir = 4
	},
/turf/open/floor/iron,
/area/ruin/space/has_grav/powered/cat_man)
"Eo" = (
/obj/effect/turf_decal/tile/neutral/half/contrasted{
	dir = 4
	},
/turf/open/floor/iron,
/area/ruin/space/has_grav/powered/cat_man)
"IN" = (
/obj/machinery/light{
	dir = 1
	},
/obj/effect/turf_decal/tile/neutral/half/contrasted{
	dir = 4
	},
/turf/open/floor/iron,
/area/ruin/space/has_grav/powered/cat_man)
"NJ" = (
/obj/effect/decal/cleanable/dirt,
/obj/effect/decal/cleanable/dirt,
/obj/item/food/meat/slab/synthmeat{
	desc = "A slab of cat meat. Tastes like furball.";
	name = "cat meat"
	},
/obj/machinery/atmospherics/pipe/smart/simple/green/hidden{
	dir = 6
	},
/turf/open/floor/plating,
/area/ruin/space/has_grav/powered/cat_man)
"Oi" = (
/obj/structure/table,
/obj/effect/turf_decal/tile/neutral/half/contrasted{
	dir = 4
	},
/turf/open/floor/iron,
/area/ruin/space/has_grav/powered/cat_man)
"OG" = (
/obj/machinery/light,
/obj/effect/turf_decal/tile/neutral/half/contrasted{
	dir = 8
	},
/turf/open/floor/iron,
/area/ruin/space/has_grav/powered/cat_man)
"RT" = (
/obj/machinery/door/airlock/external,
/obj/effect/mapping_helpers/airlock/cyclelink_helper,
/turf/open/floor/plating,
/area/ruin/space/has_grav/powered/cat_man)
"Sl" = (
/obj/machinery/door/airlock/external,
/obj/effect/mapping_helpers/airlock/cyclelink_helper{
	dir = 8
	},
/turf/open/floor/plating,
/area/ruin/space/has_grav/powered/cat_man)
"SV" = (
/obj/structure/closet/crate/bin,
/obj/effect/turf_decal/tile/neutral/half/contrasted{
	dir = 4
	},
/turf/open/floor/iron,
/area/ruin/space/has_grav/powered/cat_man)

(1,1,1) = {"
aa
aa
aa
aa
aa
aa
aa
aa
aa
aa
aa
aa
aa
aa
aa
aa
mI
mI
mI
mI
mI
mI
mI
aa
aa
aa
aa
aa
aa
aa
"}
(2,1,1) = {"
aa
aa
aa
aa
aa
aa
aa
mI
mI
mI
mI
ac
ac
ac
ac
ac
mI
mI
mI
mI
mI
mI
mI
aa
aa
aa
aa
aa
aa
aa
"}
(3,1,1) = {"
aa
aa
aa
aa
aa
aa
mI
mI
mI
mI
ac
ac
ac
ac
ac
ac
mI
mI
mI
mI
mI
mI
mI
mI
mI
aa
aa
aa
aa
aa
"}
(4,1,1) = {"
aa
aa
aa
aa
mI
mI
mI
mI
mI
mI
mI
ac
ac
ac
ac
ac
mI
mI
mI
mI
mI
mI
mI
mI
mI
mI
mI
mI
aa
aa
"}
(5,1,1) = {"
aa
aa
mI
mI
mI
mI
ac
ac
ac
mI
mI
ac
ac
ac
ac
mI
mI
mI
mI
mI
mI
mI
mI
mI
mI
mI
mI
mI
aa
aa
"}
(6,1,1) = {"
aa
aa
ac
ac
ac
ac
ac
ad
au
ad
mI
mI
ac
ac
ac
mI
mI
mI
mI
mI
mI
mI
mI
mI
mI
ac
ac
mI
aa
aa
"}
(7,1,1) = {"
aa
aa
mI
mI
mI
mI
mI
ad
av
ad
mI
ad
aZ
aZ
aZ
ad
ad
ad
ad
ad
ac
ac
ac
ac
ac
ac
ac
ac
aa
aa
"}
(8,1,1) = {"
aa
aa
mI
mI
ad
ad
ad
ad
Sl
ad
ad
ad
ba
bo
bw
ad
SV
aI
Bm
ad
aZ
ad
ac
ac
ac
ac
ac
ac
aa
aa
"}
(9,1,1) = {"
aa
mI
mI
mI
ad
ae
ah
ad
Eo
Bm
ad
aR
aS
bp
bx
ad
Oi
aI
tT
RT
ah
Bl
ac
ac
ac
ac
ac
ac
aa
aa
"}
(10,1,1) = {"
mI
mI
mI
mI
ad
af
ah
aq
Eo
tT
aN
aS
aS
aS
aS
ad
BQ
aI
tk
ad
aZ
ad
ac
ac
ac
ac
ac
ac
aa
aa
"}
(11,1,1) = {"
aa
mI
mI
mI
ad
ad
ad
ad
IN
tk
ad
aT
Cr
aS
by
ad
ml
aI
OG
ad
ac
ac
ac
ac
ac
ac
ac
ac
aa
aa
"}
(12,1,1) = {"
aa
aa
mI
mI
ad
ag
aj
ad
Eo
tT
ad
ad
ad
ad
ad
ad
ad
aI
tT
ad
ad
ad
ad
ad
mI
mI
ac
mI
aa
aa
"}
(13,1,1) = {"
aa
aa
mI
mI
ad
ah
ah
ar
Eo
aI
bN
aI
bc
bq
aI
aI
bN
aI
tT
bY
ay
cd
ch
ad
ad
ad
ad
mI
aa
aa
"}
(14,1,1) = {"
aa
mI
mI
mI
ad
ai
ak
ad
ad
ad
ad
Eo
bd
br
bz
tT
ad
ad
ad
ad
ah
ce
ci
co
cs
nI
ad
mI
mI
aa
"}
(15,1,1) = {"
aa
mI
mI
mI
ad
ad
ad
ad
ay
ay
aP
Eo
be
bs
bA
tT
aP
bP
bU
as
bZ
ay
ah
cp
ct
cw
ad
mI
mI
aa
"}
(16,1,1) = {"
aa
mI
mI
mI
mI
ad
al
as
az
aJ
aP
Eo
bf
bt
bB
rY
aP
bQ
bV
ad
ca
cf
cj
ad
cu
cx
ad
mI
mI
aa
"}
(17,1,1) = {"
aa
mI
mI
mI
mI
ad
am
ad
aA
aK
aQ
mA
bg
bu
bC
tT
bO
aK
bW
ad
an
ad
ck
ad
ad
ad
ad
mI
mI
aa
"}
(18,1,1) = {"
aa
mI
mI
mI
mI
ad
an
ad
ad
ad
ad
fs
aI
aI
aI
nY
ad
ad
ad
ad
an
ad
cl
cm
ad
mI
mI
mI
aa
aa
"}
(19,1,1) = {"
aa
mI
mI
mI
mI
ad
ao
as
aB
ay
aQ
CZ
Bj
ho
Bj
Bo
bO
ay
NJ
as
cb
ad
cm
cq
ad
mI
mI
mI
aa
aa
"}
(20,1,1) = {"
aa
mI
mI
mI
mI
ad
an
ad
aC
aJ
ad
aP
bi
ad
bi
aP
ad
aJ
bV
ad
an
ad
ad
ad
ad
mI
mI
mI
aa
aa
"}
(21,1,1) = {"
aa
mI
mI
mI
mI
ad
an
ad
aD
aL
ad
ay
bj
ad
ay
ay
ad
aK
aD
ad
am
cg
cm
cr
ad
mI
mI
mI
mI
mI
"}
(22,1,1) = {"
aa
mI
mI
mI
mI
ad
am
ad
ad
ad
ad
hz
bk
ad
aL
bH
ad
ad
ad
ad
an
ad
cn
cr
ad
mI
mI
mI
aa
aa
"}
(23,1,1) = {"
aa
aa
aa
mI
mI
ad
ap
at
aE
aM
ad
aY
bl
ad
bD
bI
ad
bR
aE
aE
cc
ad
ad
ad
ad
mI
mI
aa
aa
aa
"}
(24,1,1) = {"
aa
aa
aa
mI
mI
ad
ad
ad
ad
am
ad
ad
bm
ad
ad
bm
ad
am
ad
ad
ad
ad
mI
mI
mI
mI
mI
aa
aa
aa
"}
(25,1,1) = {"
aa
aa
aa
aa
mI
mI
mI
mI
ad
ap
at
aE
bn
aE
at
bn
aE
bS
ad
mI
mI
mI
mI
mI
mI
mI
mI
aa
aa
aa
"}
(26,1,1) = {"
aa
aa
aa
aa
mI
mI
mI
mI
ad
ad
ad
ad
ad
ad
ad
ad
ad
ad
ad
mI
mI
mI
mI
mI
mI
mI
mI
aa
aa
aa
"}
(27,1,1) = {"
aa
aa
aa
aa
mI
mI
mI
mI
mI
mI
mI
mI
mI
mI
mI
mI
mI
mI
mI
mI
mI
mI
mI
mI
mI
aa
aa
aa
aa
aa
"}
(28,1,1) = {"
aa
aa
aa
aa
mI
mI
mI
mI
mI
mI
mI
mI
mI
mI
mI
mI
mI
mI
mI
mI
mI
mI
mI
mI
mI
aa
aa
aa
aa
aa
"}
(29,1,1) = {"
aa
aa
aa
aa
mI
mI
mI
mI
mI
mI
mI
mI
mI
mI
mI
mI
mI
mI
mI
mI
mI
mI
mI
mI
mI
aa
aa
aa
aa
aa
"}
(30,1,1) = {"
aa
aa
aa
aa
aa
aa
aa
mI
mI
mI
mI
mI
mI
mI
mI
mI
mI
mI
mI
mI
mI
aa
aa
aa
aa
aa
aa
aa
aa
aa
"}
(31,1,1) = {"
aa
aa
aa
aa
aa
aa
aa
mI
mI
mI
mI
mI
mI
mI
mI
aa
aa
aa
aa
aa
aa
aa
aa
aa
aa
aa
aa
aa
aa
aa
"}
(32,1,1) = {"
aa
aa
aa
aa
aa
aa
aa
aa
aa
mI
mI
mI
aa
aa
aa
aa
aa
aa
aa
aa
aa
aa
aa
aa
aa
aa
aa
aa
aa
aa
"}
(33,1,1) = {"
aa
aa
aa
aa
aa
aa
aa
aa
aa
mI
mI
mI
aa
aa
aa
aa
aa
aa
aa
aa
aa
aa
aa
aa
aa
aa
aa
aa
aa
aa
"}
