"aa" = (/turf/open/space/basic,/area/space)
"ab" = (/turf/closed/wall/r_wall,/area/ruin/space/has_grav/storage/materials3)
"ac" = (/obj/structure/closet/crate,/obj/effect/spawner/lootdrop/maintenance/four,/turf/open/floor/plasteel,/area/ruin/space/has_grav/storage/materials3)
"ad" = (/turf/closed/wall/r_wall,/area/ruin/space/has_grav/storage/materials2)
"ae" = (/turf/open/floor/plasteel,/area/ruin/space/has_grav/storage/materials3)
"af" = (/obj/effect/decal/cleanable/blood/footprints{icon_state = "blood1"; dir = 4},/turf/open/floor/plasteel,/area/ruin/space/has_grav/storage/materials2)
"ag" = (/obj/item/storage/pill_bottle,/obj/effect/decal/cleanable/blood/footprints{icon_state = "blood1"; dir = 4},/turf/open/floor/plasteel,/area/ruin/space/has_grav/storage/materials2)
"ah" = (/obj/effect/mob_spawn/human/corpse/cargo_tech,/turf/open/floor/plasteel,/area/ruin/space/has_grav/storage/materials2)
"ai" = (/turf/closed/wall/r_wall,/area/ruin/space/has_grav/storage/materials1)
"aj" = (/obj/machinery/power/apc/auto_name/west{start_charge = 0},/obj/structure/cable{icon_state = "0-4"},/turf/open/floor/plasteel,/area/ruin/space/has_grav/storage/materials3)
"ak" = (/obj/effect/decal/cleanable/blood/footprints{icon_state = "blood1"; dir = 1},/turf/open/floor/plasteel,/area/ruin/space/has_grav/storage/materials2)
"al" = (/obj/machinery/power/apc/auto_name/east{start_charge = 0},/obj/structure/cable{icon_state = "0-8"},/turf/open/floor/plasteel,/area/ruin/space/has_grav/storage/materials2)
"am" = (/turf/open/floor/plasteel,/area/ruin/space/has_grav/storage/materials2)
"an" = (/obj/structure/closet/crate/secure/weapon,/obj/item/ammo_box/magazine/smgm9mm,/obj/item/ammo_box/magazine/smgm9mm/ap,/obj/item/ammo_box/magazine/smgm9mm,/turf/open/floor/plasteel,/area/ruin/space/has_grav/storage/materials2)
"ao" = (/turf/open/space/basic,/area/ruin/space/has_grav/storage/materials2)
"ap" = (/obj/effect/decal/cleanable/cobweb,/turf/open/floor/plasteel,/area/ruin/space/has_grav/storage/materials1)
"aq" = (/turf/open/floor/plasteel,/area/ruin/space/has_grav/storage/materials1)
"ar" = (/mob/living/carbon/human/species/golem/alien_alloy,/turf/open/floor/plasteel,/area/ruin/space/has_grav/storage/central)
"as" = (/obj/structure/cable{icon_state = "2-8"},/obj/structure/cable{icon_state = "2-4"},/turf/open/floor/plasteel,/area/ruin/space/has_grav/storage/materials1)
"at" = (/obj/structure/cable{icon_state = "4-8"},/turf/open/floor/plasteel,/area/ruin/space/has_grav/storage/materials1)
"au" = (/obj/machinery/door/airlock/highsecurity,/obj/effect/mapping_helpers/airlock/locked,/turf/open/floor/plasteel,/area/ruin/space/has_grav/storage/materials3)
"av" = (/obj/structure/falsewall/reinforced,/obj/effect/decal/cleanable/blood/footprints{icon_state = "blood1"; dir = 1},/turf/open/floor/plasteel,/area/ruin/space/has_grav/storage/materials2)
"aw" = (/obj/structure/closet/syndicate/resources{name = "Resourse storage"},/obj/effect/decal/cleanable/cobweb,/turf/open/floor/plasteel,/area/ruin/space/has_grav/storage/materials2)
"ax" = (/obj/structure/closet/syndicate/resources{name = "Resourse storage"},/turf/open/floor/plasteel,/area/ruin/space/has_grav/storage/materials2)
"ay" = (/obj/machinery/doorButtons/access_button,/turf/closed/wall/r_wall,/area/ruin/space/has_grav/storage/materials2)
"az" = (/obj/structure/cable{icon_state = "1-2"},/obj/effect/decal/cleanable/blood/tracks{icon_state = "tracks"; dir = 9},/turf/open/floor/plasteel,/area/ruin/space/has_grav/storage/materials1)
"aA" = (/obj/effect/decal/cleanable/blood/tracks{icon_state = "tracks"; dir = 4},/turf/open/floor/plasteel,/area/ruin/space/has_grav/storage/materials1)
"aB" = (/obj/machinery/door/airlock/highsecurity,/obj/effect/decal/cleanable/blood/tracks{icon_state = "tracks"; dir = 4},/obj/effect/mapping_helpers/airlock/locked,/turf/open/floor/plasteel,/area/ruin/space/has_grav/storage/materials2)
"aC" = (/obj/effect/decal/cleanable/blood,/turf/open/floor/plasteel,/area/ruin/space/has_grav/storage/materials2)
"aD" = (/obj/machinery/door/airlock/highsecurity,/obj/effect/mapping_helpers/airlock/locked,/turf/open/floor/plasteel,/area/ruin/space/has_grav/storage/materials2)
"aE" = (/obj/item/bear_armor,/turf/open/floor/plasteel,/area/ruin/space/has_grav/storage/materials2)
"aF" = (/obj/structure/cable{icon_state = "1-2"},/obj/effect/decal/cleanable/blood/tracks,/turf/open/floor/plasteel,/area/ruin/space/has_grav/storage/materials1)
"aG" = (/obj/machinery/door/airlock/highsecurity,/obj/structure/cable{icon_state = "1-2"},/obj/effect/decal/cleanable/blood/tracks,/obj/effect/mapping_helpers/airlock/locked,/turf/open/floor/plasteel,/area/ruin/space/has_grav/storage/materials1)
"aH" = (/obj/structure/closet/syndicate/resources{name = "Resourse storage"},/obj/effect/decal/cleanable/blood,/turf/open/floor/plasteel,/area/ruin/space/has_grav/storage/materials2)
"aI" = (/obj/effect/spawner/lootdrop/glowstick,/turf/open/floor/plasteel,/area/ruin/space/has_grav/storage/materials1)
"aJ" = (/obj/effect/decal/cleanable/cobweb,/turf/open/floor/plasteel,/area/ruin/space/has_grav/storage/materials2)
"aK" = (/obj/structure/falsewall/reinforced,/turf/open/floor/plasteel,/area/ruin/space/has_grav/storage/materials2)
"aL" = (/obj/machinery/power/apc/auto_name/south{start_charge = 0},/obj/structure/cable{icon_state = "0-8"},/turf/open/floor/plasteel,/area/ruin/space/has_grav/storage/central2)
"aM" = (/turf/closed/wall/r_wall,/area/ruin/space/has_grav/storage/power1)
"aN" = (/obj/machinery/door/airlock/highsecurity,/obj/structure/cable{icon_state = "1-2"},/obj/effect/decal/cleanable/blood/tracks,/obj/effect/decal/cleanable/blood/tracks,/obj/effect/mapping_helpers/airlock/locked,/turf/open/floor/plasteel,/area/ruin/space/has_grav/storage/materials1)
"aO" = (/obj/structure/cable{icon_state = "4-8"},/turf/closed/wall/r_wall,/area/ruin/space/has_grav/storage/power2)
"aP" = (/obj/structure/cable{icon_state = "2-8"},/obj/structure/cable{icon_state = "2-4"},/turf/closed/wall/r_wall,/area/ruin/space/has_grav/storage/power2)
"aQ" = (/obj/structure/cable{icon_state = "1-8"},/turf/closed/wall/r_wall,/area/ruin/space/has_grav/storage/power2)
"aR" = (/turf/closed/wall/r_wall,/area/ruin/space/has_grav/storage/power2)
"aS" = (/turf/closed/wall/r_wall,/area/ruin/space/has_grav/storage/power3)
"aT" = (/obj/structure/closet/crate/secure/loot,/obj/effect/decal/cleanable/cobweb,/turf/open/floor/plasteel,/area/ruin/space/has_grav/storage/power3)
"aU" = (/turf/open/floor/plasteel,/area/ruin/space/has_grav/storage/power3)
"aV" = (/obj/effect/decal/cleanable/cobweb,/turf/open/floor/plasteel,/area/ruin/space/has_grav/storage/power1)
"aW" = (/obj/structure/cable{icon_state = "1-2"},/obj/effect/decal/cleanable/blood/footprints{icon_state = "blood1"; dir = 1},/turf/open/floor/plasteel,/area/ruin/space/has_grav/storage/power1)
"aX" = (/turf/open/floor/plasteel,/area/ruin/space/has_grav/storage/power1)
"aY" = (/turf/closed/wall/r_wall,/area/ruin/space/has_grav/storage/central)
"aZ" = (/obj/item/trash/pistachios,/obj/item/storage/pill_bottle/floorpill/full,/turf/open/floor/plasteel,/area/ruin/space/has_grav/storage/central)
"ba" = (/obj/structure/closet/toolcloset,/obj/effect/decal/cleanable/cobweb,/turf/open/floor/plasteel,/area/ruin/space/has_grav/storage/power2)
"bb" = (/obj/item/trash/sosjerky,/obj/item/trash/syndi_cakes,/obj/effect/mob_spawn/human/corpse/cargo_tech,/turf/open/floor/plasteel,/area/ruin/space/has_grav/storage/central)
"bc" = (/obj/structure/closet/toolcloset,/turf/open/floor/plasteel,/area/ruin/space/has_grav/storage/power2)
"bd" = (/obj/effect/decal/cleanable/blood/splatter,/obj/effect/mob_spawn/human/corpse/cargo_tech,/obj/item/weldingtool/mini,/obj/item/storage/pill_bottle/lsd,/turf/open/floor/plasteel,/area/ruin/space/has_grav/storage/central)
"be" = (/obj/effect/decal/cleanable/cobweb/cobweb2,/turf/open/floor/plasteel,/area/ruin/space/has_grav/storage/materials1)
"bf" = (/obj/item/storage/pill_bottle,/turf/open/floor/plasteel,/area/ruin/space/has_grav/storage/materials2)
"bg" = (/obj/structure/cable{icon_state = "2-4"},/turf/open/floor/plasteel,/area/ruin/space/has_grav/storage/materials2)
"bh" = (/obj/machinery/power/apc/auto_name/north{start_charge = 0},/turf/open/floor/plasteel,/area/ruin/space/has_grav/storage/central)
"bi" = (/turf/open/floor/plasteel,/area/ruin/space/has_grav/storage/power2)
"bj" = (/obj/machinery/vending/engivend,/turf/open/floor/plasteel,/area/ruin/space/has_grav/storage/power2)
"bk" = (/turf/closed/wall/r_wall,/area/ruin/space/has_grav/storage/central2)
"bl" = (/turf/closed/wall,/area/ruin/space/has_grav/storage/central)
"bm" = (/obj/structure/falsewall/reinforced,/obj/effect/decal/cleanable/blood/tracks,/turf/open/floor/plasteel,/area/ruin/space/has_grav/storage/central)
"bn" = (/obj/machinery/power/apc/auto_name/east{start_charge = 0},/turf/open/floor/plasteel,/area/ruin/space/has_grav/storage/central)
"bo" = (/obj/structure/cable{icon_state = "1-2"},/turf/closed/wall/r_wall,/area/ruin/space/has_grav/storage/central2)
"bp" = (/turf/open/floor/plasteel,/area/ruin/space/has_grav/storage/central)
"bq" = (/obj/structure/closet/firecloset/full,/turf/open/floor/plasteel,/area/ruin/space/has_grav/storage/central)
"br" = (/obj/structure/closet/crate,/obj/effect/spawner/lootdrop/maintenance/two,/obj/effect/decal/cleanable/cobweb,/turf/open/floor/plasteel,/area/ruin/space/has_grav/storage/central)
"bs" = (/obj/structure/closet/crate,/obj/effect/spawner/lootdrop/maintenance/two,/turf/open/floor/plasteel,/area/ruin/space/has_grav/storage/central)
"bt" = (/obj/effect/decal/cleanable/blood/tracks{icon_state = "tracks"; dir = 10},/turf/open/floor/plasteel,/area/ruin/space/has_grav/storage/central)
"bu" = (/obj/effect/decal/cleanable/blood/tracks{icon_state = "tracks"; dir = 8},/turf/open/floor/plasteel,/area/ruin/space/has_grav/storage/central)
"bv" = (/obj/structure/cable{icon_state = "1-2"},/obj/effect/decal/cleanable/blood/tracks{icon_state = "tracks"; dir = 6},/turf/open/floor/plasteel,/area/ruin/space/has_grav/storage/central)
"bw" = (/obj/machinery/door/airlock/highsecurity,/obj/effect/mapping_helpers/airlock/locked,/turf/open/floor/plasteel,/area/ruin/space/has_grav/storage/central)
"bx" = (/obj/structure/cable{icon_state = "1-4"},/turf/closed/wall/r_wall,/area/ruin/space/has_grav/storage/power2)
"by" = (/obj/effect/decal/cleanable/cobweb/cobweb2,/turf/open/floor/plasteel,/area/ruin/space/has_grav/storage/central)
"bz" = (/turf/open/space/basic,/area/ruin/space/has_grav/storage/central2)
"bA" = (/obj/structure/cable{icon_state = "1-2"},/turf/open/floor/plasteel,/area/ruin/space/has_grav/storage/central)
"bB" = (/obj/vehicle/ridden/bicycle,/turf/open/floor/plasteel,/area/ruin/space/has_grav/storage/central2)
"bC" = (/turf/open/floor/plasteel,/area/ruin/space/has_grav/storage/central2)
"bD" = (/obj/structure/table/wood/fancy/red,/obj/structure/table/wood/fancy/cyan,/obj/item/storage/lockbox/dueling,/turf/open/floor/plasteel,/area/ruin/space/has_grav/storage/central2)
"bE" = (/obj/structure/cable{icon_state = "4-8"},/obj/effect/decal/cleanable/cobweb,/turf/open/floor/plasteel,/area/ruin/space/has_grav/storage/power2)
"bF" = (/obj/machinery/power/smes,/obj/structure/cable{icon_state = "0-8"},/turf/open/floor/plasteel,/area/ruin/space/has_grav/storage/power2)
"bG" = (/obj/structure/closet/crate/secure/loot,/turf/open/floor/plasteel,/area/ruin/space/has_grav/storage/power3)
"bH" = (/obj/machinery/door/airlock/highsecurity,/obj/effect/mapping_helpers/airlock/locked,/turf/open/floor/plasteel,/area/ruin/space/has_grav/storage/central2)
"bI" = (/obj/machinery/door/airlock/vault,/obj/effect/mapping_helpers/airlock/locked,/turf/open/floor/plasteel,/area/ruin/space/has_grav/storage/central2)
"bJ" = (/obj/structure/cable{icon_state = "0-2"},/turf/open/floor/plasteel,/area/ruin/space/has_grav/storage/power2)
"bK" = (/obj/machinery/power/apc/auto_name/south{start_charge = 0},/turf/open/floor/plasteel,/area/ruin/space/has_grav/storage/power1)
"bL" = (/obj/structure/cable{icon_state = "1-8"},/obj/structure/cable{icon_state = "4-8"},/turf/open/floor/plasteel,/area/ruin/space/has_grav/storage/power1)
"bM" = (/obj/structure/cable{icon_state = "4-8"},/obj/structure/cable{icon_state = "1-8"},/obj/effect/decal/cleanable/blood/footprints{icon_state = "blood1"; dir = 1},/turf/open/floor/plasteel,/area/ruin/space/has_grav/storage/power1)
"bN" = (/obj/structure/cable{icon_state = "4-8"},/obj/effect/decal/cleanable/blood/footprints{icon_state = "blood1"; dir = 8},/turf/open/floor/plasteel,/area/ruin/space/has_grav/storage/power1)
"bO" = (/obj/structure/cable{icon_state = "1-8"},/obj/effect/decal/cleanable/blood/footprints{icon_state = "blood1"; dir = 8},/turf/open/floor/plasteel,/area/ruin/space/has_grav/storage/power1)
"bP" = (/obj/machinery/door/airlock/highsecurity,/obj/structure/cable{icon_state = "1-2"},/obj/structure/cable{icon_state = "1-4"},/obj/effect/decal/cleanable/blood/footprints{icon_state = "blood1"; dir = 1},/obj/effect/mapping_helpers/airlock/locked,/turf/open/floor/plasteel,/area/ruin/space/has_grav/storage/power1)
"bQ" = (/obj/effect/decal/cleanable/blood/footprints{icon_state = "blood1"; dir = 8},/turf/open/floor/plasteel,/area/ruin/space/has_grav/storage/power2)
"bR" = (/obj/structure/cable{icon_state = "1-2"},/turf/open/floor/plasteel,/area/ruin/space/has_grav/storage/central2)
"bS" = (/obj/structure/table/wood/fancy/royalblue,/obj/item/reagent_containers/hypospray,/turf/open/floor/plasteel,/area/ruin/space/has_grav/storage/central2)
"bT" = (/obj/effect/spawner/lootdrop/glowstick,/turf/open/floor/plasteel,/area/ruin/space/has_grav/storage/central)
"bU" = (/obj/machinery/power/apc/auto_name/west{start_charge = 0},/obj/structure/cable{icon_state = "0-2"},/turf/open/floor/plasteel,/area/ruin/space/has_grav/storage/power3)
"bV" = (/obj/structure/cable{icon_state = "1-2"},/obj/item/melee,/turf/open/floor/plasteel,/area/ruin/space/has_grav/storage/central2)
"bW" = (/obj/machinery/door/airlock/hatch,/turf/open/floor/plasteel,/area/ruin/space/has_grav/storage/central)
"bX" = (/obj/item/inducer,/turf/open/floor/plasteel,/area/ruin/space/has_grav/storage/central)
"bY" = (/obj/machinery/power/apc/auto_name/east{start_charge = 0},/obj/structure/cable{icon_state = "0-2"},/turf/open/floor/plasteel,/area/ruin/space/has_grav/storage/power2)
"bZ" = (/obj/item/export_scanner,/turf/open/floor/plasteel,/area/ruin/space/has_grav/storage/central)
"ca" = (/obj/effect/mob_spawn/human/corpse/cargo_tech,/turf/open/floor/plasteel,/area/ruin/space/has_grav/storage/central)
"cb" = (/obj/machinery/door/airlock/highsecurity,/obj/structure/cable{icon_state = "4-8"},/obj/effect/mapping_helpers/airlock/locked,/turf/open/floor/plasteel,/area/ruin/space/has_grav/storage/power3)
"cc" = (/obj/machinery/door/airlock/highsecurity,/obj/effect/decal/cleanable/blood/footprints{icon_state = "blood1"; dir = 8},/obj/effect/mapping_helpers/airlock/locked,/turf/open/floor/plasteel,/area/ruin/space/has_grav/storage/power2)
"cd" = (/obj/structure/table/wood/fancy/red,/obj/item/gun/ballistic/automatic/proto/unrestricted,/turf/open/floor/plasteel,/area/ruin/space/has_grav/storage/central2)
"ce" = (/obj/item/crowbar/red,/turf/open/floor/plasteel,/area/ruin/space/has_grav/storage/central)
"cf" = (/obj/item/melee,/turf/open/floor/plasteel,/area/ruin/space/has_grav/storage/central2)
"cg" = (/obj/structure/closet/crate/internals,/turf/open/floor/plasteel,/area/ruin/space/has_grav/storage/central)
"ch" = (/obj/structure/closet/crate/engineering/electrical,/turf/open/floor/plasteel,/area/ruin/space/has_grav/storage/central)
"ci" = (/obj/structure/closet/crate/secure/loot,/turf/open/floor/plasteel,/area/ruin/space/has_grav/storage/central)
"cj" = (/obj/structure/table/wood/fancy/orange,/obj/item/construction/rcd/combat,/turf/open/floor/plasteel,/area/ruin/space/has_grav/storage/central2)
"ck" = (/obj/structure/table/wood/fancy/green,/obj/item/construction/rld,/turf/open/floor/plasteel,/area/ruin/space/has_grav/storage/central2)
"cl" = (/obj/structure/table/wood/fancy/blue,/obj/structure/table/wood/fancy/purple,/obj/item/assembly/signaler/anomaly,/turf/open/floor/plasteel,/area/ruin/space/has_grav/storage/central2)
"cm" = (/obj/item/crowbar/red,/obj/effect/mob_spawn/human/corpse/cargo_tech,/turf/open/floor/plasteel,/area/ruin/space/has_grav/storage/power2)
"cn" = (/obj/structure/cable{icon_state = "1-2"},/obj/effect/decal/cleanable/blood/footprints{icon_state = "blood1"; dir = 1},/turf/open/floor/plasteel,/area/ruin/space/has_grav/storage/central)
"co" = (/obj/structure/cable{icon_state = "4-8"},/turf/closed/wall/r_wall,/area/ruin/space/has_grav/storage/central)
"cp" = (/obj/structure/closet/crate/medical,/obj/item/storage/pill_bottle/lsd,/obj/item/storage/pill_bottle/happiness,/obj/item/storage/pill_bottle/happy,/turf/open/floor/plasteel,/area/ruin/space/has_grav/storage/power2)
"cq" = (/obj/machinery/power/port_gen/pacman/super,/obj/structure/cable,/turf/open/floor/plasteel,/area/ruin/space/has_grav/storage/power2)
"cr" = (/obj/structure/closet/crate,/obj/item/bedsheet/ian,/obj/item/bedsheet/medical,/obj/item/bedsheet/hop,/obj/item/bedsheet/dorms,/obj/item/bedsheet/cmo,/obj/item/bedsheet/nanotrasen,/obj/item/bedsheet/centcom,/obj/item/bedsheet/syndie,/turf/open/floor/plasteel,/area/ruin/space/has_grav/storage/power1)
"cs" = (/obj/item/storage/pill_bottle,/turf/open/floor/plasteel,/area/ruin/space/has_grav/storage/power2)
"ct" = (/obj/structure/closet/cardboard/metal,/obj/item/storage/toolbox/mechanical,/obj/item/storage/toolbox/mechanical,/obj/item/storage/toolbox/emergency,/obj/item/storage/toolbox/electrical,/obj/item/storage/toolbox/electrical,/turf/open/floor/plasteel,/area/ruin/space/has_grav/storage/power1)
"cu" = (/obj/structure/closet/crate/solarpanel_small,/turf/open/floor/plasteel,/area/ruin/space/has_grav/storage/power2)
"cv" = (/obj/structure/falsewall/reinforced,/turf/open/floor/plasteel,/area/ruin/space/has_grav/storage/power2)

(1,1,1) = {"
aaaaaaaaaaaaaaaaaaaaaaaaaaaaaaaaaaaaaaaaaaaaaaaaaaaaaaaaaaaa
aaaaaaaaaaaaaaaaaaaaaaaaaaaaaaaaaaaaaaaaaaaaaaaaaaaaaaaaaaaa
aaaaaaaaaaaaaaaaaaaaaaaaaaaaaaadadadadadadadadadadadaaaaaaaa
aaaaaaaaaaaaaaaaaaaaaaaaaaaaaaadafafafafafafafagahadaaaaaaaa
aaaaaaaaaaaaabababababaiaiaiaiadakamadadadadadanamadaaaoaaaa
aaaaaaaaaaaaabacaeacabapaqaqaqadakamadadadadadadadadaaaaaaaa
aaaaaaaaaaaaabacaeacabajasataladavadadawaxaxadamamayaaaaaaaa
aaaaaaaaaaaaabacaeaeauaqazaAaAaBaCamaDamamamadaEamadaaaaaaaa
aaaaaaaaaaaaabacaeacabaqaFaqaqadadadadaHaxaxadamamadaaaaaaaa
aaaaaaaaaaaaabacaeacabaqaFaIaqadaJamaKaKadadadamamadaaaaaaaa
aaaaaaaaaaaaabababababaiaGaiaiadamamadadadadadaKadadaaaaaaaa
aaaaaaaaaaaaaaaYaZbbbdaiaFaqbeadbfbfamamamamambgaLbkaaaaaaaa
aaaablblblblblaYaYaYbmaYaNaiaYaYaYbkbkbkbkbkbkbobkbkbkaaaaaa
aaaablbpbpbqbqaYbrbsbtbubvbhbpbyaYbzbkbkbkbkbkbobkbkbkaaaaaa
aaaablbpbpbpbpaYbpbpbsbpbAbpbpbsaYbzbkbkbBbCbDbRbSbkbkaaaaaa
aaaablbparbTbnaYbpbpbpbpbAbpbsbpaYbkbkbkbCbCbCbVbCbkbkaaaaaa
aaaabWbpbXbpbpbwbpbpbZbpbAcabpbpbpbHbCbIbCbCbCbRcdbkbkaaaaaa
aaaablbpbpbpbpaYbpbpbpbpbAbpcebpaYbkbkbkcfbCbCbRbCbkbkaaaaaa
aaaablbpbpcgceaYbpchbpbTbAbpbpciaYbzbkbkcjbCckbRclbkbkaaaaaa
aaaablbpcgbpbpaYbpbpbpbKcnbpcibpaYbzbkbkbkbkbkbobkbkbkaaaaaa
aaaablblblblblaYaYaYaYaMbPcocococoaOaOaOaOaPaOaQaRaRaRaaaaaa
aaaaaaaaaaaaaSaTaUaUaSaVaWaXaXaRbabcbibibjbxbEbFaRaaaaaaaaaa
aaaaaaaaaaaaaSbGaUaUaSbUaWaXbYaRbibibibibiaRbibJaRaaaaaaaaaa
aaaaaaaaaaaaaSbGaUaUcbbLbMbNbOccbQbQbQcmcpaRbicqaRaaaaaaaaaa
aaaaaaaaaaaaaSaUaUaUaScraXaXaXaRbibibicsbiaRbibiaRaaaaaaaaaa
aaaaaaaaaaaaaSaUaUaUaSaXaXaXctaRbibicucucucvbibiaRaaaaaaaaaa
aaaaaaaaaaaaaSaSaSaSaSaMaMaMaMaRaRaRaRaRaRaRaRaRaRaaaaaaaaaa
aaaaaaaaaaaaaaaaaaaaaaaaaaaaaaaaaaaaaaaaaaaaaaaaaaaaaaaaaaaa
aaaaaaaaaaaaaaaaaaaaaaaaaaaaaaaaaaaaaaaaaaaaaaaaaaaaaaaaaaaa
aaaaaaaaaaaaaaaaaaaaaaaaaaaaaaaaaaaaaaaaaaaaaaaaaaaaaaaaaaaa
"}
