//MAP CONVERTED BY dmm2tgm.py THIS HEADER COMMENT PREVENTS RECONVERSION, DO NOT REMOVE
"a" = (
/turf/open/space/basic,
/area/space)
"b" = (
/turf/closed/mineral,
/area/ruin/space/has_grav)
"c" = (
/turf/open/floor/plating/asteroid,
/area/ruin/space/has_grav)
"d" = (
/obj/item/mining_scanner{
	dir = 1
	},
/turf/open/floor/plating/asteroid,
/area/ruin/space/has_grav)
"e" = (
/obj/item/pickaxe/drill{
	dir = 1
	},
/turf/open/floor/plating/asteroid,
/area/ruin/space/has_grav)
"f" = (
/obj/item/stack/ore/iron{
	amount = 15;
	pixel_x = 15;
	pixel_y = -5;
	dir = 1
	},
/obj/item/stack/ore/titanium{
	amount = 10;
	pixel_x = 5;
	pixel_y = 2;
	dir = 1
	},
/turf/open/floor/plating/asteroid,
/area/ruin/space/has_grav)
"g" = (
/obj/item/stack/ore/plasma{
	amount = 5;
	pixel_x = -15;
	pixel_y = 10;
	dir = 1
	},
/obj/item/stack/ore/uranium{
	pixel_x = -10;
	dir = 1
	},
/obj/item/stack/ore/copper{
	amount = 5;
	pixel_x = 6;
	pixel_y = -5;
	dir = 1
	},
/turf/open/floor/plating/asteroid,
/area/ruin/space/has_grav)
"h" = (
/obj/item/stack/ore/plasma{
	amount = 10;
	pixel_x = -10;
	pixel_y = 10;
	dir = 1
	},
/turf/open/floor/plating/asteroid,
/area/ruin/space/has_grav)
"i" = (
/obj/item/stack/ore/titanium{
	dir = 1
	},
/turf/open/floor/plating/asteroid,
/area/ruin/space/has_grav)
"j" = (
/obj/item/stack/ore/iron{
	amount = 20;
	pixel_x = -15;
	pixel_y = -10;
	dir = 1
	},
/obj/item/stack/ore/silver{
	amount = 5;
	pixel_x = 7;
	pixel_y = 3;
	dir = 1
	},
/obj/item/stack/ore/diamond{
	pixel_x = 5;
	pixel_y = -10;
	dir = 1
	},
/obj/item/stack/ore/copper{
	amount = 10;
	pixel_x = 5;
	pixel_y = 10;
	dir = 1
	},
/turf/open/floor/plating/asteroid,
/area/ruin/space/has_grav)
"k" = (
/obj/item/stack/ore/iron{
	amount = 15;
	pixel_x = -10;
	pixel_y = 4;
	dir = 1
	},
/obj/item/stack/ore/silver{
	amount = 2;
	pixel_x = -16;
	pixel_y = 4;
	dir = 1
	},
/obj/item/stack/ore/copper{
	amount = 5;
	pixel_x = -9;
	pixel_y = -5;
	dir = 1
	},
/turf/open/floor/plating/asteroid,
/area/ruin/space/has_grav)
"l" = (
/obj/item/stack/ore/gold{
	amount = 2;
	pixel_x = 13;
	pixel_y = -10;
	dir = 1
	},
/turf/open/floor/plating/asteroid,
/area/ruin/space/has_grav)
"m" = (
/obj/item/stack/ore/gold{
	amount = 2;
	pixel_x = 13;
	dir = 1
	},
/turf/open/floor/plating/asteroid,
/area/ruin/space/has_grav)
"n" = (
/obj/item/stack/ore/iron{
	amount = 5;
	pixel_x = -10;
	pixel_y = -3;
	dir = 1
	},
/obj/item/stack/ore/bluespace_crystal{
	pixel_x = -5;
	pixel_y = -10;
	dir = 1
	},
/turf/open/floor/plating/asteroid,
/area/ruin/space/has_grav)
"o" = (
/turf/closed/wall/rust,
/area/ruin/space/has_grav/powered)
"p" = (
/mob/living/simple_animal/hostile/asteroid/hivelord,
/turf/open/floor/plating/asteroid,
/area/ruin/space/has_grav)
"q" = (
/turf/open/floor/plating,
/area/ruin/space/has_grav/powered)
"t" = (
/obj/machinery/power/port_gen/pacman{
	dir = 1
	},
/turf/open/floor/plating,
/area/ruin/space/has_grav/powered)
"u" = (
/obj/item/stack/medical/bruise_pack{
	dir = 1
	},
/turf/open/floor/plating/asteroid,
/area/ruin/space/has_grav)
"v" = (
/obj/item/stack/sheet/glass/fifty{
	dir = 1
	},
/turf/open/floor/plating,
/area/ruin/space/has_grav/powered)
"w" = (
/obj/item/stack/medical/ointment{
	dir = 1
	},
/turf/open/floor/plating/asteroid,
/area/ruin/space/has_grav)
"x" = (
/obj/machinery/door/airlock/hatch{
	dir = 1
	},
/turf/open/floor/plating,
/area/ruin/space/has_grav/powered)
"y" = (
/obj/item/stack/spacecash/c500{
	dir = 1
	},
/turf/open/floor/plating/asteroid,
/area/ruin/space/has_grav)
"z" = (
/obj/machinery/portable_atmospherics/canister/air{
	dir = 1
	},
/turf/open/floor/plating,
/area/ruin/space/has_grav/powered)
"A" = (
/obj/machinery/portable_atmospherics/scrubber{
	dir = 1
	},
/turf/open/floor/plating,
/area/ruin/space/has_grav/powered)
"B" = (
/obj/item/radio/off{
	dir = 1
	},
/turf/open/floor/plating,
/area/ruin/space/has_grav/powered)
"C" = (
/obj/machinery/portable_atmospherics/pump{
	dir = 1
	},
/turf/open/floor/plating,
/area/ruin/space/has_grav/powered)
"D" = (
/obj/item/tank/internals/oxygen{
	dir = 1
	},
/obj/item/tank/internals/oxygen{
	dir = 1
	},
/obj/item/tank/jetpack/improvised{
	dir = 1
	},
/turf/open/floor/plating,
/area/ruin/space/has_grav/powered)
"E" = (
/obj/machinery/portable_atmospherics/canister/oxygen{
	dir = 1
	},
/turf/open/floor/plating,
/area/ruin/space/has_grav/powered)

(1,1,1) = {"
a
a
a
a
a
a
a
a
a
a
a
a
a
a
a
a
a
a
a
a"}(2,1,1) = {"
a
a
b
b
a
a
a
a
b
b
b
b
b
a
b
b
b
b
b
a"}(3,1,1) = {"
a
a
b
b
b
a
b
b
b
b
b
b
b
a
b
b
b
b
b
a"}(4,1,1) = {"
a
a
b
b
b
b
b
b
b
b
b
b
b
b
b
b
b
b
b
a"}(5,1,1) = {"
a
a
b
b
b
b
b
b
b
b
b
b
b
b
b
b
b
b
b
a"}(6,1,1) = {"
b
b
b
b
b
b
b
b
b
b
b
b
b
b
b
b
b
b
b
a"}(7,1,1) = {"
b
b
b
b
b
b
b
b
b
b
b
b
b
c
d
c
c
b
b
a"}(8,1,1) = {"
b
b
b
b
c
c
c
c
u
c
c
c
c
p
e
c
c
b
b
a"}(9,1,1) = {"
b
b
b
b
c
e
d
c
w
u
c
l
i
f
b
b
b
b
b
a"}(10,1,1) = {"
b
b
b
b
c
c
c
y
c
c
c
m
j
g
b
b
b
b
b
a"}(11,1,1) = {"
b
b
b
b
b
b
b
c
c
c
c
n
k
h
b
b
b
a
a
a"}(12,1,1) = {"
b
b
b
b
b
o
o
o
x
o
o
o
b
b
b
b
b
a
a
a"}(13,1,1) = {"
a
b
b
b
b
o
z
z
q
v
q
o
b
b
b
b
b
a
a
a"}(14,1,1) = {"
a
b
b
b
b
o
C
A
q
q
q
o
b
b
b
b
b
a
a
a"}(15,1,1) = {"
a
b
b
b
b
o
q
B
q
q
q
o
b
b
b
b
b
a
a
a"}(16,1,1) = {"
a
b
b
b
b
o
D
q
q
q
q
o
b
b
b
b
b
b
a
a"}(17,1,1) = {"
a
a
a
a
b
o
E
q
q
q
t
o
b
b
b
b
b
b
a
a"}(18,1,1) = {"
a
a
a
a
b
o
o
o
x
o
o
o
b
b
b
b
b
b
a
a"}(19,1,1) = {"
a
a
a
a
a
a
a
a
a
a
a
a
a
a
a
b
b
b
a
a"}(20,1,1) = {"
a
a
a
a
a
a
a
a
a
a
a
a
a
a
a
a
a
a
a
a"}