"aa" = (/turf/open/floor/plating/dirt/dark,/area/space)
"ab" = (/turf/closed/wall/mineral/titanium,/area/shuttle/custom)
"ac" = (/obj/machinery/meter/atmos,/turf/closed/wall/mineral/titanium,/area/shuttle/custom)
"ad" = (/obj/structure/window/shuttle,/obj/structure/grille,/turf/open/floor/circuit/telecomms/server,/area/shuttle/custom)
"ae" = (/turf,/area)
"af" = (/turf/open/floor/plating/dirt/dark,/area/shuttle/custom)
"ag" = (,/turf/closed/wall/mineral/titanium,/area/shuttle/custom)
"ah" = (/turf/open/floor/circuit/telecomms/server,/area/shuttle/custom)
"ai" = (,/obj/machinery/power/solar/fake,/turf/open/floor/circuit/telecomms/server,/area/shuttle/custom)
"aj" = (,/turf/open/floor/plating/dirt/dark,/area/shuttle/custom)
"ak" = (,/turf/open/floor/circuit/telecomms/server,/area/shuttle/custom)
"al" = (,,,/turf/open/floor/circuit/telecomms/server,/area/shuttle/custom)
"am" = (,,/turf/open/floor/circuit/telecomms/server,/area/shuttle/custom)
"an" = (/obj/machinery/atmospherics/pipe/simple/supply,/obj/machinery/atmospherics/pipe/simple/scrubbers/hidden/layer3,/obj/machinery/door/airlock,,/turf/open/floor/circuit/telecomms/server,/area/shuttle/custom)
"ao" = (/obj/machinery/door/airlock/external/glass,/turf/open/floor/circuit/telecomms/server,/area/shuttle/custom)
"ap" = (/obj/machinery/vending/plasmaresearch,/turf/open/floor/circuit/telecomms/server,/area/shuttle/custom)
"aq" = (,,/turf/open/floor/circuit/telecomms/server,/area/shuttle/custom)
"ar" = (,/turf/open/floor/circuit/telecomms/server,/area/shuttle/custom)
"as" = (,/obj/machinery/portable_atmospherics/canister/stimulum,/turf/open/floor/circuit/telecomms/server,/area/shuttle/custom)
"at" = (,/turf/open/floor/circuit/telecomms/server,/area/shuttle/custom)
"au" = (/obj/machinery/atmospherics/pipe/simple/supply,/obj/machinery/atmospherics/pipe/simple/scrubbers/hidden/layer3,,/turf/open/floor/circuit/telecomms/server,/area/shuttle/custom)
"av" = (/obj/machinery/autolathe,/turf/open/floor/circuit/telecomms/server,/area/shuttle/custom)
"aw" = (/obj/machinery/rnd/production/protolathe,/turf/open/floor/circuit/telecomms/server,/area/shuttle/custom)
"ax" = (/obj/machinery/atmospherics/components/unary/vent_pump,/obj/machinery/computer/rdconsole,/turf/open/floor/circuit/telecomms/server,/area/shuttle/custom)
"ay" = (/obj/structure/frame/machine,/turf/open/floor/circuit/telecomms/server,/area/shuttle/custom)
"az" = (,/turf/closed/wall/mineral/titanium,/area/shuttle/custom)
"aA" = (/obj/machinery/atmospherics/pipe/simple/supply,/turf/open/floor/circuit/telecomms/server,/area/shuttle/custom)
"aB" = (,/turf/open/floor/circuit/telecomms/server,/area/shuttle/custom)
"aC" = (/obj/structure/sink/kitchen,/turf/open/floor/circuit/telecomms/server,/area/shuttle/custom)
"aD" = (,/turf/open/floor/circuit/telecomms/server,/area/shuttle/custom)
"aE" = (,/obj/machinery/atmospherics/pipe/simple/scrubbers/hidden/layer3,,,/turf/open/floor/circuit/telecomms/server,/area/shuttle/custom)
"aF" = (,/turf/open/floor/circuit/telecomms/server,/area/shuttle/custom)
"aG" = (/obj/machinery/atmospherics/pipe/simple/supply,,/turf/open/floor/circuit/telecomms/server,/area/shuttle/custom)
"aH" = (,/obj/machinery/vending/plasmaresearch,/turf/open/floor/circuit/telecomms/server,/area/shuttle/custom)
"aI" = (,/turf/closed/wall/mineral/titanium,/area/shuttle/custom)
"aJ" = (/obj/machinery/suit_storage_unit,/turf/open/floor/circuit/telecomms/server,/area/shuttle/custom)
"aK" = (,/turf/open/floor/circuit/telecomms/server,/area/shuttle/custom)
"aL" = (,/turf/open/floor/circuit/telecomms/server,/area/shuttle/custom)
"aM" = (/obj/machinery/atmospherics/pipe/simple/supply,/obj/machinery/atmospherics/pipe/simple/scrubbers/hidden/layer3,/obj/machinery/door/airlock,/turf/open/floor/circuit/telecomms/server,/area/shuttle/custom)
"aN" = (/obj/item/clothing/head/collectable/petehat/gang,/obj/machinery/atmospherics/components/unary/vent_pump,,/turf/open/floor/circuit/telecomms/server,/area/shuttle/custom)
"aO" = (,/turf/open/floor/circuit/telecomms/server,/area/shuttle/custom)
"aP" = (,/turf/open/floor/circuit/telecomms/server,/area/shuttle/custom)
"aQ" = (,/turf/closed/wall/mineral/titanium,/area/shuttle/custom)
"aR" = (/obj/machinery/suit_storage_unit,,/turf/open/floor/circuit/telecomms/server,/area/shuttle/custom)
"aS" = (,,/turf/open/floor/circuit/telecomms/server,/area/shuttle/custom)
"aT" = (,,,,/turf/open/floor/circuit/telecomms/server,/area/shuttle/custom)
"aU" = (,,/obj/machinery/door/airlock,,/turf/open/floor/circuit/telecomms/server,/area/shuttle/custom)
"aV" = (,,,/turf/open/floor/circuit/telecomms/server,/area/shuttle/custom)
"aW" = (/obj/machinery/atmospherics/pipe/manifold4w/supply,/obj/machinery/atmospherics/pipe/manifold4w/scrubbers/hidden/layer3,,,,/turf/open/floor/circuit/telecomms/server,/area/shuttle/custom)
"aX" = (/obj/machinery/atmospherics/pipe/manifold4w/supply,/obj/machinery/atmospherics/pipe/manifold4w/scrubbers/hidden/layer3,,/turf/open/floor/circuit/telecomms/server,/area/shuttle/custom)
"aY" = (,,,/obj/machinery/power/supermatter_crystal/engine,/turf/open/floor/circuit/telecomms/server,/area/shuttle/custom)
"aZ" = (,,/turf/open/floor/circuit/telecomms/server,/area/shuttle/custom)
"ba" = (,,/obj/machinery/door/airlock/command/glass,/turf/open/floor/circuit/telecomms/server,/area/shuttle/custom)
"bb" = (/obj/item/clothing/head/collectable/petehat/gang,,,/turf/open/floor/circuit/telecomms/server,/area/shuttle/custom)
"bc" = (,/turf/open/floor/circuit/telecomms/server,/area/shuttle/custom)
"bd" = (,,,/turf/open/floor/circuit/telecomms/server,/area/shuttle/custom)
"be" = (/obj/item/clothing/head/collectable/petehat/gang,,,/turf/open/floor/circuit/telecomms/server,/area/shuttle/custom)
"bf" = (,/turf/open/floor/circuit/telecomms/server,/area/shuttle/custom)
"bg" = (,/turf/open/floor/circuit/telecomms/server,/area/shuttle/custom)
"bh" = (/obj/machinery/atmospherics/pipe/simple/supply,,/turf/open/floor/circuit/telecomms/server,/area/shuttle/custom)
"bi" = (,,/turf/open/floor/circuit/telecomms/server,/area/shuttle/custom)
"bj" = (,/obj/machinery/vending/plasmaresearch,/turf/open/floor/circuit/telecomms/server,/area/shuttle/custom)
"bk" = (/obj/structure/cable,/obj/machinery/power/supermatter_crystal/engine,/turf/open/floor/circuit/telecomms/server,/area/shuttle/custom)
"bl" = (,/turf/open/floor/circuit/telecomms/server,/area/shuttle/custom)
"bm" = (/obj/machinery/atmospherics/pipe/simple/supply,/obj/machinery/atmospherics/pipe/simple/scrubbers/hidden/layer3,/obj/machinery/vending/plasmaresearch,,,/turf/open/floor/circuit/telecomms/server,/area/shuttle/custom)
"bn" = (/obj/machinery/vending/plasmaresearch,,/turf/open/floor/circuit/telecomms/server,/area/shuttle/custom)
"bo" = (/obj/machinery/power/supermatter_crystal/engine,,/turf/open/floor/circuit/telecomms/server,/area/shuttle/custom)
"bp" = (,/turf/closed/wall/mineral/titanium,/area/shuttle/custom)
"bq" = (/obj/machinery/atmospherics/pipe/simple/supply,/obj/machinery/atmospherics/pipe/simple/scrubbers/hidden/layer3,/obj/machinery/door/airlock/engineering,,/turf/open/floor/circuit/telecomms/server,/area/shuttle/custom)
"br" = (/turf,/area/shuttle/custom)
"bs" = (,/turf/open/floor/circuit/telecomms/server,/area/shuttle/custom)
"bt" = (,/turf/open/floor/circuit/telecomms/server,/area/shuttle/custom)
"bu" = (,,,,/turf/open/floor/circuit/telecomms/server,/area/shuttle/custom)
"bv" = (/obj/machinery/atmospherics/pipe/manifold/supply,/obj/machinery/atmospherics/pipe/simple/scrubbers/hidden/layer3,,,/turf/open/floor/circuit/telecomms/server,/area/shuttle/custom)
"bw" = (,,,/turf/open/floor/circuit/telecomms/server,/area/shuttle/custom)
"bx" = (,,/obj/machinery/power/solar/fake,/turf/open/floor/circuit/telecomms/server,/area/shuttle/custom)
"by" = (,/turf/open/floor/circuit/telecomms/server,/area/shuttle/custom)
"bz" = (/obj/machinery/atmospherics/components/unary/tank,/turf/open/floor/circuit/telecomms/server,/area/shuttle/custom)
"bA" = (/obj/machinery/power/smes,/obj/structure/cable,/turf/open/floor/circuit/telecomms/server,/area/shuttle/custom)
"bB" = (,/obj/machinery/vending/plasmaresearch,,/turf/open/floor/circuit/telecomms/server,/area/shuttle/custom)
"bC" = (/obj/machinery/power/port_gen,,/turf/open/floor/circuit/telecomms/server,/area/shuttle/custom)
"bD" = (,/turf/open/floor/circuit/telecomms/server,/area/shuttle/custom)
"bE" = (,/turf/open/floor/circuit/telecomms/server,/area/shuttle/custom)

(1,1,1) = {"
aaaaaaaaabababababacadababababababababaaaaaaaaaaaa
aaaaaeafafagahahahahahaiahahahahahahabaaaaaaaaaaaa
aaaaaeajafagahahahakalamahahahahahahabaaaaaaaaaaaa
aaabababababababababanababababababababababaaaaaaaa
aaaoapaoaqarasadahatauatahahabavawaxayahabadadaaaa
aaababazaAaBaCabahaDaEaFahahabahapaGaHahaIahadadaa
aaaaabaJaAaKabababaLauahahaKabadabaMabadabaNaOadaa
aaaPaQaRaSaTaUaVaUaVaWaVaVaVaUaVaVaXaYaZbabbbcadaa
aaaaabaJaAbdabababaLauahahaKabadabaMabadabbebfadaa
aaabababaAbgahabahaDaEaFahahabahatbhbiahazahadadaa
aaaoataobjbkbladahahbmbnboahabahahaBahahaIadadaaaa
aaabababababababacbpbqababababababababababaaaaaaaa
aaaaaebrafagbsbtbtbubvbwbxbybybyarbzabaaaaaaaaaaaa
aaaaaeajafagbAbBbCahbDahahahahapbEbzabaaaaaaaaaaaa
aaaaaaaaababababababadababababababababaaaaaaaaaaaa
"}
