//MAP CONVERTED BY dmm2tgm.py THIS HEADER COMMENT PREVENTS RECONVERSION, DO NOT REMOVE
"a" = (
/turf/template_noop,
/area/template_noop)
"b" = (
/turf/closed/wall/mineral/bananium,
/area/ruin/unpowered)
"c" = (
/obj/structure/shuttle/engine/propulsion/right{
	dir = 1
	},
/turf/open/floor/mineral/bananium/airless,
/area/ruin/unpowered)
"d" = (
/obj/structure/window/plasma/fulltile{
	dir = 1
	},
/turf/open/floor/mineral/bananium/airless,
/area/ruin/unpowered)
"e" = (
/obj/item/gps{
	gpstag = "SOS";
	dir = 1
	},
/obj/structure/chair/comfy/shuttle{
	dir = 8
	},
/obj/item/storage/pod{
	pixel_y = 30;
	dir = 1
	},
/turf/open/floor/mineral/bananium/airless,
/area/ruin/unpowered)
"f" = (
/obj/machinery/door/airlock/bananium{
	dir = 1
	},
/turf/open/floor/mineral/bananium/airless,
/area/ruin/unpowered)
"g" = (
/obj/structure/chair/comfy/shuttle{
	dir = 8
	},
/obj/effect/decal/remains/human{
	dir = 4
	},
/turf/open/floor/mineral/bananium/airless,
/area/ruin/unpowered)

(1,1,1) = {"
b
d
b
a"}(2,1,1) = {"
b
g
b
a"}(3,1,1) = {"
b
e
b
a"}(4,1,1) = {"
c
f
c
a"}