//MAP CONVERTED BY dmm2tgm.py THIS HEADER COMMENT PREVENTS RECONVERSION, DO NOT REMOVE
"a" = (
/turf/template_noop,
/area/template_noop)
"b" = (
/turf/closed/wall/mineral/bananium,
/area/ruin/unpowered)
"c" = (
/obj/structure/shuttle/engine/propulsion/right,
/turf/open/floor/mineral/bananium/airless,
/area/ruin/unpowered)
"d" = (
/obj/structure/window/plasma/fulltile,
/turf/open/floor/mineral/bananium/airless,
/area/ruin/unpowered)
"e" = (
/obj/item/gps{
	gpstag = "SOS"
	},
/obj/structure/chair/comfy/shuttle{
	dir = 8
	},
/obj/item/storage/pod{
	pixel_y = -30
	},
/turf/open/floor/mineral/bananium/airless,
/area/ruin/unpowered)
"f" = (
/obj/machinery/door/airlock/bananium,
/turf/open/floor/mineral/bananium/airless,
/area/ruin/unpowered)
"g" = (
/obj/structure/chair/comfy/shuttle{
	dir = 8
	},
/obj/effect/decal/remains/human,
/turf/open/floor/mineral/bananium/airless,
/area/ruin/unpowered)

(1,1,1) = {"
a
b
d
b
"}
(2,1,1) = {"
a
b
g
b
"}
(3,1,1) = {"
a
b
e
b
"}
(4,1,1) = {"
a
c
f
c
"}
