"a" = (/turf/template_noop,/area/template_noop)
"b" = (/turf/open/floor/mineral/titanium/white,/area/ruin/unpowered)
"c" = (/turf/closed/wall/mineral/titanium,/area/ruin/unpowered)
"d" = (/obj/structure/window/shuttle,/turf/open/floor/mineral/titanium/white,/area/ruin/unpowered)
"e" = (/obj/structure/shuttle/engine/propulsion,/turf/open/space/basic,/area/ruin/unpowered)
"f" = (/obj/machinery/door/airlock/shuttle,/turf/open/floor/mineral/titanium/white,/area/ruin/unpowered)
"g" = (/obj/structure/chair/comfy/shuttle{dir = 8},/turf/open/floor/mineral/titanium/white,/area/ruin/unpowered)
"h" = (/obj/machinery/computer,/turf/open/floor/mineral/titanium/white,/area/ruin/unpowered)
"i" = (/obj/structure/chair/comfy/shuttle{dir = 4},/turf/open/floor/mineral/titanium/white,/area/ruin/unpowered)
"j" = (/obj/structure/chair/comfy/shuttle{dir = 4},/obj/effect/mob_spawn/human/corpse/assistant,/turf/open/floor/mineral/titanium/white,/area/ruin/unpowered)
"k" = (/obj/structure/chair/comfy/shuttle{dir = 4},/obj/item/storage/pod{pixel_x = -24},/turf/open/floor/mineral/titanium/white,/area/ruin/unpowered)
"l" = (/obj/structure/chair/comfy/shuttle{dir = 8},/obj/item/storage/pod{pixel_x = 24},/turf/open/floor/mineral/titanium/white,/area/ruin/unpowered)
"m" = (/obj/item/gps {gpstag = "SOS"},/turf/open/floor/mineral/titanium/white,/area/ruin/unpowered)
"n" = (/obj/structure/chair/comfy/shuttle{dir = 1},/obj/effect/mob_spawn/human/corpse/cargo_tech,/turf/open/floor/mineral/titanium/white,/area/ruin/unpowered)

(1,1,1) = {"
aaaaaaaa
aaaaaaaa
aaaaaaaa
aaaaaaaa
acdddcaa
acibhcaa
acjbncaa
acjmgcaa
ackblcaa
aecfceaa
aaaaaaaa
aaaaaaaa
"}
