//MAP CONVERTED BY dmm2tgm.py THIS HEADER COMMENT PREVENTS RECONVERSION, DO NOT REMOVE
"a" = (
/turf/template_noop,
/area/template_noop)
"b" = (
/turf/open/floor/mineral/titanium/white,
/area/ruin/unpowered)
"c" = (
/turf/closed/wall/mineral/titanium,
/area/ruin/unpowered)
"d" = (
/obj/structure/window/reinforced/shuttle,
/turf/open/floor/mineral/titanium/white,
/area/ruin/unpowered)
"e" = (
/obj/structure/shuttle/engine/propulsion,
/turf/open/space/basic,
/area/ruin/unpowered)
"f" = (
/obj/machinery/door/airlock/shuttle,
/obj/structure/fans/tiny,
/turf/open/floor/mineral/titanium/white,
/area/ruin/unpowered)
"g" = (
/obj/structure/chair/fancy/shuttle{
	dir = 8
	},
/turf/open/floor/mineral/titanium/white,
/area/ruin/unpowered)
"h" = (
/obj/machinery/computer,
/turf/open/floor/mineral/titanium/white,
/area/ruin/unpowered)
"i" = (
/obj/structure/chair/fancy/shuttle{
	dir = 4
	},
/turf/open/floor/mineral/titanium/white,
/area/ruin/unpowered)
"j" = (
/obj/structure/chair/fancy/shuttle{
	dir = 4
	},
/obj/effect/mob_spawn/human/corpse/assistant,
/turf/open/floor/mineral/titanium/white,
/area/ruin/unpowered)
"k" = (
/obj/structure/chair/fancy/shuttle{
	dir = 4
	},
/obj/item/storage/pod{
	pixel_x = -32
	},
/turf/open/floor/mineral/titanium/white,
/area/ruin/unpowered)
"l" = (
/obj/structure/chair/fancy/shuttle{
	dir = 8
	},
/obj/item/storage/pod{
	pixel_x = 32
	},
/turf/open/floor/mineral/titanium/white,
/area/ruin/unpowered)
"m" = (
/obj/item/gps{
	gpstag = "SOS"
	},
/turf/open/floor/mineral/titanium/white,
/area/ruin/unpowered)
"n" = (
/obj/structure/chair/fancy/shuttle{
	dir = 1
	},
/obj/effect/mob_spawn/human/corpse/cargo_tech,
/turf/open/floor/mineral/titanium/white,
/area/ruin/unpowered)

(1,1,1) = {"
a
a
a
a
a
a
a
a
a
a
a
a
"}
(2,1,1) = {"
a
a
a
a
c
c
c
c
c
e
a
a
"}
(3,1,1) = {"
a
a
a
a
d
i
j
j
k
c
a
a
"}
(4,1,1) = {"
a
a
a
a
d
b
b
m
b
f
a
a
"}
(5,1,1) = {"
a
a
a
a
d
h
n
g
l
c
a
a
"}
(6,1,1) = {"
a
a
a
a
c
c
c
c
c
e
a
a
"}
(7,1,1) = {"
a
a
a
a
a
a
a
a
a
a
a
a
"}
(8,1,1) = {"
a
a
a
a
a
a
a
a
a
a
a
a
"}
