"a" = (/turf/open/space/basic,/area/space)
"b" = (/turf/closed/wall/r_wall,/area/ruin/space/has_grav/powered)
"c" = (/obj/structure/rack,/obj/item/stack/sheet/glass/fifty,/obj/item/stack/sheet/glass/fifty,/obj/item/stack/sheet/glass/fifty,/turf/open/floor/plasteel/airless,/area/ruin/space/has_grav/powered)
"d" = (/turf/open/floor/plasteel/airless,/area/ruin/space/has_grav/powered)
"e" = (/obj/machinery/portable_atmospherics/canister/air,/turf/open/floor/plasteel,/area/ruin/space/has_grav/powered)
"f" = (/obj/structure/rack,/obj/item/stack/sheet/iron/fifty,/obj/item/stack/sheet/iron/fifty,/obj/item/stack/sheet/iron/fifty,/turf/open/floor/plasteel/airless,/area/ruin/space/has_grav/powered)
"g" = (/obj/machinery/portable_atmospherics/canister/toxins,/turf/open/floor/plasteel/airless,/area/ruin/space/has_grav/powered)
"h" = (/obj/structure/closet/crate/science,/obj/item/circuitboard/computer/shuttle/docker,/obj/item/circuitboard/computer/shuttle/flight_control,/obj/item/circuitboard/machine/shuttle/heater,/obj/item/circuitboard/machine/shuttle/engine/plasma,/obj/item/shuttle_creator,/obj/item/circuitboard/machine/shuttle/engine/plasma,/obj/item/circuitboard/machine/shuttle/heater,/obj/item/pipe_dispenser,/turf/open/floor/plasteel/airless,/area/ruin/space/has_grav/powered)
"i" = (/obj/machinery/door/airlock/external/glass,/obj/structure/fans/tiny,/turf/open/floor/plasteel/airless,/area/ruin/space/has_grav/powered)
"j" = (/obj/structure/lattice,/turf/open/space/basic,/area/space)
"k" = (/turf/open/floor/plasteel/yellowsiding,/area/ruin/space/has_grav/powered)
"l" = (/turf/open/floor/plasteel/yellowsiding{dir = 1},/area/ruin/space/has_grav/powered)
"m" = (/obj/structure/rack,/obj/item/stack/rods,/obj/item/stack/rods,/turf/open/floor/plasteel/airless,/area/ruin/space/has_grav/powered)
"n" = (/obj/structure/table,/obj/item/storage/toolbox/mechanical,/turf/open/floor/plasteel/airless,/area/ruin/space/has_grav/powered)
"o" = (/obj/structure/table,/obj/item/stack/cable_coil/random,/obj/item/stack/cable_coil/random,/obj/item/stack/cable_coil/random,/obj/item/storage/toolbox/electrical,/turf/open/floor/plasteel/airless,/area/ruin/space/has_grav/powered)
"p" = (/turf/open/floor/plating,/area/space)
"q" = (/obj/structure/girder/displaced,/turf/open/floor/plating,/area/space)
"r" = (/obj/structure/fans/tiny,/turf/open/floor/plating,/area/space)
"s" = (/obj/structure/statue/gold/ce,/turf/open/floor/plasteel/airless,/area/ruin/space/has_grav/powered)

(1,1,1) = {"
aaaaaaaaaabbbbbbbaaaaaaaaaaaaa
aaaaaaaaaabcdsdebaaaaaaaaaaaaa
aaaaaaaaaabfdddgbaaaaaaaaaaaaa
aaaaaaaaaabmdddnbaaaaaaaaaaaaa
aaaaaaaababhdddobaaabaaaaaaaaa
aaaaaaadddbbbibbbdddgdaaaaaaaa
aaaaajjkkkkkkkkkkkkkkkjjaaaaaa
aaaaaaaajaaaaaaaaaaajaaaaaaaaa
aaaaaaaajaqqrqqqaaaajaaaaaaaaa
aaaaaaaajapppppqrqqajaaaaaaaaa
aaaaaaaajappppppppqajaaaaaaaaa
aaaaaaaajappppppppqajaaaaaaaaa
aaaaaaaajapppppqqqqajaaaaaaaaa
aaaaaaaajaqqqqqqaaaajaaaaaaaaa
aaaaaaaajaaaaaaaaaaajaaaaaaaaa
aaaaajjllllllllllllllljjaaaaaa
aaaaaaadddddddddddddddaaaaaaaa
aaaaaaaabaaaaaaaaaaabaaaaaaaaa
"}
