//MAP CONVERTED BY dmm2tgm.py THIS HEADER COMMENT PREVENTS RECONVERSION, DO NOT REMOVE
"a" = (
/turf/open/space/basic,
/area/space)
"b" = (
/turf/closed/wall/mineral/gold,
/area/ruin/space/has_grav/powered)
"d" = (
/turf/open/floor/carpet/purple,
/area/ruin/space/has_grav/powered)
"e" = (
/turf/open/floor/light/colour_cycle/dancefloor_a,
/area/ruin/space/has_grav/powered)
"f" = (
/turf/open/floor/light/colour_cycle/dancefloor_b,
/area/ruin/space/has_grav/powered)
"g" = (
/obj/machinery/computer{
	desc = "Unfortunately, the machine seems to be broken...";
	name = "Disco Disco Rave"
	},
/turf/open/floor/eighties,
/area/ruin/space/has_grav/powered)
"h" = (
/obj/structure/window/reinforced/spawner/directional/south,
/turf/open/floor/eighties,
/area/ruin/space/has_grav/powered)
"i" = (
/turf/open/floor/eighties,
/area/ruin/space/has_grav/powered)
"j" = (
/obj/structure/window/reinforced/fulltile,
/turf/open/floor/carpet/purple,
/area/ruin/space/has_grav/powered)
"k" = (
/obj/effect/spawner/random/entertainment/arcade,
/turf/open/floor/carpet/purple,
/area/ruin/space/has_grav/powered)
"l" = (
/obj/machinery/computer/slot_machine,
/turf/open/floor/carpet/purple,
/area/ruin/space/has_grav/powered)
"m" = (
/obj/structure/table/wood/poker,
/obj/item/gobbler,
/turf/open/floor/carpet/purple,
/area/ruin/space/has_grav/powered)
"n" = (
/obj/machinery/door/airlock/gold,
/obj/structure/fans/tiny,
/turf/open/floor/carpet/purple,
/area/ruin/space/has_grav/powered)
"o" = (
/obj/structure/table/wood/fancy/purple,
/obj/item/storage/belt/military/snack,
/turf/open/floor/carpet/purple,
/area/ruin/space/has_grav/powered)
"p" = (
/obj/structure/closet/crate/wooden{
	name = "prize crate"
	},
/obj/item/choice_beacon/pet/pingu,
/obj/item/coin/arcade_token,
/obj/item/coin/arcade_token,
/obj/item/coin/arcade_token,
/obj/item/coin/arcade_token,
/obj/item/coin/arcade_token,
/obj/item/coin/arcade_token,
/obj/item/coin/arcade_token,
/obj/item/coin/arcade_token,
/obj/item/coin/arcade_token,
/obj/item/coin/arcade_token,
/turf/open/floor/carpet/purple,
/area/ruin/space/has_grav/powered)
"q" = (
/obj/structure/closet/crate/freezer{
	name = "refreshment cooler"
	},
/obj/item/reagent_containers/cup/glass/bottle/beer/light,
/obj/item/reagent_containers/cup/soda_cans/sodawater,
/obj/item/reagent_containers/cup/soda_cans/shamblers,
/obj/item/reagent_containers/cup/soda_cans/shamblers,
/obj/item/reagent_containers/cup/soda_cans/grey_bull,
/obj/item/reagent_containers/cup/soda_cans/grey_bull,
/obj/item/reagent_containers/cup/soda_cans/air,
/obj/item/reagent_containers/cup/soda_cans/dr_gibb,
/obj/item/reagent_containers/cup/soda_cans/dr_gibb,
/obj/item/reagent_containers/cup/soda_cans/cola,
/obj/item/reagent_containers/cup/soda_cans/cola,
/obj/item/reagent_containers/cup/soda_cans/pwr_game,
/obj/item/reagent_containers/cup/soda_cans/pwr_game,
/obj/item/reagent_containers/cup/soda_cans/space_up,
/obj/item/reagent_containers/cup/soda_cans/space_up,
/obj/item/reagent_containers/cup/soda_cans/starkist,
/turf/open/floor/carpet/purple,
/area/ruin/space/has_grav/powered)
"r" = (
/obj/effect/spawner/random/entertainment/arcade,
/turf/open/floor/eighties,
/area/ruin/space/has_grav/powered)
"s" = (
/turf/closed/mineral,
/area/ruin/space/has_grav/powered)

(1,1,1) = {"
a
a
a
a
a
a
a
a
a
a
a
a
a
a
a
a
a
a
a
a
"}
(2,1,1) = {"
a
a
a
a
a
a
a
a
a
a
a
a
a
a
a
a
a
a
a
a
"}
(3,1,1) = {"
a
a
a
a
a
a
a
a
a
a
a
a
a
a
s
s
a
a
a
a
"}
(4,1,1) = {"
a
a
a
a
a
a
a
a
a
a
a
a
a
s
s
s
s
a
a
a
"}
(5,1,1) = {"
a
a
a
a
s
s
s
s
a
b
j
j
j
b
s
s
s
s
a
a
"}
(6,1,1) = {"
a
a
a
s
s
s
s
s
s
b
p
d
d
b
s
s
s
s
a
a
"}
(7,1,1) = {"
a
a
s
s
s
s
s
s
s
b
m
m
m
b
s
s
s
a
a
a
"}
(8,1,1) = {"
a
a
s
s
s
s
b
b
b
k
d
d
d
k
b
b
s
a
a
a
"}
(9,1,1) = {"
a
s
s
s
s
b
r
r
h
d
d
d
d
d
l
b
a
a
a
a
"}
(10,1,1) = {"
a
s
s
s
b
i
i
i
h
d
d
d
d
d
d
l
b
b
a
a
"}
(11,1,1) = {"
a
s
s
s
b
g
e
f
e
i
i
i
i
i
i
i
i
n
a
a
"}
(12,1,1) = {"
a
a
s
s
b
g
f
e
f
i
i
i
i
i
i
i
i
n
a
a
"}
(13,1,1) = {"
a
a
s
s
b
g
e
f
e
i
i
i
i
i
i
i
i
n
a
a
"}
(14,1,1) = {"
a
s
s
s
b
i
i
i
h
d
d
d
d
d
d
l
b
b
a
a
"}
(15,1,1) = {"
a
s
s
s
s
b
r
r
h
d
d
d
d
d
l
b
a
a
a
a
"}
(16,1,1) = {"
a
s
s
s
s
s
b
b
b
k
d
d
d
k
b
b
s
a
a
a
"}
(17,1,1) = {"
a
a
s
s
s
s
s
s
s
b
o
d
o
b
s
s
s
s
a
a
"}
(18,1,1) = {"
a
a
a
s
s
s
s
s
a
b
q
d
q
b
s
s
s
s
a
a
"}
(19,1,1) = {"
a
a
a
a
a
s
s
a
a
b
j
j
j
b
s
s
s
a
a
a
"}
(20,1,1) = {"
a
a
a
a
a
a
a
a
a
a
a
a
a
a
a
a
a
a
a
a
"}
(21,1,1) = {"
a
a
a
a
a
a
a
a
a
a
a
a
a
a
a
a
a
a
a
a
"}
(22,1,1) = {"
a
a
a
a
a
a
a
a
a
a
a
a
a
a
a
a
a
a
a
a
"}
(23,1,1) = {"
a
a
a
a
a
a
a
a
a
a
a
a
a
a
a
a
a
a
a
a
"}
(24,1,1) = {"
a
a
a
a
a
a
a
a
a
a
a
a
a
a
a
a
a
a
a
a
"}
(25,1,1) = {"
a
a
a
a
a
a
a
a
a
a
a
a
a
a
a
a
a
a
a
a
"}
