//MAP CONVERTED BY dmm2tgm.py THIS HEADER COMMENT PREVENTS RECONVERSION, DO NOT REMOVE
"a" = (
/turf/open/space/basic,
/area/space)
"b" = (
/turf/closed/wall/r_wall,
/area/ruin/space/has_grav/powered)
"c" = (
/obj/structure/rack{
	dir = 1
	},
/obj/item/stack/sheet/glass/fifty{
	dir = 1
	},
/obj/item/stack/sheet/glass/fifty{
	dir = 1
	},
/obj/item/stack/sheet/glass/fifty{
	dir = 1
	},
/turf/open/floor/plasteel/airless,
/area/ruin/space/has_grav/powered)
"d" = (
/turf/open/floor/plasteel/airless,
/area/ruin/space/has_grav/powered)
"e" = (
/obj/machinery/portable_atmospherics/canister/air{
	dir = 1
	},
/turf/open/floor/plasteel,
/area/ruin/space/has_grav/powered)
"f" = (
/obj/structure/rack{
	dir = 1
	},
/obj/item/stack/sheet/iron/fifty{
	dir = 1
	},
/obj/item/stack/sheet/iron/fifty{
	dir = 1
	},
/obj/item/stack/sheet/iron/fifty{
	dir = 1
	},
/turf/open/floor/plasteel/airless,
/area/ruin/space/has_grav/powered)
"g" = (
/obj/machinery/portable_atmospherics/canister/toxins{
	dir = 1
	},
/turf/open/floor/plasteel/airless,
/area/ruin/space/has_grav/powered)
"h" = (
/obj/structure/closet/crate/science{
	dir = 1
	},
/obj/item/circuitboard/computer/shuttle/flight_control{
	dir = 1
	},
/obj/item/circuitboard/machine/shuttle/heater{
	dir = 1
	},
/obj/item/circuitboard/machine/shuttle/engine/plasma{
	dir = 1
	},
/obj/item/shuttle_creator{
	dir = 1
	},
/obj/item/circuitboard/machine/shuttle/engine/plasma{
	dir = 1
	},
/obj/item/circuitboard/machine/shuttle/heater{
	dir = 1
	},
/obj/item/pipe_dispenser{
	dir = 1
	},
/turf/open/floor/plasteel/airless,
/area/ruin/space/has_grav/powered)
"i" = (
/obj/machinery/door/airlock/external/glass{
	dir = 1
	},
/obj/structure/fans/tiny{
	dir = 1
	},
/turf/open/floor/plasteel/airless,
/area/ruin/space/has_grav/powered)
"j" = (
/obj/structure/lattice{
	dir = 1
	},
/turf/open/space/basic,
/area/space)
"k" = (
/turf/open/floor/plasteel/yellowsiding,
/area/ruin/space/has_grav/powered)
"l" = (
/turf/open/floor/plasteel/yellowsiding{
	dir = 1
	},
/area/ruin/space/has_grav/powered)
"m" = (
/obj/structure/rack{
	dir = 1
	},
/obj/item/stack/rods{
	dir = 1
	},
/obj/item/stack/rods{
	dir = 1
	},
/turf/open/floor/plasteel/airless,
/area/ruin/space/has_grav/powered)
"n" = (
/obj/structure/table{
	dir = 1
	},
/obj/item/storage/toolbox/mechanical{
	dir = 1
	},
/turf/open/floor/plasteel/airless,
/area/ruin/space/has_grav/powered)
"o" = (
/obj/structure/table{
	dir = 1
	},
/obj/item/stack/cable_coil/random,
/obj/item/stack/cable_coil/random,
/obj/item/stack/cable_coil/random,
/obj/item/storage/toolbox/electrical{
	dir = 1
	},
/turf/open/floor/plasteel/airless,
/area/ruin/space/has_grav/powered)
"p" = (
/turf/open/floor/plating,
/area/space)
"q" = (
/obj/structure/girder/displaced{
	dir = 1
	},
/turf/open/floor/plating,
/area/space)
"r" = (
/obj/structure/fans/tiny{
	dir = 1
	},
/turf/open/floor/plating,
/area/space)
"s" = (
/obj/structure/statue/gold/ce{
	dir = 1
	},
/turf/open/floor/plasteel/airless,
/area/ruin/space/has_grav/powered)

(1,1,1) = {"
a
a
a
a
a
a
a
a
a
a
a
a
a
a
a
a
a
a"}(2,1,1) = {"
a
a
a
a
a
a
a
a
a
a
a
a
a
a
a
a
a
a"}(3,1,1) = {"
a
a
a
a
a
a
a
a
a
a
a
a
a
a
a
a
a
a"}(4,1,1) = {"
a
a
a
a
a
a
a
a
a
a
a
a
a
a
a
a
a
a"}(5,1,1) = {"
a
a
a
a
a
a
a
a
a
a
a
a
a
a
a
a
a
a"}(6,1,1) = {"
a
a
j
a
a
a
a
a
a
a
a
j
a
a
a
a
a
a"}(7,1,1) = {"
a
a
j
a
a
a
a
a
a
a
a
j
a
a
a
a
a
a"}(8,1,1) = {"
a
d
l
a
a
a
a
a
a
a
a
k
d
a
a
a
a
a"}(9,1,1) = {"
b
d
l
j
j
j
j
j
j
j
j
k
d
b
a
a
a
a"}(10,1,1) = {"
a
d
l
a
a
a
a
a
a
a
a
k
d
a
a
a
a
a"}(11,1,1) = {"
a
d
l
a
q
p
p
p
p
q
a
k
b
b
b
b
b
b"}(12,1,1) = {"
a
d
l
a
q
p
p
p
p
q
a
k
b
h
m
f
c
b"}(13,1,1) = {"
a
d
l
a
q
p
p
p
p
r
a
k
b
d
d
d
d
b"}(14,1,1) = {"
a
d
l
a
q
p
p
p
p
q
a
k
i
d
d
d
s
b"}(15,1,1) = {"
a
d
l
a
q
p
p
p
p
q
a
k
b
d
d
d
d
b"}(16,1,1) = {"
a
d
l
a
q
q
p
p
q
q
a
k
b
o
n
g
e
b"}(17,1,1) = {"
a
d
l
a
a
q
p
p
r
a
a
k
b
b
b
b
b
b"}(18,1,1) = {"
a
d
l
a
a
q
p
p
q
a
a
k
d
a
a
a
a
a"}(19,1,1) = {"
a
d
l
a
a
q
q
q
q
a
a
k
d
a
a
a
a
a"}(20,1,1) = {"
a
d
l
a
a
a
a
a
a
a
a
k
d
a
a
a
a
a"}(21,1,1) = {"
b
d
l
j
j
j
j
j
j
j
j
k
g
b
a
a
a
a"}(22,1,1) = {"
a
d
l
a
a
a
a
a
a
a
a
k
d
a
a
a
a
a"}(23,1,1) = {"
a
a
j
a
a
a
a
a
a
a
a
j
a
a
a
a
a
a"}(24,1,1) = {"
a
a
j
a
a
a
a
a
a
a
a
j
a
a
a
a
a
a"}(25,1,1) = {"
a
a
a
a
a
a
a
a
a
a
a
a
a
a
a
a
a
a"}(26,1,1) = {"
a
a
a
a
a
a
a
a
a
a
a
a
a
a
a
a
a
a"}(27,1,1) = {"
a
a
a
a
a
a
a
a
a
a
a
a
a
a
a
a
a
a"}(28,1,1) = {"
a
a
a
a
a
a
a
a
a
a
a
a
a
a
a
a
a
a"}(29,1,1) = {"
a
a
a
a
a
a
a
a
a
a
a
a
a
a
a
a
a
a"}(30,1,1) = {"
a
a
a
a
a
a
a
a
a
a
a
a
a
a
a
a
a
a"}