//MAP CONVERTED BY dmm2tgm.py THIS HEADER COMMENT PREVENTS RECONVERSION, DO NOT REMOVE
"a" = (
/turf/template_noop,
/area/template_noop)
"b" = (
/turf/closed/mineral/random/low_chance,
/area/ruin/unpowered)
"c" = (
/turf/closed/wall/r_wall/rust,
/area/ruin/unpowered)
"d" = (
/turf/closed/mineral/random/high_chance,
/area/ruin/unpowered)
"e" = (
/turf/open/floor/plating/airless,
/area/ruin/unpowered)
"f" = (
/obj/structure/window/reinforced/fulltile,
/turf/open/floor/plating/airless,
/area/ruin/unpowered)
"g" = (
/obj/effect/decal/remains/robot,
/turf/open/floor/plating/airless,
/area/ruin/unpowered)
"h" = (
/mob/living/simple_animal/hostile/swarmer/ai/melee_combat,
/turf/open/floor/plating/airless,
/area/ruin/unpowered)
"i" = (
/obj/machinery/door/airlock/external{
	req_access_txt = "150"
	},
/turf/open/floor/plating/airless,
/area/ruin/unpowered)
"j" = (
/obj/structure/swarmer/trap,
/turf/open/floor/plating/airless,
/area/ruin/unpowered)
"k" = (
/obj/effect/decal/cleanable/robot_debris/gib,
/turf/open/floor/plating/airless,
/area/ruin/unpowered)
"l" = (
/mob/living/simple_animal/hostile/swarmer/ai/ranged_combat,
/turf/open/floor/plating/airless,
/area/ruin/unpowered)
"m" = (
/obj/structure/swarmer/blockade,
/turf/open/floor/plating/airless,
/area/ruin/unpowered)
"n" = (
/obj/item/deactivated_swarmer,
/turf/open/floor/plating/airless,
/area/ruin/unpowered)
"o" = (
/obj/item/pen,
/turf/open/floor/plating/airless,
/area/ruin/unpowered)
"p" = (
/obj/item/clothing/head/beret/vintage,
/turf/open/floor/plating/airless,
/area/ruin/unpowered)
"q" = (
/obj/item/clothing/under/color/random,
/obj/item/clothing/under/color/random,
/obj/item/clothing/under/color/random,
/turf/open/floor/plating/airless,
/area/ruin/unpowered)
"r" = (
/obj/item/clothing/shoes/winterboots,
/obj/item/clothing/shoes/winterboots,
/turf/open/floor/plating/airless,
/area/ruin/unpowered)

(1,1,1) = {"
a
a
a
a
a
a
a
a
a
a
a
a
a
a
a
a
a
a
a
a
a
a
a
a
a
a
a
a
a
a
a
a
a
a
a
a
a
a
a
a
"}
(2,1,1) = {"
a
a
a
a
a
a
a
a
a
a
a
a
a
a
a
a
a
a
a
a
a
a
a
a
a
a
a
a
a
a
a
a
a
a
a
a
a
a
a
a
"}
(3,1,1) = {"
a
a
a
a
a
a
a
a
a
a
a
a
a
a
a
a
a
a
a
a
a
a
a
a
a
a
a
a
a
a
a
a
a
a
a
a
a
a
a
a
"}
(4,1,1) = {"
a
a
a
a
a
a
a
a
a
a
a
a
a
a
a
a
a
a
a
a
a
a
a
a
a
a
a
a
a
a
a
a
a
a
a
b
a
a
a
a
"}
(5,1,1) = {"
a
a
a
a
a
a
a
a
a
a
a
a
a
a
a
a
a
a
a
a
a
a
a
a
a
a
a
a
a
a
a
a
a
a
b
b
b
a
a
a
"}
(6,1,1) = {"
a
a
a
a
a
a
a
a
a
a
a
a
a
a
a
a
a
a
a
a
a
a
a
a
a
a
a
a
a
a
a
a
a
a
b
b
b
a
a
a
"}
(7,1,1) = {"
a
a
a
a
a
a
a
a
a
a
a
a
a
a
a
a
a
a
a
a
a
a
a
a
a
a
a
a
a
a
a
a
a
a
a
b
a
a
a
a
"}
(8,1,1) = {"
a
a
a
a
a
a
a
a
a
a
a
a
a
a
a
a
a
a
a
a
a
a
a
a
a
a
a
a
a
a
a
a
a
a
a
a
a
a
a
a
"}
(9,1,1) = {"
a
a
a
a
a
a
a
a
a
a
a
a
a
a
a
a
a
a
a
c
c
c
i
c
c
c
a
a
a
a
a
a
a
a
a
a
a
a
a
a
"}
(10,1,1) = {"
a
a
a
a
a
a
a
a
a
a
a
a
a
a
a
a
a
a
a
f
e
e
j
e
e
c
b
b
b
a
a
a
a
a
a
a
a
a
a
a
"}
(11,1,1) = {"
a
a
a
a
a
a
a
a
a
a
a
a
a
a
a
a
a
a
a
f
e
g
e
h
e
c
b
b
b
b
b
a
a
a
a
a
a
a
a
a
"}
(12,1,1) = {"
a
a
a
a
a
a
a
a
a
a
a
a
a
a
a
a
a
a
a
f
e
e
e
e
e
c
d
b
b
b
b
a
a
a
a
a
a
a
a
a
"}
(13,1,1) = {"
a
a
a
a
a
a
a
a
a
a
a
a
a
a
a
a
a
a
a
f
e
h
e
e
p
c
d
d
b
b
b
b
a
a
a
a
a
a
a
a
"}
(14,1,1) = {"
a
a
a
a
a
a
a
a
a
a
a
a
a
a
a
a
a
a
a
f
e
e
k
e
e
c
d
d
d
b
b
b
b
a
a
a
a
a
a
a
"}
(15,1,1) = {"
a
a
a
a
a
a
a
a
a
a
a
a
a
a
a
a
a
a
b
c
c
c
c
j
j
c
c
c
c
c
c
c
c
a
a
a
a
a
a
a
"}
(16,1,1) = {"
a
a
a
a
a
a
a
a
a
a
a
a
a
a
a
a
a
b
b
b
d
d
c
e
e
l
e
e
e
e
e
e
c
b
a
a
a
a
a
a
"}
(17,1,1) = {"
a
a
a
a
a
a
a
a
a
a
a
a
a
a
a
a
a
b
b
b
d
d
c
e
e
e
e
e
e
e
h
e
c
b
b
b
a
a
a
a
"}
(18,1,1) = {"
a
a
a
a
a
a
a
a
a
a
a
a
a
a
a
a
a
b
b
b
b
d
c
e
e
m
m
m
h
e
e
e
c
d
b
b
b
a
a
a
"}
(19,1,1) = {"
a
a
a
a
a
a
a
a
a
a
a
a
a
a
a
a
a
a
b
b
b
b
c
e
e
m
e
e
e
e
e
k
c
d
d
b
b
a
a
a
"}
(20,1,1) = {"
a
a
a
a
a
a
a
a
a
a
a
a
a
a
a
a
a
a
a
b
b
b
c
e
e
m
n
g
e
m
e
e
c
d
d
d
b
b
a
a
"}
(21,1,1) = {"
a
a
a
a
a
a
a
a
a
a
a
a
a
a
a
a
a
a
a
b
b
b
c
e
e
m
e
e
n
m
e
e
c
c
c
c
c
c
a
a
"}
(22,1,1) = {"
a
a
a
a
a
a
a
a
a
a
a
a
a
a
a
a
a
a
a
a
a
b
c
e
e
e
e
e
e
m
e
e
m
e
r
q
e
f
a
a
"}
(23,1,1) = {"
a
a
a
a
a
a
a
a
a
a
a
a
a
a
a
a
a
a
a
a
a
a
c
e
e
e
h
m
m
m
e
l
j
e
e
e
e
f
a
a
"}
(24,1,1) = {"
a
a
a
a
a
a
a
a
a
a
a
a
a
a
a
a
a
a
a
a
a
a
c
e
h
e
e
e
e
g
e
e
j
e
e
g
e
f
a
a
"}
(25,1,1) = {"
a
a
a
a
a
a
a
a
a
a
a
a
a
a
a
a
b
a
a
a
a
a
c
o
n
e
e
e
e
e
e
e
m
e
e
h
e
f
a
a
"}
(26,1,1) = {"
a
a
a
a
a
a
a
a
a
a
a
a
a
a
a
a
b
b
a
a
a
a
c
c
c
c
c
c
c
c
c
c
c
e
e
e
e
f
a
a
"}
(27,1,1) = {"
a
a
a
a
a
a
a
a
a
a
a
a
a
a
a
a
a
a
a
a
a
a
a
b
b
b
b
d
d
d
d
d
c
h
e
e
e
f
a
a
"}
(28,1,1) = {"
a
a
a
a
a
a
a
a
a
a
a
a
a
a
a
a
a
a
a
a
a
a
a
a
b
b
b
b
b
d
d
d
c
e
e
e
e
f
a
a
"}
(29,1,1) = {"
a
a
a
a
a
a
a
a
a
a
a
a
a
a
a
a
a
a
a
a
a
a
a
a
a
b
b
b
b
b
b
d
c
e
j
e
e
f
a
a
"}
(30,1,1) = {"
a
a
a
a
a
a
a
a
a
a
a
a
a
a
a
a
a
a
a
a
a
a
a
a
a
b
b
b
b
b
b
b
c
c
i
c
c
c
a
a
"}
(31,1,1) = {"
a
a
a
a
a
a
a
a
a
a
a
a
a
a
a
a
a
a
a
a
a
a
a
a
a
a
a
b
b
b
b
a
a
a
a
a
a
a
a
a
"}
(32,1,1) = {"
a
a
a
a
a
a
a
a
a
a
a
a
a
a
a
a
a
a
a
a
a
a
a
a
a
a
a
a
a
a
a
a
a
a
a
a
a
a
a
a
"}
(33,1,1) = {"
a
a
a
a
a
a
a
a
a
a
a
a
a
a
a
a
a
a
b
a
a
a
a
a
a
a
a
a
a
a
a
a
a
a
a
a
a
a
a
a
"}
(34,1,1) = {"
a
a
a
a
a
a
a
a
a
a
a
a
a
a
a
a
b
b
b
b
a
a
a
a
a
a
a
a
a
a
a
a
a
a
a
a
a
a
a
a
"}
(35,1,1) = {"
a
a
a
a
a
a
a
a
a
a
a
a
a
a
a
a
b
b
b
b
a
a
a
a
a
a
a
a
a
a
a
a
a
a
a
a
a
a
a
a
"}
(36,1,1) = {"
a
a
a
a
a
a
a
a
a
a
a
a
a
a
a
a
a
b
b
a
a
a
a
a
a
a
a
a
a
a
a
a
a
a
a
a
a
a
a
a
"}
(37,1,1) = {"
a
a
a
a
a
a
a
a
a
a
a
a
a
a
a
a
a
a
a
a
a
a
a
a
a
a
a
a
a
a
a
a
a
a
a
a
a
a
a
a
"}
(38,1,1) = {"
a
a
a
a
a
a
a
a
a
a
a
a
a
a
a
a
a
a
a
a
a
a
a
a
a
a
a
a
a
a
a
a
a
a
a
a
a
a
a
a
"}
(39,1,1) = {"
a
a
a
a
a
a
a
a
a
a
a
a
a
a
a
a
a
a
a
a
a
a
a
a
a
a
a
a
a
a
a
a
a
a
a
a
a
a
a
a
"}
(40,1,1) = {"
a
a
a
a
a
a
a
a
a
a
a
a
a
a
a
a
a
a
a
a
a
a
a
a
a
a
a
a
a
a
a
a
a
a
a
a
a
a
a
a
"}
