//MAP CONVERTED BY dmm2tgm.py THIS HEADER COMMENT PREVENTS RECONVERSION, DO NOT REMOVE
"aa" = (
/turf/template_noop,
/area/template_noop)
"ab" = (
/obj/structure/lattice{
	dir = 1
	},
/turf/template_noop,
/area/space/nearstation)
"ac" = (
/obj/structure/grille{
	dir = 1
	},
/turf/open/floor/plating/airless,
/area/ruin/space/has_grav/turretedoutpost)
"ad" = (
/turf/closed/wall/r_wall,
/area/ruin/space/has_grav/turretedoutpost)
"ae" = (
/obj/structure/table/reinforced{
	dir = 1
	},
/obj/item/stock_parts/cell/hyper{
	dir = 1
	},
/turf/open/floor/plasteel,
/area/ruin/space/has_grav/turretedoutpost)
"af" = (
/obj/structure/frame/computer{
	dir = 1
	},
/turf/open/floor/plasteel,
/area/ruin/space/has_grav/turretedoutpost)
"ag" = (
/turf/open/floor/plasteel,
/area/ruin/space/has_grav/turretedoutpost)
"ah" = (
/obj/machinery/light{
	dir = 2
	},
/turf/open/floor/plasteel,
/area/ruin/space/has_grav/turretedoutpost)
"ai" = (
/obj/machinery/door/airlock/external{
	dir = 1
	},
/obj/effect/mapping_helpers/airlock/cyclelink_helper{
	dir = 4
	},
/turf/open/floor/plating,
/area/ruin/space/has_grav/turretedoutpost)
"aj" = (
/obj/machinery/light{
	dir = 2
	},
/turf/open/floor/plating,
/area/ruin/space/has_grav/turretedoutpost)
"ak" = (
/turf/open/floor/plating,
/area/ruin/space/has_grav/turretedoutpost)
"al" = (
/turf/open/floor/plating/airless,
/area/ruin/space/has_grav/turretedoutpost)
"am" = (
/obj/structure/table/reinforced{
	dir = 1
	},
/obj/item/folder{
	dir = 1
	},
/obj/item/radio{
	dir = 1
	},
/turf/open/floor/plasteel,
/area/ruin/space/has_grav/turretedoutpost)
"an" = (
/obj/structure/chair/office{
	dir = 8
	},
/turf/open/floor/plasteel,
/area/ruin/space/has_grav/turretedoutpost)
"ao" = (
/obj/machinery/porta_turret{
	dir = 1
	},
/turf/open/floor/plating/airless,
/area/ruin/space/has_grav/turretedoutpost)
"ap" = (
/obj/structure/filingcabinet{
	dir = 1
	},
/turf/open/floor/plasteel,
/area/ruin/space/has_grav/turretedoutpost)
"aq" = (
/obj/machinery/light{
	dir = 1
	},
/turf/open/floor/plasteel,
/area/ruin/space/has_grav/turretedoutpost)
"ar" = (
/obj/machinery/power/apc{
	name = "Worn-out APC";
	pixel_y = 24;
	dir = 1
	},
/turf/open/floor/plasteel,
/area/ruin/space/has_grav/turretedoutpost)
"as" = (
/obj/structure/rack{
	dir = 1
	},
/obj/effect/turf_decal/tile/neutral{
	dir = 8
	},
/obj/effect/turf_decal/tile/neutral{
	dir = 2
	},
/turf/open/floor/plasteel/dark,
/area/ruin/space/has_grav/turretedoutpost)
"at" = (
/obj/item/rack_parts{
	dir = 1
	},
/obj/effect/turf_decal/tile/neutral{
	dir = 8
	},
/obj/effect/turf_decal/tile/neutral{
	dir = 2
	},
/turf/open/floor/plasteel/dark,
/area/ruin/space/has_grav/turretedoutpost)
"au" = (
/obj/item/rack_parts{
	dir = 1
	},
/obj/machinery/light{
	dir = 2
	},
/obj/effect/turf_decal/tile/neutral{
	dir = 8
	},
/obj/effect/turf_decal/tile/neutral{
	dir = 2
	},
/turf/open/floor/plasteel/dark,
/area/ruin/space/has_grav/turretedoutpost)
"av" = (
/obj/structure/rack{
	dir = 1
	},
/obj/item/firing_pin{
	dir = 1
	},
/obj/effect/turf_decal/tile/neutral{
	dir = 8
	},
/obj/effect/turf_decal/tile/neutral{
	dir = 2
	},
/turf/open/floor/plasteel/dark,
/area/ruin/space/has_grav/turretedoutpost)
"aw" = (
/obj/machinery/door/airlock/public/glass{
	dir = 1
	},
/turf/open/floor/plasteel,
/area/ruin/space/has_grav/turretedoutpost)
"ax" = (
/obj/machinery/door/airlock{
	dir = 1
	},
/turf/open/floor/plasteel,
/area/ruin/space/has_grav/turretedoutpost)
"ay" = (
/obj/item/rack_parts{
	dir = 1
	},
/obj/effect/turf_decal/tile/neutral{
	dir = 8
	},
/obj/effect/turf_decal/tile/neutral{
	dir = 1
	},
/turf/open/floor/plasteel/dark,
/area/ruin/space/has_grav/turretedoutpost)
"az" = (
/turf/open/floor/plasteel/dark,
/area/ruin/space/has_grav/turretedoutpost)
"aA" = (
/obj/structure/tank_dispenser/oxygen{
	dir = 1
	},
/turf/open/floor/plasteel/dark,
/area/ruin/space/has_grav/turretedoutpost)
"aB" = (
/obj/structure/table/reinforced{
	dir = 1
	},
/obj/item/clothing/head/ushanka{
	dir = 1
	},
/obj/effect/turf_decal/tile/red{
	dir = 4
	},
/obj/effect/turf_decal/tile/red{
	dir = 2
	},
/obj/effect/turf_decal/tile/red{
	dir = 8
	},
/obj/effect/turf_decal/tile/red{
	dir = 1
	},
/turf/open/floor/plasteel,
/area/ruin/space/has_grav/turretedoutpost)
"aC" = (
/obj/structure/table/reinforced{
	dir = 1
	},
/obj/structure/reagent_dispensers/peppertank{
	pixel_y = -32;
	dir = 1
	},
/turf/open/floor/plasteel,
/area/ruin/space/has_grav/turretedoutpost)
"aD" = (
/obj/structure/table/reinforced{
	dir = 1
	},
/obj/item/clipboard{
	dir = 1
	},
/obj/machinery/light{
	dir = 2
	},
/obj/item/radio{
	dir = 1
	},
/turf/open/floor/plasteel,
/area/ruin/space/has_grav/turretedoutpost)
"aE" = (
/obj/machinery/vending/clothing{
	dir = 1
	},
/turf/open/floor/plasteel,
/area/ruin/space/has_grav/turretedoutpost)
"aF" = (
/obj/structure/rack{
	dir = 1
	},
/obj/effect/turf_decal/tile/neutral{
	dir = 8
	},
/obj/effect/turf_decal/tile/neutral{
	dir = 1
	},
/turf/open/floor/plasteel/dark,
/area/ruin/space/has_grav/turretedoutpost)
"aG" = (
/obj/structure/rack{
	dir = 1
	},
/obj/effect/turf_decal/tile/neutral{
	dir = 8
	},
/obj/effect/turf_decal/tile/neutral{
	dir = 4
	},
/obj/effect/turf_decal/tile/neutral{
	dir = 2
	},
/obj/effect/turf_decal/tile/neutral{
	dir = 1
	},
/turf/open/floor/plasteel/dark,
/area/ruin/space/has_grav/turretedoutpost)
"aH" = (
/obj/structure/rack{
	dir = 1
	},
/obj/item/ammo_box/c9mm{
	dir = 1
	},
/obj/effect/turf_decal/tile/neutral{
	dir = 8
	},
/obj/effect/turf_decal/tile/neutral{
	dir = 4
	},
/obj/effect/turf_decal/tile/neutral{
	dir = 2
	},
/obj/effect/turf_decal/tile/neutral{
	dir = 1
	},
/turf/open/floor/plasteel/dark,
/area/ruin/space/has_grav/turretedoutpost)
"aI" = (
/obj/machinery/door/airlock/public/glass{
	dir = 1
	},
/turf/open/floor/plasteel/dark,
/area/ruin/space/has_grav/turretedoutpost)
"aK" = (
/obj/structure/bed{
	dir = 1
	},
/obj/item/bedsheet/orange{
	dir = 1
	},
/obj/machinery/light{
	dir = 4
	},
/turf/open/floor/plasteel,
/area/ruin/space/has_grav/turretedoutpost)
"aL" = (
/obj/structure/rack{
	dir = 1
	},
/obj/item/clothing/head/helmet/swat{
	dir = 1
	},
/obj/effect/turf_decal/tile/neutral{
	dir = 8
	},
/obj/effect/turf_decal/tile/neutral{
	dir = 1
	},
/turf/open/floor/plasteel/dark,
/area/ruin/space/has_grav/turretedoutpost)
"aM" = (
/obj/structure/rack{
	dir = 1
	},
/obj/item/crowbar/red{
	dir = 1
	},
/obj/item/paper/crumpled{
	dir = 1
	},
/obj/effect/turf_decal/tile/neutral{
	dir = 8
	},
/obj/effect/turf_decal/tile/neutral{
	dir = 4
	},
/obj/effect/turf_decal/tile/neutral{
	dir = 2
	},
/obj/effect/turf_decal/tile/neutral{
	dir = 1
	},
/turf/open/floor/plasteel/dark,
/area/ruin/space/has_grav/turretedoutpost)
"aN" = (
/obj/structure/chair/office{
	dir = 1
	},
/turf/open/floor/plasteel,
/area/ruin/space/has_grav/turretedoutpost)
"aO" = (
/obj/structure/chair/comfy/beige{
	dir = 4
	},
/turf/open/floor/plasteel,
/area/ruin/space/has_grav/turretedoutpost)
"aP" = (
/obj/structure/bed{
	dir = 1
	},
/obj/item/bedsheet/orange{
	dir = 1
	},
/turf/open/floor/plasteel,
/area/ruin/space/has_grav/turretedoutpost)
"aQ" = (
/obj/structure/rack{
	dir = 1
	},
/obj/item/grenade/chem_grenade/teargas{
	dir = 1
	},
/turf/open/floor/plasteel/dark,
/area/ruin/space/has_grav/turretedoutpost)
"aR" = (
/obj/structure/table/reinforced{
	dir = 1
	},
/obj/item/paper/crumpled{
	dir = 1
	},
/obj/effect/turf_decal/tile/red{
	dir = 4
	},
/obj/effect/turf_decal/tile/red{
	dir = 2
	},
/obj/effect/turf_decal/tile/red{
	dir = 8
	},
/obj/effect/turf_decal/tile/red{
	dir = 1
	},
/turf/open/floor/plasteel,
/area/ruin/space/has_grav/turretedoutpost)
"aS" = (
/obj/structure/table/reinforced{
	dir = 1
	},
/obj/machinery/light{
	dir = 1
	},
/obj/item/camera_bug{
	dir = 1
	},
/turf/open/floor/plasteel,
/area/ruin/space/has_grav/turretedoutpost)
"aT" = (
/obj/structure/table/reinforced{
	dir = 1
	},
/obj/item/paper_bin{
	dir = 1
	},
/turf/open/floor/plasteel,
/area/ruin/space/has_grav/turretedoutpost)
"aU" = (
/obj/structure/table/reinforced{
	dir = 1
	},
/obj/item/pen/blue{
	dir = 1
	},
/turf/open/floor/plasteel,
/area/ruin/space/has_grav/turretedoutpost)
"aV" = (
/obj/structure/table/wood{
	dir = 1
	},
/obj/item/reagent_containers/food/drinks/bottle/vodka{
	pixel_x = -4;
	pixel_y = -4;
	dir = 1
	},
/obj/item/reagent_containers/food/drinks/bottle/vodka/badminka{
	pixel_x = 3;
	dir = 1
	},
/turf/open/floor/plasteel,
/area/ruin/space/has_grav/turretedoutpost)
"aW" = (
/obj/structure/rack{
	dir = 1
	},
/obj/effect/turf_decal/tile/neutral{
	dir = 4
	},
/obj/effect/turf_decal/tile/neutral{
	dir = 1
	},
/turf/open/floor/plasteel/dark,
/area/ruin/space/has_grav/turretedoutpost)
"aX" = (
/obj/item/rack_parts{
	dir = 1
	},
/obj/effect/turf_decal/tile/neutral{
	dir = 4
	},
/obj/effect/turf_decal/tile/neutral{
	dir = 1
	},
/turf/open/floor/plasteel/dark,
/area/ruin/space/has_grav/turretedoutpost)
"aY" = (
/obj/structure/rack{
	dir = 1
	},
/obj/item/storage/belt/military{
	dir = 1
	},
/obj/machinery/light{
	dir = 1
	},
/obj/effect/turf_decal/tile/neutral{
	dir = 4
	},
/obj/effect/turf_decal/tile/neutral{
	dir = 1
	},
/turf/open/floor/plasteel/dark,
/area/ruin/space/has_grav/turretedoutpost)
"aZ" = (
/obj/structure/rack{
	dir = 1
	},
/obj/item/clothing/head/helmet/riot{
	dir = 1
	},
/obj/effect/turf_decal/tile/neutral{
	dir = 4
	},
/obj/effect/turf_decal/tile/neutral{
	dir = 1
	},
/turf/open/floor/plasteel/dark,
/area/ruin/space/has_grav/turretedoutpost)
"ba" = (
/obj/structure/table/wood{
	dir = 1
	},
/obj/item/reagent_containers/food/snacks/breadslice/meat{
	dir = 1
	},
/obj/machinery/light{
	dir = 8
	},
/turf/open/floor/plasteel,
/area/ruin/space/has_grav/turretedoutpost)
"tK" = (
/obj/effect/turf_decal/tile/red{
	dir = 4
	},
/obj/effect/turf_decal/tile/red{
	dir = 2
	},
/obj/effect/turf_decal/tile/red{
	dir = 8
	},
/obj/effect/turf_decal/tile/red{
	dir = 1
	},
/turf/open/floor/plasteel,
/area/ruin/space/has_grav/turretedoutpost)
"Nu" = (
/obj/machinery/door/airlock/external{
	dir = 1
	},
/obj/effect/mapping_helpers/airlock/cyclelink_helper{
	dir = 8
	},
/turf/open/floor/plating,
/area/ruin/space/has_grav/turretedoutpost)

(1,1,1) = {"
aa
aa
aa
aa
aa
aa
aa
ab
aa
aa
aa
aa
aa
aa
aa
aa
aa
aa"}(2,1,1) = {"
aa
aa
aa
ab
aa
ab
ab
ab
aa
aa
aa
aa
aa
aa
aa
aa
aa
aa"}(3,1,1) = {"
aa
aa
ab
ab
al
al
al
al
al
al
al
al
aa
aa
aa
aa
aa
aa"}(4,1,1) = {"
aa
ab
ab
al
ao
ad
ad
ad
ad
ad
ad
ao
al
aa
aa
aa
aa
aa"}(5,1,1) = {"
aa
aa
ab
al
ad
ad
aF
aL
aF
ay
ad
ad
al
aa
aa
aa
aa
aa"}(6,1,1) = {"
aa
aa
ab
al
ad
aW
az
az
az
az
as
ad
al
ab
ab
ab
ab
aa"}(7,1,1) = {"
aa
ab
ab
al
ad
aX
az
aG
aG
az
at
ad
al
aa
ab
aa
aa
aa"}(8,1,1) = {"
aa
aa
aa
al
ad
aY
az
aM
aH
az
au
ad
al
aa
ab
ab
aa
aa"}(9,1,1) = {"
aa
aa
ab
al
ad
aZ
az
az
az
az
av
ad
al
aa
ab
ab
ab
aa"}(10,1,1) = {"
aa
aa
ab
al
ad
ad
aQ
az
az
aA
ad
ad
al
aa
ab
aa
ab
aa"}(11,1,1) = {"
aa
aa
ab
al
ao
ad
ad
aI
aI
ad
ad
ac
ac
ac
ac
ac
aa
aa"}(12,1,1) = {"
aa
ab
ab
ab
al
ad
aR
tK
tK
aB
ad
ad
ad
ad
ad
ac
aa
aa"}(13,1,1) = {"
aa
aa
aa
ab
al
ad
aS
ag
ag
aC
ad
ap
am
ae
ad
ac
aa
aa"}(14,1,1) = {"
aa
aa
aa
aa
al
ad
aT
aN
ag
aD
ad
aq
an
af
ad
ac
aa
aa"}(15,1,1) = {"
ab
ab
ab
ac
ac
ad
aU
ag
ag
ag
aw
ag
ag
af
ad
ac
aa
aa"}(16,1,1) = {"
aa
aa
ab
ac
ad
ad
ad
ad
ad
ad
ad
ag
ag
af
ad
ac
ab
aa"}(17,1,1) = {"
aa
ab
ab
ac
ad
ba
aV
aO
ag
ag
ax
ag
ag
ag
ad
ac
aa
aa"}(18,1,1) = {"
aa
aa
aa
ac
ad
ag
ag
ag
ag
aE
ad
ar
ag
ah
ad
ac
ab
aa"}(19,1,1) = {"
aa
aa
aa
ac
ad
ag
ag
ag
ag
ad
ad
ad
ai
ai
ad
ac
aa
ab"}(20,1,1) = {"
aa
aa
aa
ac
ad
aP
aP
aP
aK
ad
al
ad
ak
aj
ad
ac
ab
ab"}(21,1,1) = {"
aa
ab
ab
ac
ad
ad
ad
ad
ad
ad
al
ad
ak
ak
ad
ac
ab
aa"}(22,1,1) = {"
aa
ab
aa
ac
ac
ac
ac
ac
ac
ac
ac
ad
Nu
Nu
ad
ac
ab
ab"}