//MAP CONVERTED BY dmm2tgm.py THIS HEADER COMMENT PREVENTS RECONVERSION, DO NOT REMOVE
"c" = (
/obj/structure/chair/fancy/shuttle{
	dir = 4
	},
/obj/effect/turf_decal/stripes/line{
	dir = 4
	},
/obj/structure/cable/yellow{
	icon_state = "1-2"
	},
/obj/structure/cable/yellow{
	icon_state = "1-4"
	},
/turf/open/floor/mineral/titanium/blue,
/area/shuttle/pod_1)
"h" = (
/obj/effect/turf_decal/stripes/line,
/obj/machinery/power/smes/engineering{
	charge = 1e+006
	},
/obj/structure/cable/yellow{
	icon_state = "0-2"
	},
/turf/open/floor/mineral/titanium/blue,
/area/shuttle/pod_1)
"m" = (
/obj/machinery/door/airlock/titanium{
	name = "Shuttle Airlock"
	},
/obj/structure/fans/tiny,
/obj/docking_port/mobile{
	dwidth = 2;
	height = 7;
	id = "tram_corg";
	launch_status = 0;
	name = "transport shuttle";
	preferred_direction = 2;
	width = 5
	},
/turf/open/floor/mineral/titanium/white,
/area/shuttle/pod_1)
"p" = (
/turf/open/floor/mineral/titanium/white,
/area/shuttle/pod_1)
"t" = (
/obj/structure/cable/yellow{
	icon_state = "4-8"
	},
/turf/open/floor/mineral/titanium/white,
/area/shuttle/pod_1)
"w" = (
/obj/item/radio/intercom{
	pixel_x = 30
	},
/obj/effect/turf_decal/stripes/line{
	dir = 8
	},
/obj/machinery/power/engine_capacitor_bank{
	dir = 1
	},
/obj/structure/cable/yellow,
/turf/open/floor/mineral/titanium/blue,
/area/shuttle/pod_1)
"y" = (
/obj/effect/turf_decal/stripes/line{
	dir = 4
	},
/obj/structure/sign/poster/random{
	pixel_x = -32
	},
/obj/machinery/power/engine_capacitor_bank{
	dir = 1
	},
/obj/structure/cable/yellow,
/turf/open/floor/mineral/titanium/blue,
/area/shuttle/pod_1)
"C" = (
/obj/effect/turf_decal/stripes/line,
/obj/structure/table,
/turf/open/floor/mineral/titanium/blue,
/area/shuttle/pod_1)
"D" = (
/obj/structure/chair/fancy/shuttle{
	dir = 8
	},
/obj/machinery/status_display/evac{
	pixel_x = 32
	},
/obj/effect/turf_decal/stripes/line{
	dir = 9
	},
/turf/open/floor/mineral/titanium/blue,
/area/shuttle/pod_1)
"E" = (
/turf/closed/wall/mineral/titanium,
/area/template_noop)
"I" = (
/obj/machinery/light{
	dir = 1
	},
/obj/effect/turf_decal/stripes/line,
/obj/machinery/computer/shuttle_flight{
	possible_destinations = "corg_north;corg_south";
	shuttleId = "tram_corg"
	},
/obj/machinery/power/terminal{
	dir = 8
	},
/turf/open/floor/mineral/titanium/blue,
/area/shuttle/pod_1)
"K" = (
/turf/closed/wall/mineral/titanium,
/area/shuttle/pod_1)
"M" = (
/obj/structure/chair/fancy/shuttle{
	dir = 4
	},
/obj/machinery/status_display/evac{
	pixel_x = -32
	},
/obj/effect/turf_decal/stripes/line{
	dir = 5
	},
/obj/structure/cable/yellow{
	icon_state = "1-2"
	},
/turf/open/floor/mineral/titanium/blue,
/area/shuttle/pod_1)
"P" = (
/obj/structure/cable/yellow{
	icon_state = "1-2"
	},
/turf/open/floor/mineral/titanium/white,
/area/shuttle/pod_1)
"S" = (
/obj/structure/grille,
/obj/structure/window/shuttle,
/turf/open/floor/plating,
/area/shuttle/pod_1)
"U" = (
/obj/machinery/shuttle/engine/ion{
	dir = 1
	},
/turf/closed/wall/mineral/titanium,
/area/shuttle/pod_1)
"W" = (
/obj/structure/chair/fancy/shuttle{
	dir = 8
	},
/obj/effect/turf_decal/stripes/line{
	dir = 8
	},
/obj/structure/cable/yellow{
	icon_state = "2-8"
	},
/turf/open/floor/mineral/titanium/blue,
/area/shuttle/pod_1)
"X" = (
/obj/structure/chair/fancy/shuttle{
	dir = 1
	},
/turf/open/floor/mineral/titanium/white,
/area/shuttle/pod_1)

(1,1,1) = {"
E
K
S
K
S
K
K
"}
(2,1,1) = {"
S
h
P
M
c
y
U
"}
(3,1,1) = {"
S
I
X
p
t
p
m
"}
(4,1,1) = {"
S
C
p
D
W
w
U
"}
(5,1,1) = {"
E
K
S
K
S
K
K
"}
