"a" = (/obj/structure/flora/rock/pile,/turf/open/floor/plating/asteroid,/area/ruin/unpowered)
"e" = (/obj/structure/flora/rock/jungle,/turf/open/floor/plating/asteroid,/area/ruin/unpowered)
"u" = (/obj/structure/flora/rock,/turf/open/floor/plating/asteroid,/area/ruin/unpowered)
"Q" = (/obj/structure/flora/junglebush/large,/turf/open/floor/plating/asteroid,/area/ruin/unpowered)
"T" = (/turf/open/floor/plating/asteroid,/area/ruin/unpowered)

(1,1,1) = {"
TQTTu
euTaQ
TTQTT
TeTuT
aTTTQ
"}
