//MAP CONVERTED BY dmm2tgm.py THIS HEADER COMMENT PREVENTS RECONVERSION, DO NOT REMOVE
"cj" = (
/obj/effect/landmark/exploration_weapon_spawner{
	dir = 4
	},
/turf/closed/wall/mineral/plastitanium,
/area/shuttle/exploration/ruin/syndicate/fighter)
"dt" = (
/obj/machinery/button/door{
	id = "caravansyndicate1_bolt";
	name = "External Bolt Control";
	normaldoorcontrol = 1;
	pixel_x = -25;
	req_access_txt = "150";
	specialfunctions = 4
	},
/obj/effect/decal/cleanable/dirt,
/obj/machinery/computer/camera_advanced/shuttle_docker/caravan/syndicate1,
/turf/open/floor/mineral/plastitanium/red,
/area/shuttle/exploration/ruin/syndicate/fighter)
"kt" = (
/obj/effect/landmark/exploration_weapon_spawner/down{
	dir = 4
	},
/turf/closed/wall/mineral/plastitanium,
/area/shuttle/exploration/ruin/syndicate/fighter)
"nr" = (
/obj/effect/mapping_helpers/airlock/locked,
/obj/machinery/door/airlock/hatch{
	id_tag = "caravansyndicate1_bolt";
	name = "External Airlock";
	normalspeed = 0;
	req_access_txt = "150"
	},
/obj/effect/decal/cleanable/dirt,
/obj/docking_port/mobile{
	callTime = 50;
	dir = 4;
	dwidth = 4;
	height = 5;
	id = "syndicatefighter";
	ignitionTime = 25;
	name = "Syndicate Fighter";
	port_direction = 2;
	preferred_direction = 4;
	width = 9
	},
/turf/open/floor/plating,
/area/shuttle/exploration/ruin/syndicate/fighter)
"sV" = (
/obj/effect/decal/cleanable/dirt,
/obj/effect/decal/cleanable/dirt,
/obj/machinery/computer/shuttle/caravan/syndicate1{
	dir = 8
	},
/turf/open/floor/mineral/plastitanium/red,
/area/shuttle/exploration/ruin/syndicate/fighter)
"uF" = (
/obj/machinery/power/apc/highcap/fifteen_k{
	dir = 8;
	name = "Syndicate Fighter APC";
	pixel_x = -24;
	req_access = null;
	req_access_txt = "150"
	},
/obj/machinery/computer/security{
	dir = 1;
	network = list("caravansyndicate1")
	},
/obj/structure/cable/yellow,
/turf/open/floor/mineral/plastitanium/red,
/area/shuttle/exploration/ruin/syndicate/fighter)
"wL" = (
/turf/closed/wall/mineral/plastitanium/nodiagonal,
/area/shuttle/exploration/ruin/syndicate/fighter)
"Jv" = (
/turf/template_noop,
/area/template_noop)
"MX" = (
/turf/closed/wall/mineral/plastitanium,
/area/shuttle/exploration/ruin/syndicate/fighter)
"OV" = (
/obj/machinery/camera/xray{
	c_tag = "External View";
	dir = 4;
	network = list("caravansyndicate1");
	pixel_x = 32
	},
/turf/closed/wall/mineral/plastitanium/nodiagonal,
/area/shuttle/exploration/ruin/syndicate/fighter)
"PM" = (
/obj/structure/chair/comfy/shuttle{
	dir = 4
	},
/obj/machinery/turretid{
	ailock = 1;
	control_area = null;
	desc = "A specially designed set of turret controls. Looks to be covered in protective casing to prevent AI interfacing.";
	icon_state = "control_kill";
	lethal = 1;
	name = "Shuttle turret control";
	pixel_x = 32;
	pixel_y = -28;
	req_access = null;
	req_access_txt = "150"
	},
/obj/structure/cable/yellow{
	icon_state = "0-2"
	},
/mob/living/simple_animal/hostile/syndicate/ranged/smg/pilot{
	environment_smash = 0
	},
/turf/open/floor/mineral/plastitanium/red,
/area/shuttle/exploration/ruin/syndicate/fighter)
"Sj" = (
/obj/structure/shuttle/engine/propulsion/burst{
	dir = 8
	},
/turf/closed/wall/mineral/plastitanium,
/area/shuttle/exploration/ruin/syndicate/fighter)

(1,1,1) = {"
Jv
Jv
Sj
wL
nr
wL
Sj
Jv
Jv
"}
(2,1,1) = {"
Jv
Sj
wL
dt
PM
uF
wL
Sj
Jv
"}
(3,1,1) = {"
cj
wL
wL
wL
sV
wL
wL
wL
kt
"}
(4,1,1) = {"
wL
MX
Jv
MX
OV
MX
Jv
MX
wL
"}
(5,1,1) = {"
MX
Jv
Jv
Jv
Jv
Jv
Jv
Jv
MX
"}
