//MAP CONVERTED BY dmm2tgm.py THIS HEADER COMMENT PREVENTS RECONVERSION, DO NOT REMOVE
"f" = (
/obj/structure/chair/comfy/shuttle{
	dir = 1
	},
/mob/living/simple_animal/hostile/nanotrasen,
/obj/machinery/light/small{
	dir = 8
	},
/obj/effect/turf_decal/stripes/corner,
/obj/effect/turf_decal/stripes/line{
	dir = 1
	},
/obj/machinery/power/apc{
	name = "Prisoner Transport Vessel APC";
	pixel_y = -24;
	req_access = null
	},
/turf/open/floor/mineral/titanium,
/area/shuttle/exploration/ruin)
"g" = (
/obj/structure/chair/comfy/shuttle{
	dir = 4
	},
/obj/effect/turf_decal/stripes/corner{
	dir = 4
	},
/obj/machinery/light/small{
	dir = 8
	},
/turf/open/floor/mineral/plastitanium/red,
/area/shuttle/exploration/ruin)
"h" = (
/obj/effect/turf_decal/stripes/line{
	dir = 8
	},
/obj/effect/turf_decal/stripes/line{
	dir = 4
	},
/turf/open/floor/mineral/titanium,
/area/shuttle/exploration/ruin)
"j" = (
/obj/effect/spawner/structure/window/shuttle,
/turf/open/floor/plating,
/area/shuttle/exploration/ruin)
"k" = (
/obj/structure/chair/comfy/shuttle{
	dir = 8
	},
/obj/machinery/newscaster{
	pixel_x = 32
	},
/turf/open/floor/mineral/plastitanium/red,
/area/shuttle/exploration/ruin)
"r" = (
/obj/effect/turf_decal/stripes/corner{
	dir = 1
	},
/obj/effect/turf_decal/stripes/corner{
	dir = 4
	},
/obj/effect/turf_decal/stripes/line,
/turf/open/floor/mineral/titanium,
/area/shuttle/exploration/ruin)
"s" = (
/turf/open/floor/mineral/plastitanium/red,
/area/shuttle/exploration/ruin)
"v" = (
/obj/machinery/computer/weapons,
/obj/effect/turf_decal/stripes/line{
	dir = 6
	},
/turf/open/floor/mineral/titanium,
/area/shuttle/exploration/ruin)
"w" = (
/obj/structure/fans/tiny,
/obj/machinery/door/airlock/security,
/obj/effect/mapping_helpers/airlock/locked,
/obj/docking_port/mobile{
	dir = 8;
	dwidth = 3;
	height = 4;
	id = "set_by_code";
	movement_force = list("KNOCKDOWN" = 0, "THROW" = 0);
	name = "Nanotrasen Prisoner Transport Vessel";
	port_direction = 8;
	preferred_direction = 4;
	width = 14
	},
/turf/open/floor/mineral/plastitanium/red,
/area/shuttle/exploration/ruin)
"y" = (
/obj/structure/chair/comfy/shuttle{
	dir = 4
	},
/turf/open/floor/mineral/plastitanium/red,
/area/shuttle/exploration/ruin)
"A" = (
/obj/machinery/computer/system_map,
/obj/effect/turf_decal/stripes/line{
	dir = 10
	},
/turf/open/floor/mineral/titanium,
/area/shuttle/exploration/ruin)
"F" = (
/obj/structure/chair/comfy/shuttle{
	dir = 8
	},
/obj/effect/turf_decal/stripes/corner{
	dir = 1
	},
/turf/open/floor/mineral/plastitanium/red,
/area/shuttle/exploration/ruin)
"G" = (
/obj/structure/table/reinforced,
/obj/item/gun/energy/disabler,
/obj/item/storage/box/handcuffs,
/obj/item/assembly/flash,
/obj/effect/turf_decal/stripes/end{
	dir = 1
	},
/turf/open/floor/mineral/titanium,
/area/shuttle/exploration/ruin)
"I" = (
/obj/structure/chair/comfy/shuttle{
	dir = 1
	},
/mob/living/simple_animal/hostile/nanotrasen,
/obj/machinery/light/small{
	dir = 4
	},
/obj/effect/turf_decal/stripes/corner{
	dir = 8
	},
/obj/effect/turf_decal/stripes/line{
	dir = 1
	},
/obj/machinery/newscaster/security_unit{
	pixel_y = -28
	},
/turf/open/floor/mineral/titanium,
/area/shuttle/exploration/ruin)
"J" = (
/obj/machinery/flasher/portable,
/obj/item/wrench,
/obj/structure/closet/crate,
/obj/effect/spawner/lootdrop/armory_contraband,
/turf/open/floor/mineral/plastitanium/red,
/area/shuttle/exploration/ruin)
"L" = (
/obj/effect/turf_decal/stripes/line{
	dir = 1
	},
/turf/open/floor/mineral/plastitanium/red,
/area/shuttle/exploration/ruin)
"N" = (
/turf/template_noop,
/area/template_noop)
"O" = (
/obj/structure/shuttle/engine/propulsion/burst,
/turf/open/floor/plating,
/area/shuttle/exploration/ruin)
"Q" = (
/obj/structure/shuttle/engine/heater,
/obj/effect/spawner/structure/window/shuttle,
/turf/open/floor/plating,
/area/shuttle/exploration/ruin)
"R" = (
/obj/machinery/door/airlock/security,
/turf/open/floor/mineral/plastitanium/red,
/area/shuttle/exploration/ruin)
"U" = (
/obj/effect/landmark/exploration_weapon_spawner/right{
	dir = 1
	},
/turf/closed/wall/mineral/titanium/nodiagonal,
/area/shuttle/exploration/ruin)
"V" = (
/obj/effect/landmark/exploration_weapon_spawner/left{
	dir = 1
	},
/turf/closed/wall/mineral/titanium/nodiagonal,
/area/shuttle/exploration/ruin)
"Z" = (
/turf/closed/wall/mineral/titanium/nodiagonal,
/area/shuttle/exploration/ruin)

(1,1,1) = {"
N
j
Z
V
Z
Z
j
Z
Z
Z
"}
(2,1,1) = {"
j
j
v
f
Z
g
J
y
Q
O
"}
(3,1,1) = {"
j
G
h
r
R
L
s
s
Q
O
"}
(4,1,1) = {"
j
j
A
I
Z
F
s
k
Q
O
"}
(5,1,1) = {"
N
j
Z
U
Z
Z
w
Z
Z
Z
"}
