//MAP CONVERTED BY dmm2tgm.py THIS HEADER COMMENT PREVENTS RECONVERSION, DO NOT REMOVE
"at" = (
/mob/living/simple_animal/hostile/pirate{
	environment_smash = 0
	},
/turf/open/floor/plasteel,
/area/shuttle/exploration/ruin/pirate/cutter)
"aA" = (
/obj/structure/table,
/obj/machinery/airalarm/all_access{
	pixel_y = 24
	},
/obj/item/ammo_box/a40mm,
/obj/effect/turf_decal/tile/neutral{
	dir = 1
	},
/obj/effect/turf_decal/tile/neutral,
/obj/effect/turf_decal/tile/neutral{
	dir = 4
	},
/obj/effect/turf_decal/tile/neutral{
	dir = 8
	},
/turf/open/floor/plasteel/dark,
/area/shuttle/exploration/ruin/pirate/cutter)
"bt" = (
/obj/machinery/atmospherics/pipe/manifold/supply/hidden{
	dir = 8
	},
/obj/machinery/meter,
/turf/open/floor/plating,
/area/shuttle/exploration/ruin/pirate/cutter)
"bJ" = (
/obj/effect/turf_decal/tile/red{
	dir = 1
	},
/obj/effect/turf_decal/tile/red{
	dir = 8
	},
/obj/machinery/computer/system_map{
	dir = 8
	},
/turf/open/floor/plasteel/dark,
/area/shuttle/exploration/ruin/pirate/cutter)
"cL" = (
/turf/closed/wall/mineral/plastitanium/nodiagonal,
/area/shuttle/exploration/ruin/pirate/cutter)
"dO" = (
/obj/effect/mapping_helpers/airlock/cyclelink_helper{
	dir = 1
	},
/obj/effect/mapping_helpers/airlock/locked,
/obj/machinery/door/airlock/external{
	id_tag = "explorationpirate_bolt_port"
	},
/turf/open/floor/plating,
/area/shuttle/exploration/ruin/pirate/cutter)
"dW" = (
/obj/machinery/button/door{
	id = "caravanpirate_bolt_port";
	name = "External Bolt Control";
	normaldoorcontrol = 1;
	pixel_x = -4;
	pixel_y = 25;
	specialfunctions = 4
	},
/obj/machinery/atmospherics/pipe/simple/supply/hidden{
	dir = 4
	},
/turf/open/floor/plasteel/white/side{
	dir = 1
	},
/area/shuttle/exploration/ruin/pirate/cutter)
"em" = (
/obj/structure/reagent_dispensers/watertank,
/obj/item/reagent_containers/glass/bucket,
/obj/item/mop,
/obj/effect/turf_decal/stripes/line{
	dir = 5
	},
/turf/open/floor/plating,
/area/shuttle/exploration/ruin/pirate/cutter)
"et" = (
/obj/machinery/atmospherics/pipe/simple/supply/hidden{
	dir = 4
	},
/obj/effect/turf_decal/tile/red{
	dir = 1
	},
/obj/effect/turf_decal/tile/red,
/obj/effect/turf_decal/tile/red{
	dir = 8
	},
/turf/open/floor/plasteel,
/area/shuttle/exploration/ruin/pirate/cutter)
"fb" = (
/obj/machinery/power/terminal{
	dir = 1
	},
/obj/structure/cable{
	icon_state = "0-2"
	},
/obj/structure/closet/crate,
/obj/item/stack/sheet/iron/twenty,
/obj/item/stack/sheet/glass{
	amount = 10
	},
/obj/item/storage/toolbox/mechanical,
/obj/item/flashlight{
	pixel_x = 3;
	pixel_y = 3
	},
/obj/item/stack/sheet/mineral/plasma{
	amount = 20
	},
/obj/effect/turf_decal/stripes/line{
	dir = 4
	},
/turf/open/floor/plating,
/area/shuttle/exploration/ruin/pirate/cutter)
"fq" = (
/obj/effect/landmark/exploration_weapon_spawner/down{
	dir = 4
	},
/turf/closed/wall/mineral/plastitanium/nodiagonal,
/area/shuttle/exploration/ruin/pirate/cutter)
"fH" = (
/obj/structure/closet{
	name = "pirate outfits"
	},
/obj/item/clothing/head/collectable/pirate,
/obj/item/clothing/suit/pirate,
/obj/item/clothing/under/costume/pirate,
/obj/item/clothing/shoes/jackboots,
/obj/item/clothing/head/bandana,
/turf/open/floor/plasteel/dark/side{
	dir = 5
	},
/area/shuttle/exploration/ruin/pirate/cutter)
"fP" = (
/obj/machinery/atmospherics/pipe/simple/supply/hidden{
	dir = 6
	},
/obj/effect/decal/cleanable/dirt,
/turf/open/floor/plasteel,
/area/shuttle/exploration/ruin/pirate/cutter)
"fR" = (
/obj/machinery/atmospherics/pipe/simple/supply/hidden{
	dir = 4
	},
/obj/effect/turf_decal/tile/blue,
/obj/effect/turf_decal/tile/blue{
	dir = 4
	},
/turf/open/floor/plasteel/dark,
/area/shuttle/exploration/ruin/pirate/cutter)
"gu" = (
/obj/structure/table,
/obj/item/circular_saw,
/obj/item/scalpel{
	pixel_y = 12
	},
/obj/item/cautery{
	pixel_x = 4
	},
/obj/machinery/light/small{
	dir = 8
	},
/turf/open/floor/plasteel/white/side{
	dir = 8
	},
/area/shuttle/exploration/ruin/pirate/cutter)
"gX" = (
/obj/structure/closet/crate/secure/loot,
/obj/machinery/airalarm/all_access{
	pixel_y = 24
	},
/turf/open/floor/plasteel/dark,
/area/shuttle/exploration/ruin/pirate/cutter)
"hA" = (
/obj/machinery/suit_storage_unit/open,
/obj/effect/turf_decal/tile/neutral{
	dir = 1
	},
/obj/effect/turf_decal/tile/neutral,
/obj/effect/turf_decal/tile/neutral{
	dir = 4
	},
/obj/effect/turf_decal/tile/neutral{
	dir = 8
	},
/turf/open/floor/plasteel/dark,
/area/shuttle/exploration/ruin/pirate/cutter)
"hT" = (
/obj/effect/landmark/exploration_weapon_spawner{
	dir = 4
	},
/turf/closed/wall/mineral/plastitanium/nodiagonal,
/area/shuttle/exploration/ruin/pirate/cutter)
"iS" = (
/obj/machinery/atmospherics/pipe/manifold/supply/hidden{
	dir = 4
	},
/obj/effect/turf_decal/tile/neutral{
	dir = 1
	},
/obj/effect/turf_decal/tile/neutral,
/obj/effect/turf_decal/tile/neutral{
	dir = 4
	},
/obj/effect/turf_decal/tile/neutral{
	dir = 8
	},
/turf/open/floor/plasteel/dark,
/area/shuttle/exploration/ruin/pirate/cutter)
"jA" = (
/obj/structure/bed,
/obj/item/bedsheet/brown,
/obj/machinery/airalarm/all_access{
	dir = 4;
	pixel_x = -24
	},
/obj/effect/turf_decal/tile/red{
	dir = 8
	},
/turf/open/floor/plasteel/dark,
/area/shuttle/exploration/ruin/pirate/cutter)
"jB" = (
/obj/machinery/porta_turret/syndicate/pod{
	dir = 10;
	faction = list("pirate")
	},
/turf/closed/wall/mineral/plastitanium,
/area/shuttle/exploration/ruin/pirate/cutter)
"jH" = (
/obj/structure/table,
/obj/item/coin/gold,
/obj/item/coin/silver,
/obj/item/coin/silver,
/turf/open/floor/plasteel/dark,
/area/shuttle/exploration/ruin/pirate/cutter)
"jL" = (
/obj/machinery/atmospherics/components/unary/vent_pump/on{
	dir = 1
	},
/turf/open/floor/plasteel,
/area/shuttle/exploration/ruin/pirate/cutter)
"kh" = (
/obj/machinery/atmospherics/pipe/simple/supply/hidden{
	dir = 5
	},
/turf/open/floor/plating,
/area/shuttle/exploration/ruin/pirate/cutter)
"kN" = (
/obj/structure/table/optable,
/obj/effect/turf_decal/bot,
/turf/open/floor/plasteel/white,
/area/shuttle/exploration/ruin/pirate/cutter)
"kX" = (
/obj/machinery/light/small{
	dir = 8
	},
/obj/structure/closet/crate/secure/loot,
/obj/machinery/atmospherics/components/unary/vent_pump/on{
	dir = 4
	},
/obj/structure/extinguisher_cabinet{
	pixel_x = -27
	},
/turf/open/floor/plasteel/dark,
/area/shuttle/exploration/ruin/pirate/cutter)
"lk" = (
/obj/structure/shuttle/engine/propulsion/burst/left{
	dir = 8
	},
/turf/open/floor/plating/airless,
/area/shuttle/exploration/ruin/pirate/cutter)
"lC" = (
/obj/machinery/porta_turret/syndicate/pod{
	dir = 9;
	faction = list("pirate")
	},
/turf/closed/wall/mineral/plastitanium,
/area/shuttle/exploration/ruin/pirate/cutter)
"lT" = (
/obj/machinery/light/small{
	dir = 4
	},
/obj/machinery/atmospherics/pipe/simple/supply/hidden,
/turf/open/floor/plating,
/area/shuttle/exploration/ruin/pirate/cutter)
"mu" = (
/obj/machinery/atmospherics/pipe/simple/supply/hidden,
/obj/effect/turf_decal/tile/neutral{
	dir = 1
	},
/obj/effect/turf_decal/tile/neutral,
/obj/effect/turf_decal/tile/neutral{
	dir = 4
	},
/obj/effect/turf_decal/tile/neutral{
	dir = 8
	},
/turf/open/floor/plasteel/dark,
/area/shuttle/exploration/ruin/pirate/cutter)
"mQ" = (
/obj/machinery/atmospherics/pipe/simple/supply/hidden{
	dir = 10
	},
/obj/effect/turf_decal/tile/neutral{
	dir = 1
	},
/obj/effect/turf_decal/tile/neutral,
/obj/effect/turf_decal/tile/neutral{
	dir = 4
	},
/obj/effect/turf_decal/tile/neutral{
	dir = 8
	},
/turf/open/floor/plasteel/dark,
/area/shuttle/exploration/ruin/pirate/cutter)
"mS" = (
/obj/machinery/atmospherics/components/unary/vent_pump/on,
/obj/effect/turf_decal/tile/neutral{
	dir = 1
	},
/obj/effect/turf_decal/tile/neutral,
/obj/effect/turf_decal/tile/neutral{
	dir = 4
	},
/obj/effect/turf_decal/tile/neutral{
	dir = 8
	},
/turf/open/floor/plasteel/dark,
/area/shuttle/exploration/ruin/pirate/cutter)
"np" = (
/obj/structure/cable/yellow{
	icon_state = "0-2"
	},
/obj/machinery/power/apc{
	dir = 8;
	name = "Pirate Cutter APC";
	pixel_x = -24;
	req_access = null
	},
/obj/machinery/atmospherics/pipe/simple/supply/hidden,
/obj/machinery/airalarm/all_access{
	dir = 8;
	pixel_x = 24
	},
/turf/open/floor/plating,
/area/shuttle/exploration/ruin/pirate/cutter)
"ny" = (
/obj/machinery/atmospherics/components/unary/vent_pump/on{
	dir = 4
	},
/obj/machinery/space_heater,
/obj/effect/turf_decal/stripes/line{
	dir = 6
	},
/turf/open/floor/plating,
/area/shuttle/exploration/ruin/pirate/cutter)
"nR" = (
/obj/structure/chair/office{
	dir = 4
	},
/obj/machinery/turretid{
	icon_state = "control_kill";
	lethal = 1;
	locked = 0;
	pixel_y = -30;
	req_access = null
	},
/mob/living/simple_animal/hostile/pirate/ranged{
	environment_smash = 0
	},
/obj/effect/turf_decal/tile/neutral{
	dir = 1
	},
/obj/effect/turf_decal/tile/neutral,
/obj/effect/turf_decal/tile/neutral{
	dir = 4
	},
/obj/effect/turf_decal/tile/neutral{
	dir = 8
	},
/turf/open/floor/plasteel/dark,
/area/shuttle/exploration/ruin/pirate/cutter)
"oT" = (
/obj/machinery/porta_turret/syndicate/pod{
	dir = 5;
	faction = list("pirate")
	},
/turf/closed/wall/mineral/plastitanium,
/area/shuttle/exploration/ruin/pirate/cutter)
"qA" = (
/obj/structure/table,
/obj/item/retractor,
/obj/item/hemostat,
/turf/open/floor/plasteel/white,
/area/shuttle/exploration/ruin/pirate/cutter)
"qU" = (
/obj/machinery/light/small{
	dir = 4
	},
/obj/machinery/atmospherics/pipe/simple/supply/hidden{
	dir = 9
	},
/obj/effect/turf_decal/tile/red,
/obj/effect/turf_decal/tile/red{
	dir = 8
	},
/turf/open/floor/plasteel,
/area/shuttle/exploration/ruin/pirate/cutter)
"rD" = (
/obj/structure/table/reinforced,
/obj/machinery/recharger,
/obj/item/melee/classic_baton/police,
/obj/effect/turf_decal/tile/red,
/turf/open/floor/plasteel/dark,
/area/shuttle/exploration/ruin/pirate/cutter)
"rF" = (
/obj/machinery/light/small{
	dir = 1
	},
/obj/structure/bed,
/obj/item/bedsheet/brown,
/turf/open/floor/plasteel/dark,
/area/shuttle/exploration/ruin/pirate/cutter)
"rI" = (
/obj/structure/sign/departments/engineering,
/turf/closed/wall/mineral/plastitanium/nodiagonal,
/area/shuttle/exploration/ruin/pirate/cutter)
"te" = (
/obj/structure/tank_dispenser/oxygen,
/obj/machinery/firealarm{
	dir = 2;
	pixel_y = 24
	},
/obj/effect/turf_decal/tile/neutral{
	dir = 1
	},
/obj/effect/turf_decal/tile/neutral,
/obj/effect/turf_decal/tile/neutral{
	dir = 4
	},
/obj/effect/turf_decal/tile/neutral{
	dir = 8
	},
/turf/open/floor/plasteel/dark,
/area/shuttle/exploration/ruin/pirate/cutter)
"ux" = (
/obj/machinery/atmospherics/pipe/simple/supply/hidden{
	dir = 4
	},
/obj/effect/turf_decal/tile/red{
	dir = 1
	},
/obj/effect/turf_decal/tile/red{
	dir = 8
	},
/turf/open/floor/plasteel/dark,
/area/shuttle/exploration/ruin/pirate/cutter)
"uV" = (
/obj/structure/bed,
/obj/item/bedsheet/brown,
/obj/machinery/firealarm{
	dir = 8;
	pixel_x = -26
	},
/turf/open/floor/plasteel/dark/side{
	dir = 6
	},
/area/shuttle/exploration/ruin/pirate/cutter)
"vd" = (
/obj/effect/mapping_helpers/airlock/cyclelink_helper{
	dir = 2
	},
/obj/effect/mapping_helpers/airlock/locked,
/obj/machinery/door/airlock/external{
	id_tag = "explorationpirate_bolt_starboard"
	},
/turf/open/floor/plating,
/area/shuttle/exploration/ruin/pirate/cutter)
"vv" = (
/obj/structure/chair/office{
	dir = 8
	},
/obj/effect/turf_decal/tile/neutral{
	dir = 1
	},
/obj/effect/turf_decal/tile/neutral,
/obj/effect/turf_decal/tile/neutral{
	dir = 4
	},
/obj/effect/turf_decal/tile/neutral{
	dir = 8
	},
/turf/open/floor/plasteel/dark,
/area/shuttle/exploration/ruin/pirate/cutter)
"wf" = (
/obj/structure/table,
/obj/item/storage/box/lethalshot,
/obj/effect/turf_decal/tile/neutral{
	dir = 1
	},
/obj/effect/turf_decal/tile/neutral,
/obj/effect/turf_decal/tile/neutral{
	dir = 4
	},
/obj/effect/turf_decal/tile/neutral{
	dir = 8
	},
/turf/open/floor/plasteel/dark,
/area/shuttle/exploration/ruin/pirate/cutter)
"wm" = (
/obj/machinery/power/smes{
	charge = 5e+006
	},
/obj/structure/cable/yellow{
	icon_state = "0-4"
	},
/obj/effect/turf_decal/stripes/line{
	dir = 5
	},
/turf/open/floor/plating,
/area/shuttle/exploration/ruin/pirate/cutter)
"wW" = (
/obj/effect/mapping_helpers/airlock/cyclelink_helper{
	dir = 1
	},
/obj/effect/mapping_helpers/airlock/locked,
/obj/machinery/door/airlock/external{
	id_tag = "explorationpirate_bolt_starboard"
	},
/turf/open/floor/plating,
/area/shuttle/exploration/ruin/pirate/cutter)
"xe" = (
/obj/effect/decal/cleanable/dirt,
/turf/open/floor/plasteel,
/area/shuttle/exploration/ruin/pirate/cutter)
"yW" = (
/obj/structure/table,
/obj/item/storage/firstaid/brute{
	pixel_x = 3;
	pixel_y = 3
	},
/obj/item/storage/firstaid/fire,
/obj/machinery/firealarm{
	dir = 1;
	pixel_y = -24
	},
/turf/open/floor/plasteel/white,
/area/shuttle/exploration/ruin/pirate/cutter)
"yX" = (
/obj/structure/closet/crate/freezer/surplus_limbs,
/obj/effect/turf_decal/bot,
/turf/open/floor/plasteel/white,
/area/shuttle/exploration/ruin/pirate/cutter)
"zd" = (
/obj/structure/sign/departments/medbay/alt,
/turf/closed/wall/mineral/plastitanium/nodiagonal,
/area/shuttle/exploration/ruin/pirate/cutter)
"zs" = (
/obj/machinery/sleeper{
	dir = 1
	},
/obj/effect/turf_decal/delivery,
/obj/machinery/airalarm/all_access{
	dir = 1;
	pixel_y = -24
	},
/turf/open/floor/plasteel/white,
/area/shuttle/exploration/ruin/pirate/cutter)
"zY" = (
/mob/living/simple_animal/hostile/pirate/ranged{
	environment_smash = 0
	},
/obj/effect/decal/cleanable/dirt,
/turf/open/floor/plasteel,
/area/shuttle/exploration/ruin/pirate/cutter)
"Ax" = (
/obj/structure/table,
/obj/machinery/door/window/southleft{
	base_state = "right";
	icon_state = "right";
	name = "Weapon Storage"
	},
/obj/item/gun/energy/laser,
/obj/effect/turf_decal/tile/neutral{
	dir = 1
	},
/obj/effect/turf_decal/tile/neutral,
/obj/effect/turf_decal/tile/neutral{
	dir = 4
	},
/obj/effect/turf_decal/tile/neutral{
	dir = 8
	},
/turf/open/floor/plasteel/dark,
/area/shuttle/exploration/ruin/pirate/cutter)
"AW" = (
/obj/structure/table,
/obj/machinery/cell_charger,
/obj/item/stack/cable_coil/yellow,
/obj/item/stock_parts/cell/high,
/obj/effect/turf_decal/bot,
/turf/open/floor/plating,
/area/shuttle/exploration/ruin/pirate/cutter)
"BI" = (
/obj/machinery/atmospherics/pipe/simple/supply/hidden{
	dir = 4
	},
/obj/machinery/door/firedoor,
/obj/machinery/door/airlock/medical/glass{
	name = "Medbay"
	},
/obj/effect/decal/cleanable/dirt,
/turf/open/floor/plasteel,
/area/shuttle/exploration/ruin/pirate/cutter)
"BQ" = (
/obj/machinery/atmospherics/pipe/simple/supply/hidden{
	dir = 4
	},
/turf/open/floor/plasteel/white/side{
	dir = 9
	},
/area/shuttle/exploration/ruin/pirate/cutter)
"Cc" = (
/obj/machinery/light/small{
	dir = 4
	},
/obj/machinery/atmospherics/pipe/simple/supply/hidden{
	dir = 10
	},
/turf/open/floor/plasteel/white/side{
	dir = 1
	},
/area/shuttle/exploration/ruin/pirate/cutter)
"Ce" = (
/obj/machinery/light/small{
	dir = 8
	},
/obj/structure/sign/warning/vacuum{
	pixel_x = -32
	},
/turf/open/floor/plating,
/area/shuttle/exploration/ruin/pirate/cutter)
"Cm" = (
/obj/machinery/atmospherics/pipe/simple/supply/hidden{
	dir = 4
	},
/turf/open/floor/plasteel/dark,
/area/shuttle/exploration/ruin/pirate/cutter)
"De" = (
/obj/machinery/atmospherics/pipe/simple/supply/hidden{
	dir = 4
	},
/turf/open/floor/plasteel/dark/side{
	dir = 4
	},
/area/shuttle/exploration/ruin/pirate/cutter)
"Ei" = (
/obj/machinery/atmospherics/pipe/manifold/supply/hidden{
	dir = 4
	},
/turf/open/floor/plating,
/area/shuttle/exploration/ruin/pirate/cutter)
"Ep" = (
/obj/effect/turf_decal/tile/red{
	dir = 1
	},
/obj/effect/turf_decal/tile/red{
	dir = 4
	},
/turf/open/floor/plasteel/dark,
/area/shuttle/exploration/ruin/pirate/cutter)
"EB" = (
/obj/structure/rack,
/obj/item/storage/bag/money/vault,
/mob/living/simple_animal/parrot{
	faction = list("pirate");
	name = "Pegwing"
	},
/obj/effect/turf_decal/tile/blue{
	dir = 4
	},
/turf/open/floor/plasteel/dark,
/area/shuttle/exploration/ruin/pirate/cutter)
"EI" = (
/obj/structure/table,
/obj/machinery/light/small{
	brightness = 3;
	dir = 8
	},
/obj/item/stack/spacecash/c200,
/turf/open/floor/plasteel/dark,
/area/shuttle/exploration/ruin/pirate/cutter)
"Fi" = (
/obj/structure/grille,
/obj/structure/window/plastitanium,
/obj/machinery/door/poddoor{
	id = "caravanpirate_bridge"
	},
/turf/open/floor/plating,
/area/shuttle/exploration/ruin/pirate/cutter)
"FC" = (
/obj/machinery/atmospherics/pipe/simple/supply/hidden{
	dir = 4
	},
/obj/machinery/door/firedoor,
/obj/machinery/door/airlock/engineering{
	name = "Engineering"
	},
/turf/open/floor/plating,
/area/shuttle/exploration/ruin/pirate/cutter)
"HI" = (
/obj/machinery/light/small,
/obj/structure/bed,
/obj/item/bedsheet/brown,
/turf/open/floor/plasteel/dark,
/area/shuttle/exploration/ruin/pirate/cutter)
"HZ" = (
/obj/structure/shuttle/engine/heater{
	dir = 8
	},
/obj/structure/window/reinforced{
	dir = 4
	},
/turf/open/floor/plating/airless,
/area/shuttle/exploration/ruin/pirate/cutter)
"Iu" = (
/obj/machinery/atmospherics/pipe/manifold/supply/hidden{
	dir = 1
	},
/turf/open/floor/plasteel/white/side{
	dir = 1
	},
/area/shuttle/exploration/ruin/pirate/cutter)
"Jc" = (
/obj/machinery/light/small{
	dir = 8
	},
/obj/effect/turf_decal/tile/red{
	dir = 1
	},
/obj/effect/turf_decal/tile/red{
	dir = 8
	},
/turf/open/floor/plasteel,
/area/shuttle/exploration/ruin/pirate/cutter)
"Jd" = (
/obj/item/stack/sheet/mineral/gold{
	amount = 25
	},
/obj/item/stack/sheet/mineral/bananium{
	amount = 5
	},
/obj/item/stack/sheet/mineral/silver{
	amount = 25
	},
/obj/item/stack/sheet/mineral/uranium{
	amount = 10
	},
/obj/item/stack/sheet/mineral/diamond{
	amount = 5
	},
/obj/structure/closet/crate,
/obj/item/coin/silver,
/obj/item/coin/silver,
/obj/item/coin/silver,
/obj/item/coin/gold,
/obj/item/coin/gold,
/obj/effect/turf_decal/tile/blue,
/turf/open/floor/plasteel/dark,
/area/shuttle/exploration/ruin/pirate/cutter)
"Jv" = (
/turf/template_noop,
/area/template_noop)
"Kv" = (
/obj/structure/cable/yellow{
	icon_state = "1-8"
	},
/obj/machinery/atmospherics/pipe/simple/supply/hidden,
/turf/open/floor/plating,
/area/shuttle/exploration/ruin/pirate/cutter)
"KB" = (
/obj/machinery/atmospherics/pipe/simple/supply/hidden{
	dir = 4
	},
/obj/machinery/door/firedoor,
/obj/machinery/door/airlock/security{
	name = "Armory"
	},
/obj/effect/decal/cleanable/dirt,
/turf/open/floor/plasteel,
/area/shuttle/exploration/ruin/pirate/cutter)
"KH" = (
/obj/machinery/atmospherics/pipe/simple/supply/hidden{
	dir = 4
	},
/obj/effect/turf_decal/tile/red,
/obj/effect/turf_decal/tile/red{
	dir = 8
	},
/turf/open/floor/plasteel,
/area/shuttle/exploration/ruin/pirate/cutter)
"KO" = (
/obj/machinery/atmospherics/pipe/simple/supply/hidden{
	dir = 5
	},
/obj/effect/decal/cleanable/dirt,
/turf/open/floor/plasteel,
/area/shuttle/exploration/ruin/pirate/cutter)
"Lz" = (
/obj/machinery/atmospherics/pipe/simple/supply/hidden{
	dir = 4
	},
/turf/open/floor/plasteel/white/side{
	dir = 1
	},
/area/shuttle/exploration/ruin/pirate/cutter)
"LV" = (
/obj/structure/table,
/obj/item/storage/fancy/donut_box{
	pixel_y = 18
	},
/obj/item/storage/box/donkpockets{
	pixel_x = -3;
	pixel_y = 7
	},
/obj/item/storage/box/donkpockets{
	pixel_x = -6
	},
/obj/item/reagent_containers/food/drinks/bottle/rum{
	pixel_x = 8;
	pixel_y = 3
	},
/obj/structure/sign/poster/contraband/red_rum{
	pixel_x = 32
	},
/turf/open/floor/plasteel/dark,
/area/shuttle/exploration/ruin/pirate/cutter)
"Of" = (
/obj/structure/table,
/obj/item/reagent_containers/food/drinks/bottle/rum{
	pixel_x = 3;
	pixel_y = 6
	},
/obj/item/reagent_containers/food/drinks/bottle/rum,
/turf/open/floor/plasteel/dark,
/area/shuttle/exploration/ruin/pirate/cutter)
"OH" = (
/obj/machinery/button/door{
	id = "caravanpirate_bolt_starboard";
	name = "External Bolt Control";
	normaldoorcontrol = 1;
	pixel_x = -4;
	pixel_y = -25;
	specialfunctions = 4
	},
/obj/machinery/atmospherics/pipe/simple/supply/hidden{
	dir = 4
	},
/obj/effect/turf_decal/tile/red,
/obj/effect/turf_decal/tile/red{
	dir = 8
	},
/turf/open/floor/plasteel,
/area/shuttle/exploration/ruin/pirate/cutter)
"PC" = (
/obj/structure/cable,
/obj/machinery/power/port_gen/pacman{
	anchored = 1
	},
/obj/item/wrench,
/obj/effect/turf_decal/stripes/line{
	dir = 6
	},
/turf/open/floor/plating,
/area/shuttle/exploration/ruin/pirate/cutter)
"PK" = (
/obj/structure/closet{
	name = "pirate outfits"
	},
/obj/item/clothing/head/collectable/pirate,
/obj/item/clothing/suit/pirate,
/obj/item/clothing/under/costume/pirate,
/obj/item/clothing/shoes/jackboots,
/obj/item/clothing/head/bandana,
/obj/effect/turf_decal/tile/red{
	dir = 1
	},
/turf/open/floor/plasteel/dark,
/area/shuttle/exploration/ruin/pirate/cutter)
"Qh" = (
/obj/structure/table,
/obj/structure/window/reinforced{
	dir = 8
	},
/obj/machinery/door/window/southleft{
	name = "Weapon Storage"
	},
/obj/item/grenade/smokebomb{
	pixel_x = -4
	},
/obj/item/grenade/smokebomb{
	pixel_x = 2
	},
/obj/effect/turf_decal/tile/neutral{
	dir = 1
	},
/obj/effect/turf_decal/tile/neutral,
/obj/effect/turf_decal/tile/neutral{
	dir = 4
	},
/obj/effect/turf_decal/tile/neutral{
	dir = 8
	},
/turf/open/floor/plasteel/dark,
/area/shuttle/exploration/ruin/pirate/cutter)
"Ri" = (
/obj/structure/reagent_dispensers/fueltank,
/obj/effect/turf_decal/stripes/line{
	dir = 4
	},
/turf/open/floor/plating,
/area/shuttle/exploration/ruin/pirate/cutter)
"Rw" = (
/obj/effect/mapping_helpers/airlock/cyclelink_helper{
	dir = 2
	},
/obj/effect/mapping_helpers/airlock/locked,
/obj/machinery/door/airlock/external{
	id_tag = "explorationpirate_bolt_port"
	},
/obj/docking_port/mobile{
	callTime = 150;
	dir = 2;
	dwidth = 14;
	height = 13;
	id = "set_by_code";
	movement_force = list("KNOCKDOWN" = 0, "THROW" = 0);
	name = "Pirate Cutter";
	port_direction = 8;
	preferred_direction = 4;
	width = 22
	},
/turf/open/floor/plating,
/area/shuttle/exploration/ruin/pirate/cutter)
"RY" = (
/obj/structure/shuttle/engine/propulsion/burst{
	dir = 8
	},
/turf/open/floor/plating/airless,
/area/shuttle/exploration/ruin/pirate/cutter)
"Sp" = (
/obj/machinery/atmospherics/pipe/simple/supply/hidden{
	dir = 4
	},
/obj/machinery/door/firedoor,
/obj/machinery/door/airlock/command{
	name = "Bridge"
	},
/obj/effect/turf_decal/tile/neutral{
	dir = 1
	},
/obj/effect/turf_decal/tile/neutral,
/obj/effect/turf_decal/tile/neutral{
	dir = 4
	},
/obj/effect/turf_decal/tile/neutral{
	dir = 8
	},
/turf/open/floor/plasteel/dark,
/area/shuttle/exploration/ruin/pirate/cutter)
"Tj" = (
/obj/machinery/porta_turret/syndicate/pod{
	dir = 6;
	faction = list("pirate")
	},
/turf/closed/wall/mineral/plastitanium,
/area/shuttle/exploration/ruin/pirate/cutter)
"Tq" = (
/obj/effect/turf_decal/tile/neutral{
	dir = 1
	},
/obj/effect/turf_decal/tile/neutral,
/obj/effect/turf_decal/tile/neutral{
	dir = 4
	},
/obj/effect/turf_decal/tile/neutral{
	dir = 8
	},
/turf/open/floor/plasteel/dark,
/area/shuttle/exploration/ruin/pirate/cutter)
"UA" = (
/obj/machinery/atmospherics/pipe/simple/supply/hidden{
	dir = 9
	},
/obj/machinery/firealarm{
	dir = 1;
	pixel_y = -24
	},
/turf/open/floor/plasteel/dark,
/area/shuttle/exploration/ruin/pirate/cutter)
"UF" = (
/obj/structure/rack,
/obj/item/storage/toolbox/emergency,
/obj/item/weldingtool,
/obj/effect/turf_decal/tile/red{
	dir = 4
	},
/turf/open/floor/plasteel/dark,
/area/shuttle/exploration/ruin/pirate/cutter)
"UO" = (
/obj/machinery/atmospherics/pipe/simple/supply/hidden{
	dir = 9
	},
/obj/effect/turf_decal/tile/neutral{
	dir = 1
	},
/obj/effect/turf_decal/tile/neutral,
/obj/effect/turf_decal/tile/neutral{
	dir = 4
	},
/obj/effect/turf_decal/tile/neutral{
	dir = 8
	},
/turf/open/floor/plasteel/dark,
/area/shuttle/exploration/ruin/pirate/cutter)
"VM" = (
/obj/structure/shuttle/engine/propulsion/burst/right{
	dir = 8
	},
/turf/open/floor/plating/airless,
/area/shuttle/exploration/ruin/pirate/cutter)
"WB" = (
/obj/structure/table/reinforced,
/obj/machinery/button/door{
	id = "caravanpirate_bridge";
	name = "Bridge Blast Door Control";
	pixel_x = -16
	},
/obj/effect/turf_decal/tile/red,
/obj/effect/turf_decal/tile/red{
	dir = 8
	},
/turf/open/floor/plasteel/dark,
/area/shuttle/exploration/ruin/pirate/cutter)
"Xz" = (
/turf/closed/wall/mineral/plastitanium,
/area/shuttle/exploration/ruin/pirate/cutter)
"XJ" = (
/obj/machinery/atmospherics/components/unary/tank/air,
/obj/effect/turf_decal/bot,
/turf/open/floor/plating,
/area/shuttle/exploration/ruin/pirate/cutter)
"YP" = (
/obj/machinery/atmospherics/pipe/manifold/supply/hidden,
/obj/effect/turf_decal/tile/red,
/obj/effect/turf_decal/tile/red{
	dir = 8
	},
/turf/open/floor/plasteel,
/area/shuttle/exploration/ruin/pirate/cutter)
"Zy" = (
/obj/structure/table,
/obj/machinery/microwave{
	pixel_y = 5
	},
/turf/open/floor/plasteel/dark,
/area/shuttle/exploration/ruin/pirate/cutter)
"ZF" = (
/obj/machinery/atmospherics/pipe/manifold/supply/hidden{
	dir = 8
	},
/obj/effect/turf_decal/tile/neutral{
	dir = 1
	},
/obj/effect/turf_decal/tile/neutral,
/obj/effect/turf_decal/tile/neutral{
	dir = 4
	},
/obj/effect/turf_decal/tile/neutral{
	dir = 8
	},
/turf/open/floor/plasteel/dark,
/area/shuttle/exploration/ruin/pirate/cutter)
"ZG" = (
/obj/machinery/atmospherics/components/unary/vent_pump/on,
/obj/effect/decal/cleanable/dirt,
/turf/open/floor/plasteel,
/area/shuttle/exploration/ruin/pirate/cutter)

(1,1,1) = {"
Jv
Jv
Jv
lk
RY
VM
Jv
lk
RY
VM
Jv
Jv
Jv
"}
(2,1,1) = {"
Jv
Jv
Xz
HZ
HZ
HZ
cL
HZ
HZ
HZ
Xz
Jv
Jv
"}
(3,1,1) = {"
Jv
lC
cL
em
Ri
ny
cL
wm
fb
PC
cL
jB
Jv
"}
(4,1,1) = {"
Jv
cL
XJ
bt
lT
Ei
np
Kv
lT
kh
AW
cL
Jv
"}
(5,1,1) = {"
Jv
cL
cL
FC
rI
cL
cL
cL
rI
FC
cL
cL
Jv
"}
(6,1,1) = {"
Jv
cL
hA
BQ
gu
qA
cL
wf
Jc
et
hA
cL
Jv
"}
(7,1,1) = {"
Xz
cL
cL
Lz
xe
kN
cL
aA
zY
KH
cL
cL
Xz
"}
(8,1,1) = {"
Rw
Ce
dO
Iu
jL
yW
cL
te
ZG
YP
vd
Ce
wW
"}
(9,1,1) = {"
Xz
cL
cL
dW
xe
zs
cL
Qh
at
OH
cL
cL
Xz
"}
(10,1,1) = {"
Jv
Fi
hA
Cc
KO
yX
cL
Ax
fP
qU
hA
Fi
Jv
"}
(11,1,1) = {"
Jv
Xz
cL
zd
BI
cL
cL
cL
KB
cL
cL
Xz
Jv
"}
(12,1,1) = {"
Jv
Jv
cL
fH
De
uV
kX
jA
ux
PK
cL
Jv
Jv
"}
(13,1,1) = {"
Jv
Jv
hT
rF
mQ
mu
iS
ZF
UO
HI
fq
Jv
Jv
"}
(14,1,1) = {"
Jv
Jv
oT
cL
Zy
LV
Jd
fR
EB
cL
Tj
Jv
Jv
"}
(15,1,1) = {"
Jv
Jv
Jv
Xz
cL
cL
cL
Sp
cL
Xz
Jv
Jv
Jv
"}
(16,1,1) = {"
Jv
Jv
Jv
Jv
cL
Of
EI
Cm
cL
Jv
Jv
Jv
Jv
"}
(17,1,1) = {"
Jv
Jv
Jv
Jv
cL
jH
vv
Cm
cL
Jv
Jv
Jv
Jv
"}
(18,1,1) = {"
Jv
Jv
Jv
Jv
cL
gX
mS
UA
cL
Jv
Jv
Jv
Jv
"}
(19,1,1) = {"
Jv
Jv
Jv
Jv
cL
UF
Tq
rD
cL
Jv
Jv
Jv
Jv
"}
(20,1,1) = {"
Jv
Jv
Jv
Jv
Fi
Ep
nR
WB
Fi
Jv
Jv
Jv
Jv
"}
(21,1,1) = {"
Jv
Jv
Jv
Jv
Fi
Fi
bJ
Fi
Fi
Jv
Jv
Jv
Jv
"}
(22,1,1) = {"
Jv
Jv
Jv
Jv
Jv
Fi
Fi
Fi
Jv
Jv
Jv
Jv
Jv
"}
