//MAP CONVERTED BY dmm2tgm.py THIS HEADER COMMENT PREVENTS RECONVERSION, DO NOT REMOVE
"aR" = (
/obj/structure/lattice,
/obj/machinery/atmospherics/pipe/simple/scrubbers/hidden,
/turf/template_noop,
/area/shuttle/exploration)
"cg" = (
/obj/machinery/airalarm{
	pixel_y = 23
	},
/obj/machinery/atmospherics/pipe/simple/scrubbers/hidden{
	dir = 4
	},
/obj/structure/chair/fancy/shuttle,
/turf/open/floor/mineral/titanium,
/area/shuttle/exploration)
"cu" = (
/obj/structure/lattice/catwalk,
/obj/machinery/atmospherics/components/unary/outlet_injector/on,
/turf/template_noop,
/area/shuttle/exploration)
"cH" = (
/obj/item/radio/intercom{
	frequency = 1453;
	pixel_y = 24
	},
/obj/machinery/atmospherics/pipe/simple/scrubbers/hidden{
	dir = 6
	},
/turf/open/floor/mineral/titanium,
/area/shuttle/exploration)
"da" = (
/turf/closed/wall/mineral/titanium,
/area/shuttle/exploration)
"fr" = (
/obj/machinery/atmospherics/pipe/manifold/supply/hidden{
	dir = 4
	},
/turf/closed/wall/mineral/titanium/nodiagonal,
/area/shuttle/exploration)
"fF" = (
/obj/machinery/door/airlock/external/glass,
/obj/machinery/atmospherics/pipe/simple/scrubbers/hidden{
	dir = 4
	},
/obj/effect/mapping_helpers/airlock/cyclelink_helper{
	dir = 4
	},
/turf/open/floor/mineral/plastitanium,
/area/shuttle/exploration)
"hl" = (
/obj/machinery/shuttle/engine/plasma{
	dir = 1
	},
/turf/open/floor/plating,
/area/shuttle/exploration)
"hY" = (
/obj/effect/turf_decal/stripes/line{
	dir = 1
	},
/obj/structure/cable/yellow{
	icon_state = "0-8"
	},
/obj/machinery/power/apc/auto_name/east,
/obj/machinery/atmospherics/pipe/manifold/supply/hidden{
	dir = 8
	},
/turf/open/floor/mineral/titanium,
/area/shuttle/exploration)
"ir" = (
/turf/open/floor/mineral/plastitanium,
/area/shuttle/exploration)
"jR" = (
/obj/effect/turf_decal/stripes/line{
	dir = 1
	},
/obj/structure/cable/yellow{
	icon_state = "4-8"
	},
/turf/open/floor/mineral/titanium,
/area/shuttle/exploration)
"kp" = (
/mob/living/simple_animal/chicken/turkey{
	atmos_requirements = list("min_oxy" = 0, "max_oxy" = 0, "min_tox" = 0, "max_tox" = 0, "min_co2" = 0, "max_co2" = 0, "min_n2" = 0, "max_n2" = 0);
	desc = "A veteran of Nanotrasen's Animal Experimentation Program that attempted to replicate the organic space suit that some hostile entities are known to have exhibited, Tom now serves Nanotrasen as the mascot of the Exploration Crew.";
	health = 200;
	maxHealth = 200;
	melee_damage = 5;
	minbodytemp = 2.7;
	name = "Tom"
	},
/obj/machinery/atmospherics/pipe/simple/scrubbers/hidden,
/turf/open/floor/mineral/titanium,
/area/shuttle/exploration)
"ll" = (
/obj/machinery/telecomms/relay/preset/exploration,
/obj/effect/turf_decal/delivery,
/obj/machinery/light/small{
	dir = 8
	},
/turf/open/floor/mineral/titanium,
/area/shuttle/exploration)
"oC" = (
/obj/effect/spawner/structure/window/shuttle,
/turf/open/floor/plating,
/area/shuttle/exploration)
"oH" = (
/obj/machinery/atmospherics/components/binary/dp_vent_pump{
	dir = 8
	},
/turf/open/floor/mineral/plastitanium,
/area/shuttle/exploration)
"po" = (
/obj/machinery/computer/crew,
/turf/open/floor/mineral/plastitanium,
/area/shuttle/exploration)
"pG" = (
/obj/machinery/atmospherics/components/unary/portables_connector/visible{
	dir = 8
	},
/obj/machinery/portable_atmospherics/canister/plasma,
/turf/open/floor/mineral/titanium,
/area/shuttle/exploration)
"qa" = (
/obj/machinery/atmospherics/components/unary/tank/air{
	dir = 4;
	initialize_directions = 4
	},
/obj/machinery/light/small,
/turf/open/floor/mineral/plastitanium,
/area/shuttle/exploration)
"qi" = (
/obj/machinery/atmospherics/pipe/simple/supply/hidden{
	dir = 9
	},
/turf/closed/wall/mineral/titanium/nodiagonal,
/area/shuttle/exploration)
"qX" = (
/obj/structure/table,
/obj/machinery/recharger,
/turf/open/floor/mineral/titanium,
/area/shuttle/exploration)
"rQ" = (
/obj/structure/table,
/obj/item/trash/syndi_cakes{
	pixel_x = -3;
	pixel_y = 5
	},
/obj/item/broken_bottle{
	pixel_x = 8;
	pixel_y = -2
	},
/obj/item/gps/mining/exploration,
/turf/open/floor/mineral/titanium,
/area/shuttle/exploration)
"sz" = (
/obj/machinery/computer/objective,
/obj/machinery/light{
	dir = 8
	},
/turf/open/floor/mineral/titanium,
/area/shuttle/exploration)
"sE" = (
/obj/machinery/computer/shuttle_flight/custom_shuttle/exploration,
/turf/open/floor/mineral/plastitanium,
/area/shuttle/exploration)
"sT" = (
/obj/structure/chair/fancy/shuttle{
	dir = 1
	},
/turf/open/floor/mineral/titanium,
/area/shuttle/exploration)
"sY" = (
/obj/structure/table,
/obj/item/trash/sosjerky,
/obj/item/trash/popcorn{
	pixel_y = 11
	},
/obj/item/paper/crumpled{
	default_raw_text = "<p>I bought you some food, but I ate it all before you came, sorry.</p><p>- RTH</p>";
	name = "scribbled note"
	},
/turf/open/floor/mineral/titanium,
/area/shuttle/exploration)
"tq" = (
/obj/machinery/atmospherics/pipe/simple/scrubbers/hidden{
	dir = 4
	},
/obj/machinery/atmospherics/pipe/simple/supply/hidden,
/turf/open/floor/mineral/titanium,
/area/shuttle/exploration)
"ts" = (
/obj/machinery/atmospherics/components/unary/vent_scrubber/on{
	dir = 4
	},
/turf/open/floor/mineral/titanium,
/area/shuttle/exploration)
"tz" = (
/turf/closed/wall/mineral/plastitanium/nodiagonal,
/area/shuttle/exploration)
"vc" = (
/obj/machinery/computer/arcade/orion_trail,
/obj/effect/turf_decal/bot,
/turf/open/floor/mineral/titanium,
/area/shuttle/exploration)
"vd" = (
/obj/machinery/light/small{
	dir = 4
	},
/obj/structure/chair/fancy/shuttle{
	dir = 1
	},
/turf/open/floor/mineral/titanium,
/area/shuttle/exploration)
"vi" = (
/obj/structure/tank_dispenser/oxygen,
/turf/open/floor/mineral/titanium,
/area/shuttle/exploration)
"zN" = (
/obj/effect/turf_decal/bot,
/obj/machinery/atmospherics/components/unary/vent_scrubber/on{
	dir = 4
	},
/turf/open/floor/mineral/titanium,
/area/shuttle/exploration)
"Ax" = (
/turf/closed/wall/mineral/titanium/nodiagonal,
/area/shuttle/exploration)
"BF" = (
/obj/machinery/light/small{
	dir = 4
	},
/obj/structure/chair/fancy/shuttle,
/turf/open/floor/mineral/titanium,
/area/shuttle/exploration)
"CU" = (
/obj/machinery/atmospherics/components/unary/plasma_refiner{
	dir = 4
	},
/turf/open/floor/plating,
/area/shuttle/exploration)
"Dl" = (
/obj/effect/spawner/structure/window/shuttle,
/obj/machinery/atmospherics/pipe/simple/scrubbers/hidden,
/turf/open/floor/plating,
/area/shuttle/exploration)
"DM" = (
/obj/machinery/door/airlock/shuttle,
/obj/machinery/atmospherics/pipe/simple/scrubbers/hidden,
/turf/open/floor/mineral/titanium,
/area/shuttle/exploration)
"GH" = (
/obj/machinery/atmospherics/pipe/manifold/purple/visible{
	dir = 1
	},
/obj/effect/turf_decal/delivery,
/turf/open/floor/mineral/titanium,
/area/shuttle/exploration)
"Hf" = (
/turf/open/floor/mineral/titanium,
/area/shuttle/exploration)
"HD" = (
/obj/docking_port/mobile{
	dir = 8;
	dwidth = 6;
	height = 8;
	id = "exploration";
	name = "Exploration Shuttle";
	port_direction = 4;
	shuttle_object_type = /datum/orbital_object/shuttle/custom_shuttle;
	width = 16
	},
/obj/machinery/door/airlock/external/glass,
/obj/machinery/atmospherics/pipe/simple/supply/hidden{
	dir = 10
	},
/obj/effect/mapping_helpers/airlock/cyclelink_helper{
	dir = 8
	},
/turf/open/floor/mineral/plastitanium,
/area/shuttle/exploration)
"In" = (
/obj/machinery/atmospherics/pipe/simple/scrubbers/hidden,
/turf/open/floor/mineral/titanium,
/area/shuttle/exploration)
"IP" = (
/obj/machinery/atmospherics/pipe/manifold4w/purple/visible,
/obj/effect/turf_decal/delivery,
/turf/open/floor/mineral/titanium,
/area/shuttle/exploration)
"IQ" = (
/obj/machinery/atmospherics/pipe/simple/scrubbers/hidden{
	dir = 9
	},
/obj/structure/chair/fancy/shuttle,
/turf/open/floor/mineral/titanium,
/area/shuttle/exploration)
"IS" = (
/obj/machinery/atmospherics/components/unary/vent_pump/on,
/turf/open/floor/mineral/titanium,
/area/shuttle/exploration)
"KU" = (
/obj/effect/turf_decal/stripes/line{
	dir = 1
	},
/obj/structure/cable/yellow{
	icon_state = "0-4"
	},
/obj/machinery/power/port_gen/pacman,
/obj/item/wrench,
/obj/item/stack/sheet/mineral/plasma/fifty,
/turf/open/floor/plating,
/area/shuttle/exploration)
"Nc" = (
/obj/machinery/holopad,
/obj/machinery/atmospherics/pipe/simple/scrubbers/hidden,
/turf/open/floor/mineral/titanium,
/area/shuttle/exploration)
"Nx" = (
/obj/structure/chair/fancy/shuttle{
	dir = 1
	},
/obj/item/radio/intercom{
	frequency = 1453;
	pixel_y = -30
	},
/obj/machinery/light/small{
	dir = 8
	},
/turf/open/floor/mineral/plastitanium,
/area/shuttle/exploration)
"NT" = (
/obj/structure/table,
/obj/item/trash/pistachios,
/obj/item/trash/can/food/beans{
	pixel_y = 10
	},
/turf/open/floor/mineral/titanium,
/area/shuttle/exploration)
"OE" = (
/obj/structure/closet/emcloset/anchored,
/obj/machinery/advanced_airlock_controller/directional/east,
/turf/open/floor/mineral/plastitanium,
/area/shuttle/exploration)
"OU" = (
/obj/effect/turf_decal/bot,
/obj/item/storage/toolbox/mechanical,
/obj/item/multitool,
/obj/machinery/atmospherics/components/unary/vent_pump/on{
	dir = 1
	},
/turf/open/floor/mineral/titanium,
/area/shuttle/exploration)
"PA" = (
/obj/machinery/atmospherics/pipe/manifold/scrubbers/hidden{
	dir = 4
	},
/turf/open/floor/mineral/titanium,
/area/shuttle/exploration)
"Qb" = (
/obj/machinery/atmospherics/pipe/simple/supply/hidden,
/turf/closed/wall/mineral/titanium/nodiagonal,
/area/shuttle/exploration)
"Qy" = (
/obj/machinery/atmospherics/pipe/simple/purple/visible{
	dir = 6
	},
/obj/effect/turf_decal/bot,
/obj/machinery/light/small{
	dir = 1
	},
/turf/open/floor/mineral/titanium,
/area/shuttle/exploration)
"Rk" = (
/obj/structure/window/reinforced/survival_pod{
	dir = 1
	},
/obj/machinery/atmospherics/components/unary/shuttle/heater{
	dir = 1
	},
/turf/open/floor/plating,
/area/shuttle/exploration)
"Rp" = (
/obj/machinery/door/airlock/shuttle,
/obj/effect/turf_decal/stripes/line,
/obj/effect/turf_decal/stripes/line{
	dir = 1
	},
/turf/open/floor/mineral/plastitanium,
/area/shuttle/exploration)
"RQ" = (
/turf/template_noop,
/area/template_noop)
"SA" = (
/obj/effect/turf_decal/bot,
/obj/machinery/atmospherics/pipe/simple/scrubbers/hidden{
	dir = 9
	},
/turf/open/floor/mineral/titanium,
/area/shuttle/exploration)
"Vj" = (
/obj/effect/turf_decal/stripes/line{
	dir = 1
	},
/obj/structure/cable/yellow{
	icon_state = "4-8"
	},
/obj/machinery/atmospherics/pipe/simple/scrubbers/hidden,
/turf/open/floor/mineral/titanium,
/area/shuttle/exploration)
"Vl" = (
/turf/closed/wall/mineral/plastitanium,
/area/shuttle/exploration)
"Xj" = (
/obj/machinery/atmospherics/pipe/simple/supply/hidden{
	dir = 4
	},
/turf/closed/wall/mineral/titanium/nodiagonal,
/area/shuttle/exploration)
"Yi" = (
/obj/structure/closet/crate,
/obj/item/circuitboard/computer/shuttle/exploration_shuttle,
/obj/item/stack/sheet/mineral/plasma/five,
/obj/item/pickaxe,
/obj/item/mining_scanner,
/obj/item/radio/headset/headset_exploration,
/obj/item/radio/headset/headset_exploration,
/obj/machinery/light/small{
	dir = 8
	},
/turf/open/floor/plating,
/area/shuttle/exploration)
"ZX" = (
/obj/machinery/atmospherics/pipe/manifold/scrubbers/hidden{
	dir = 8
	},
/turf/open/floor/mineral/titanium,
/area/shuttle/exploration)

(1,1,1) = {"
da
da
da
da
Ax
oC
Ax
oC
Ax
Ax
Ax
Ax
Ax
tz
Vl
RQ
"}
(2,1,1) = {"
oC
sE
Nx
da
sz
sT
qX
Hf
Hf
ll
Ax
KU
Yi
CU
tz
Vl
"}
(3,1,1) = {"
oC
po
ir
Rp
Hf
Hf
ts
Hf
Hf
vi
Ax
jR
zN
GH
Rk
hl
"}
(4,1,1) = {"
oC
oC
oC
da
cH
Nc
PA
In
kp
ZX
DM
Vj
SA
GH
Rk
hl
"}
(5,1,1) = {"
RQ
RQ
RQ
da
cg
rQ
sT
vc
IS
tq
Qb
hY
OU
GH
Rk
hl
"}
(6,1,1) = {"
cu
aR
aR
Dl
IQ
sY
sT
Ax
Ax
fF
Ax
Xj
Qy
IP
Rk
hl
"}
(7,1,1) = {"
RQ
RQ
RQ
oC
BF
NT
vd
Ax
OE
oH
qa
Xj
pG
pG
tz
Vl
"}
(8,1,1) = {"
RQ
RQ
RQ
da
da
oC
Ax
Ax
Ax
HD
fr
qi
Ax
tz
Vl
RQ
"}
