//MAP CONVERTED BY dmm2tgm.py THIS HEADER COMMENT PREVENTS RECONVERSION, DO NOT REMOVE
"aT" = (
/obj/effect/turf_decal/tile/blue/opposingcorners,
/obj/machinery/light,
/obj/machinery/airalarm/unlocked{
	dir = 8;
	pixel_x = 25
	},
/obj/effect/turf_decal/bot,
/obj/structure/closet/crate/large,
/obj/effect/spawner/lootdrop/maintenance/three,
/turf/open/floor/mineral/titanium/white,
/area/shuttle/exploration)
"dt" = (
/obj/machinery/atmospherics/pipe/manifold/purple/visible{
	dir = 1
	},
/obj/effect/turf_decal/tile/brown/opposingcorners,
/obj/effect/turf_decal/delivery,
/turf/open/floor/mineral/titanium/yellow,
/area/shuttle/exploration)
"dz" = (
/obj/machinery/power/port_gen/pacman,
/obj/structure/cable/yellow{
	icon_state = "0-2"
	},
/obj/effect/turf_decal/tile/brown/opposingcorners,
/obj/item/stack/sheet/mineral/plasma/ten,
/obj/machinery/firealarm/directional/east,
/obj/effect/turf_decal/stripes/line{
	dir = 1
	},
/turf/open/floor/mineral/titanium/yellow,
/area/shuttle/exploration)
"gl" = (
/obj/effect/turf_decal/delivery,
/obj/machinery/button/door{
	desc = "A remote control switch.";
	id = "exploration";
	name = "Exploration Shuttle Shutters";
	pixel_y = -25;
	req_access_txt = "49"
	},
/obj/effect/turf_decal/stripes/closeup{
	dir = 1
	},
/obj/machinery/door/poddoor/shutters{
	id = "exploration"
	},
/turf/open/floor/plating,
/area/shuttle/exploration)
"gZ" = (
/obj/effect/turf_decal/tile/brown/opposingcorners,
/obj/structure/cable/yellow{
	icon_state = "4-8"
	},
/obj/machinery/atmospherics/pipe/simple/supply/hidden/layer2{
	dir = 4
	},
/obj/machinery/atmospherics/pipe/simple/scrubbers/hidden/layer4{
	dir = 9
	},
/turf/open/floor/mineral/titanium/yellow,
/area/shuttle/exploration)
"hr" = (
/obj/effect/turf_decal/tile/blue/opposingcorners,
/obj/machinery/atmospherics/components/unary/vent_scrubber/on/layer4{
	dir = 4
	},
/turf/open/floor/mineral/titanium/white,
/area/shuttle/exploration)
"hz" = (
/obj/effect/turf_decal/tile/neutral/opposingcorners,
/obj/machinery/light,
/obj/machinery/vendor/exploration,
/obj/effect/turf_decal/stripes/corner,
/turf/open/floor/mineral/plastitanium,
/area/shuttle/exploration)
"hW" = (
/obj/effect/turf_decal/tile/neutral/opposingcorners,
/obj/structure/table,
/obj/item/flashlight/lamp/green{
	on = 0;
	pixel_x = -3;
	pixel_y = 8
	},
/obj/machinery/atmospherics/pipe/manifold/scrubbers/hidden/layer4{
	dir = 4
	},
/turf/open/floor/mineral/plastitanium,
/area/shuttle/exploration)
"ie" = (
/obj/effect/turf_decal/stripes/line{
	dir = 8
	},
/obj/effect/turf_decal/caution/red{
	dir = 4
	},
/obj/effect/turf_decal/tile/blue/opposingcorners,
/obj/machinery/light,
/obj/structure/extinguisher_cabinet{
	pixel_y = -32
	},
/turf/open/floor/mineral/titanium/white,
/area/shuttle/exploration)
"jz" = (
/obj/effect/turf_decal/delivery,
/obj/machinery/button/door{
	desc = "A remote control switch.";
	id = "exploration";
	name = "Exploration Shuttle Shutters";
	pixel_y = 25;
	req_access_txt = "49"
	},
/obj/effect/turf_decal/stripes/closeup{
	dir = 1
	},
/obj/machinery/door/poddoor/shutters{
	id = "exploration"
	},
/turf/open/floor/plating,
/area/shuttle/exploration)
"jI" = (
/obj/structure/tank_dispenser/oxygen,
/obj/effect/turf_decal/tile/brown/opposingcorners,
/obj/effect/turf_decal/stripes/line{
	dir = 1
	},
/obj/effect/turf_decal/stripes/corner{
	dir = 8
	},
/turf/open/floor/mineral/titanium/yellow,
/area/shuttle/exploration)
"kU" = (
/obj/effect/turf_decal/tile/brown/opposingcorners,
/obj/structure/closet/crate/science/shuttle,
/obj/effect/turf_decal/stripes/line{
	dir = 1
	},
/obj/effect/turf_decal/bot,
/turf/open/floor/mineral/titanium/yellow,
/area/shuttle/exploration)
"mj" = (
/obj/effect/spawner/structure/window/shuttle,
/obj/machinery/atmospherics/pipe/simple/supply/hidden/layer2,
/turf/open/floor/plating,
/area/shuttle/exploration)
"nI" = (
/obj/machinery/atmospherics/components/unary/plasma_refiner{
	dir = 8
	},
/obj/effect/turf_decal/delivery,
/obj/effect/turf_decal/tile/brown/opposingcorners,
/obj/machinery/light,
/turf/open/floor/mineral/titanium/yellow,
/area/shuttle/exploration)
"nZ" = (
/obj/machinery/computer/objective,
/obj/effect/turf_decal/tile/neutral/opposingcorners,
/turf/open/floor/mineral/plastitanium,
/area/shuttle/exploration)
"pR" = (
/obj/effect/turf_decal/tile/neutral/opposingcorners,
/obj/effect/turf_decal/stripes/line,
/obj/machinery/atmospherics/components/unary/vent_pump/on/layer2{
	dir = 8
	},
/turf/open/floor/mineral/plastitanium,
/area/shuttle/exploration)
"pY" = (
/obj/effect/turf_decal/tile/blue/opposingcorners,
/turf/open/floor/mineral/titanium/white,
/area/shuttle/exploration)
"qC" = (
/obj/effect/turf_decal/stripes/line{
	dir = 8
	},
/obj/effect/turf_decal/caution/stand_clear{
	dir = 4
	},
/obj/effect/turf_decal/tile/brown/opposingcorners,
/obj/structure/cable/yellow{
	icon_state = "4-8"
	},
/obj/machinery/atmospherics/pipe/simple/supply/hidden/layer2{
	dir = 4
	},
/obj/machinery/atmospherics/pipe/simple/scrubbers/hidden/layer4{
	dir = 8
	},
/turf/open/floor/mineral/titanium/yellow,
/area/shuttle/exploration)
"qZ" = (
/obj/docking_port/mobile{
	dir = 4;
	dwidth = 10;
	height = 8;
	id = "exploration";
	name = "Exploration Shuttle";
	port_direction = 8;
	shuttle_object_type = /datum/orbital_object/shuttle/custom_shuttle;
	width = 14
	},
/obj/structure/cable/yellow{
	icon_state = "4-8"
	},
/obj/effect/turf_decal/delivery,
/obj/machinery/atmospherics/pipe/simple/supply/hidden/layer2{
	dir = 4
	},
/obj/machinery/atmospherics/pipe/simple/scrubbers/hidden/layer4{
	dir = 5
	},
/obj/machinery/door/airlock/external{
	req_access_txt = "49";
	name = "Exploration Shuttle airlock"
	},
/obj/effect/turf_decal/stripes/closeup{
	dir = 1
	},
/turf/open/floor/mineral/plastitanium,
/area/shuttle/exploration)
"si" = (
/obj/structure/sign/warning/fire,
/turf/closed/wall/mineral/plastitanium/nodiagonal,
/area/shuttle/exploration)
"uu" = (
/obj/effect/turf_decal/box/corners{
	dir = 4
	},
/obj/effect/turf_decal/box/corners,
/obj/effect/turf_decal/tile/neutral/fourcorners/contrasted,
/obj/effect/turf_decal/stripes/corner,
/obj/machinery/atmospherics/pipe/simple/supply/hidden/layer2{
	dir = 6
	},
/turf/open/floor/mineral/plastitanium,
/area/shuttle/exploration)
"uU" = (
/obj/structure/window/reinforced/survival_pod{
	dir = 1
	},
/obj/machinery/atmospherics/components/unary/shuttle/heater{
	dir = 1
	},
/turf/open/floor/plating,
/area/shuttle/exploration)
"vf" = (
/obj/structure/sign/nanotrasen,
/turf/closed/wall/mineral/titanium,
/area/shuttle/exploration)
"wn" = (
/obj/machinery/power/apc/auto_name/east,
/obj/effect/turf_decal/loading_area,
/obj/effect/turf_decal/tile/brown/opposingcorners,
/obj/structure/cable/yellow,
/obj/structure/cable/yellow{
	icon_state = "1-8"
	},
/turf/open/floor/mineral/titanium/yellow,
/area/shuttle/exploration)
"wE" = (
/obj/effect/turf_decal/tile/neutral/opposingcorners,
/turf/open/floor/mineral/plastitanium,
/area/shuttle/exploration)
"wG" = (
/turf/closed/wall/mineral/titanium,
/area/shuttle/exploration)
"wH" = (
/obj/effect/turf_decal/tile/brown/opposingcorners,
/obj/structure/cable/yellow{
	icon_state = "4-8"
	},
/obj/machinery/atmospherics/pipe/simple/supply/hidden/layer2{
	dir = 4
	},
/obj/machinery/atmospherics/pipe/simple/scrubbers/hidden/layer4{
	dir = 8
	},
/turf/open/floor/mineral/titanium/yellow,
/area/shuttle/exploration)
"yE" = (
/obj/effect/turf_decal/tile/neutral/opposingcorners,
/obj/structure/chair/fancy/shuttle{
	dir = 1
	},
/turf/open/floor/mineral/plastitanium,
/area/shuttle/exploration)
"As" = (
/obj/structure/chair/fancy/shuttle,
/obj/effect/turf_decal/tile/neutral/opposingcorners,
/obj/machinery/atmospherics/pipe/simple/supply/hidden/layer2,
/obj/effect/turf_decal/stripes/corner{
	dir = 4
	},
/turf/open/floor/mineral/plastitanium,
/area/shuttle/exploration)
"Av" = (
/obj/effect/turf_decal/tile/blue/opposingcorners,
/obj/effect/turf_decal/stripes/line,
/obj/machinery/atmospherics/pipe/simple/supply/hidden/layer2,
/obj/machinery/door/firedoor/border_only,
/turf/open/floor/mineral/titanium/white,
/area/shuttle/exploration)
"AE" = (
/turf/closed/wall/mineral/titanium/nodiagonal,
/area/shuttle/exploration)
"AZ" = (
/obj/effect/spawner/structure/window/shuttle,
/turf/open/floor/plating,
/area/shuttle/exploration)
"Bg" = (
/obj/effect/turf_decal/tile/blue/opposingcorners,
/obj/effect/turf_decal/bot,
/obj/structure/closet/crate/large,
/obj/effect/spawner/lootdrop/maintenance/three,
/turf/open/floor/mineral/titanium/white,
/area/shuttle/exploration)
"Bh" = (
/obj/effect/spawner/structure/window/shuttle,
/obj/machinery/atmospherics/pipe/simple/scrubbers/hidden/layer4,
/turf/open/floor/plating,
/area/shuttle/exploration)
"Bk" = (
/obj/machinery/computer/shuttle_flight/custom_shuttle/exploration,
/obj/effect/turf_decal/tile/neutral/opposingcorners,
/turf/open/floor/mineral/plastitanium,
/area/shuttle/exploration)
"Dv" = (
/obj/effect/turf_decal/tile/blue/opposingcorners,
/obj/effect/turf_decal/stripes/line{
	dir = 1
	},
/turf/open/floor/mineral/titanium/white,
/area/shuttle/exploration)
"Eg" = (
/obj/effect/turf_decal/tile/neutral/opposingcorners,
/obj/effect/turf_decal/stripes/line,
/obj/machinery/atmospherics/components/unary/vent_scrubber/on/layer4{
	dir = 4
	},
/turf/open/floor/mineral/plastitanium,
/area/shuttle/exploration)
"Fy" = (
/obj/machinery/microwave{
	pixel_y = 6
	},
/obj/effect/turf_decal/tile/neutral/opposingcorners,
/obj/structure/table,
/obj/machinery/firealarm/directional/west,
/turf/open/floor/mineral/plastitanium,
/area/shuttle/exploration)
"GJ" = (
/obj/effect/turf_decal/tile/brown/opposingcorners,
/obj/machinery/atmospherics/components/unary/vent_scrubber/on/layer4{
	dir = 8
	},
/obj/machinery/atmospherics/pipe/manifold/supply/hidden/layer2{
	dir = 4
	},
/obj/effect/turf_decal/stripes/line{
	dir = 1
	},
/turf/open/floor/mineral/titanium/yellow,
/area/shuttle/exploration)
"Ij" = (
/obj/effect/turf_decal/tile/neutral/opposingcorners,
/obj/effect/turf_decal/box,
/obj/machinery/telecomms/relay/preset/mining,
/obj/machinery/door/window/eastright{
	dir = 8
	},
/obj/structure/window/reinforced{
	dir = 1
	},
/obj/effect/turf_decal/stripes/corner{
	dir = 8
	},
/obj/machinery/light,
/turf/open/floor/mineral/plastitanium,
/area/shuttle/exploration)
"In" = (
/obj/item/tank/internals/emergency_oxygen/engi{
	pixel_x = -10;
	pixel_y = 3
	},
/obj/item/storage/toolbox/emergency,
/obj/item/radio{
	pixel_x = 7;
	pixel_y = 8
	},
/obj/effect/turf_decal/tile/neutral/opposingcorners,
/obj/structure/table,
/turf/open/floor/mineral/plastitanium,
/area/shuttle/exploration)
"Jy" = (
/obj/effect/turf_decal/tile/brown/opposingcorners,
/obj/structure/cable/yellow{
	icon_state = "4-8"
	},
/obj/machinery/atmospherics/pipe/simple/supply/hidden/layer2{
	dir = 9
	},
/turf/open/floor/mineral/titanium/yellow,
/area/shuttle/exploration)
"MU" = (
/obj/effect/turf_decal/delivery,
/obj/effect/turf_decal/stripes/closeup{
	dir = 1
	},
/obj/machinery/door/poddoor/shutters{
	id = "exploration"
	},
/turf/open/floor/plating,
/area/shuttle/exploration)
"Nq" = (
/obj/effect/turf_decal/tile/neutral/opposingcorners,
/obj/structure/table,
/obj/machinery/recharger{
	pixel_x = 6
	},
/obj/machinery/recharger{
	pixel_x = -6
	},
/obj/machinery/atmospherics/pipe/manifold/supply/hidden/layer2{
	dir = 8
	},
/turf/open/floor/mineral/plastitanium,
/area/shuttle/exploration)
"Nz" = (
/obj/effect/turf_decal/tile/blue/opposingcorners,
/obj/effect/turf_decal/stripes/line,
/obj/structure/railing,
/obj/machinery/door/firedoor/border_only,
/turf/open/floor/mineral/titanium/white,
/area/shuttle/exploration)
"NL" = (
/obj/structure/lattice/catwalk,
/obj/item/stack/marker_beacon{
	anchored = 1;
	icon_state = "markerburgundy-on";
	light_color = "#FA644B";
	light_power = 3;
	light_range = 2;
	name = "landing marker";
	picked_color = "Burgundy"
	},
/turf/template_noop,
/area/shuttle/exploration)
"Ox" = (
/obj/effect/turf_decal/tile/blue/opposingcorners,
/obj/structure/closet/crate/bin,
/obj/item/toy/beach_ball,
/obj/item/bikehorn/rubberducky,
/obj/effect/turf_decal/box,
/obj/effect/turf_decal/stripes/corner{
	dir = 1
	},
/obj/machinery/newscaster{
	pixel_y = 32
	},
/turf/open/floor/mineral/titanium/white,
/area/shuttle/exploration)
"Pd" = (
/obj/effect/turf_decal/tile/brown/opposingcorners,
/obj/machinery/atmospherics/components/unary/vent_pump/on/layer2{
	dir = 4
	},
/obj/machinery/atmospherics/pipe/manifold/scrubbers/hidden/layer4{
	dir = 8
	},
/obj/effect/turf_decal/stripes/line{
	dir = 1
	},
/turf/open/floor/mineral/titanium/yellow,
/area/shuttle/exploration)
"Pr" = (
/obj/effect/turf_decal/tile/neutral/opposingcorners,
/mob/living/simple_animal/chicken/turkey{
	atmos_requirements = list("min_oxy"=0,"max_oxy"=0,"min_tox"=0,"max_tox"=0,"min_co2"=0,"max_co2"=0,"min_n2"=0,"max_n2"=0);
	desc = "A veteran of Nanotrasen's Animal Experimentation Program that attempted to replicate the organic space suit that some hostile entities are known to have exhibited, Tom now serves Nanotrasen as the mascot of the Exploration Crew.";
	health = 200;
	maxHealth = 200;
	melee_damage = 5;
	minbodytemp = 2.7;
	name = "Tom"
	},
/turf/open/floor/mineral/plastitanium,
/area/shuttle/exploration)
"PK" = (
/obj/machinery/shuttle/engine/plasma{
	dir = 1
	},
/turf/open/floor/plating,
/area/shuttle/exploration)
"Qu" = (
/obj/effect/turf_decal/tile/neutral/opposingcorners,
/obj/structure/closet/crate/secure/weapon/contraband,
/obj/effect/turf_decal/bot,
/turf/open/floor/mineral/plastitanium,
/area/shuttle/exploration)
"Ro" = (
/obj/effect/turf_decal/stripes/line,
/obj/effect/turf_decal/tile/blue/opposingcorners,
/obj/machinery/atmospherics/pipe/simple/scrubbers/hidden/layer4,
/obj/machinery/door/firedoor/border_only,
/turf/open/floor/mineral/titanium/white,
/area/shuttle/exploration)
"St" = (
/obj/effect/turf_decal/tile/neutral/opposingcorners,
/obj/machinery/door/airlock/shuttle,
/obj/machinery/door/firedoor,
/obj/effect/turf_decal/delivery,
/turf/open/floor/mineral/plastitanium,
/area/shuttle/exploration)
"SQ" = (
/obj/machinery/holopad{
	pixel_x = 15
	},
/obj/effect/turf_decal/box/corners{
	dir = 1
	},
/obj/effect/turf_decal/box/corners{
	dir = 8
	},
/obj/effect/turf_decal/tile/neutral/fourcorners/contrasted,
/obj/effect/turf_decal/stripes/corner{
	dir = 8
	},
/obj/machinery/atmospherics/pipe/simple/scrubbers/hidden/layer4{
	dir = 10
	},
/turf/open/floor/mineral/plastitanium,
/area/shuttle/exploration)
"SX" = (
/obj/effect/turf_decal/stripes/line{
	dir = 8
	},
/obj/effect/turf_decal/caution/red{
	dir = 4
	},
/obj/effect/turf_decal/box/corners{
	dir = 4
	},
/obj/effect/turf_decal/tile/blue/opposingcorners,
/obj/machinery/firealarm/directional/north,
/obj/effect/turf_decal/stripes/corner{
	dir = 4
	},
/turf/open/floor/mineral/titanium/white,
/area/shuttle/exploration)
"Ta" = (
/obj/effect/turf_decal/tile/brown/opposingcorners,
/obj/structure/cable/yellow{
	icon_state = "4-8"
	},
/turf/open/floor/mineral/titanium/yellow,
/area/shuttle/exploration)
"TQ" = (
/obj/effect/turf_decal/stripes/corner{
	dir = 1
	},
/obj/machinery/atmospherics/components/unary/portables_connector/visible{
	dir = 4
	},
/obj/effect/turf_decal/tile/brown/opposingcorners,
/obj/effect/turf_decal/bot,
/obj/item/wrench,
/obj/machinery/light,
/turf/open/floor/mineral/titanium/yellow,
/area/shuttle/exploration)
"TZ" = (
/obj/item/storage/box/donkpockets,
/obj/item/storage/box/donkpockets/donkpockethonk{
	pixel_x = 5;
	pixel_y = 5
	},
/obj/effect/turf_decal/tile/neutral/opposingcorners,
/obj/structure/table,
/turf/open/floor/mineral/plastitanium,
/area/shuttle/exploration)
"Vg" = (
/turf/closed/wall/mineral/plastitanium,
/area/shuttle/exploration)
"Vh" = (
/obj/structure/sign/nanotrasen,
/turf/closed/wall/mineral/titanium/nodiagonal,
/area/shuttle/exploration)
"VA" = (
/obj/structure/chair/fancy/shuttle,
/obj/effect/turf_decal/tile/neutral/opposingcorners,
/obj/machinery/atmospherics/pipe/simple/scrubbers/hidden/layer4,
/obj/effect/turf_decal/stripes/corner{
	dir = 1
	},
/turf/open/floor/mineral/plastitanium,
/area/shuttle/exploration)
"XD" = (
/obj/structure/chair/fancy/shuttle{
	dir = 1
	},
/obj/effect/turf_decal/tile/neutral/opposingcorners,
/obj/machinery/atmospherics/pipe/simple/scrubbers/hidden/layer4,
/turf/open/floor/mineral/plastitanium,
/area/shuttle/exploration)
"XK" = (
/obj/effect/turf_decal/stripes/line{
	dir = 8
	},
/obj/effect/turf_decal/caution/red{
	dir = 4
	},
/obj/effect/turf_decal/tile/blue/opposingcorners,
/turf/open/floor/mineral/titanium/white,
/area/shuttle/exploration)
"XZ" = (
/obj/effect/decal/cleanable/blood/old,
/obj/effect/turf_decal/tile/blue/opposingcorners,
/obj/machinery/atmospherics/components/unary/vent_pump/on/layer2{
	dir = 8
	},
/turf/open/floor/mineral/titanium/white,
/area/shuttle/exploration)
"Ze" = (
/obj/structure/chair/fancy/shuttle{
	dir = 1
	},
/obj/effect/turf_decal/tile/neutral/opposingcorners,
/obj/machinery/atmospherics/pipe/simple/supply/hidden/layer2,
/turf/open/floor/mineral/plastitanium,
/area/shuttle/exploration)
"ZG" = (
/obj/effect/turf_decal/tile/brown/opposingcorners,
/obj/structure/closet/crate/science/mining,
/obj/effect/turf_decal/stripes/line{
	dir = 1
	},
/obj/effect/turf_decal/bot,
/turf/open/floor/mineral/titanium/yellow,
/area/shuttle/exploration)
"ZV" = (
/obj/effect/spawner/structure/window/shuttle,
/obj/machinery/atmospherics/pipe/simple/scrubbers/hidden/layer4{
	dir = 10
	},
/turf/open/floor/plating,
/area/shuttle/exploration)

(1,1,1) = {"
NL
AZ
wG
vf
AE
jz
MU
gl
AE
ZV
qZ
Vh
Vg
NL
"}
(2,1,1) = {"
AZ
AZ
Fy
hz
wG
SX
XK
ie
wG
jI
qC
TQ
si
Vg
"}
(3,1,1) = {"
AZ
TZ
wE
Eg
St
Dv
hr
pY
Nz
ZG
wH
dt
uU
PK
"}
(4,1,1) = {"
AZ
Bk
yE
SQ
Bh
VA
hW
XD
Ro
Pd
gZ
dt
uU
PK
"}
(5,1,1) = {"
AZ
nZ
yE
uu
mj
As
Nq
Ze
Av
GJ
Jy
dt
uU
PK
"}
(6,1,1) = {"
AZ
In
Pr
pR
St
Dv
XZ
pY
Nz
kU
Ta
dt
uU
PK
"}
(7,1,1) = {"
AZ
AZ
Qu
Ij
wG
Ox
Bg
aT
wG
dz
wn
nI
si
Vg
"}
(8,1,1) = {"
NL
AZ
wG
vf
wG
AZ
AZ
wG
wG
wG
wG
Vh
Vg
NL
"}
