//MAP CONVERTED BY dmm2tgm.py THIS HEADER COMMENT PREVENTS RECONVERSION, DO NOT REMOVE
"aA" = (
/obj/machinery/atmospherics/components/unary/portables_connector/visible{
	dir = 4
	},
/obj/effect/turf_decal/delivery,
/turf/open/floor/plating,
/area/shuttle/exploration)
"aV" = (
/obj/structure/extinguisher_cabinet{
	pixel_x = -25
	},
/obj/machinery/light{
	dir = 8
	},
/turf/open/floor/mineral/plastitanium,
/area/shuttle/exploration)
"bb" = (
/obj/effect/turf_decal/stripes/line{
	dir = 1
	},
/obj/effect/turf_decal/stripes/line,
/obj/machinery/atmospherics/components/binary/dp_vent_pump/layer2{
	dir = 1
	},
/obj/machinery/atmospherics/pipe/manifold/scrubbers/hidden/layer4{
	dir = 4
	},
/obj/structure/cable/yellow{
	icon_state = "1-2"
	},
/turf/open/floor/mineral/titanium,
/area/shuttle/exploration)
"bS" = (
/obj/machinery/holopad,
/obj/machinery/atmospherics/pipe/simple/supply/hidden/layer2{
	dir = 4
	},
/obj/machinery/atmospherics/pipe/simple/scrubbers/hidden/layer4{
	dir = 4
	},
/obj/structure/cable/yellow{
	icon_state = "4-8"
	},
/turf/open/floor/mineral/titanium,
/area/shuttle/exploration)
"ce" = (
/obj/machinery/door/airlock/shuttle,
/obj/machinery/atmospherics/pipe/simple/supply/hidden/layer2{
	dir = 4
	},
/obj/machinery/atmospherics/pipe/simple/scrubbers/hidden/layer4{
	dir = 4
	},
/turf/open/floor/mineral/titanium,
/area/shuttle/exploration)
"df" = (
/turf/closed/wall/mineral/titanium/nodiagonal,
/area/shuttle/exploration)
"dq" = (
/obj/effect/turf_decal/stripes/corner{
	dir = 1
	},
/obj/machinery/light/small{
	dir = 8
	},
/turf/open/floor/mineral/plastitanium,
/area/shuttle/exploration)
"dv" = (
/obj/machinery/atmospherics/pipe/manifold/purple/visible{
	dir = 4
	},
/obj/effect/turf_decal/stripes/line{
	dir = 8
	},
/obj/effect/turf_decal/stripes/corner,
/turf/open/floor/mineral/titanium,
/area/shuttle/exploration)
"dN" = (
/obj/machinery/door/airlock/external/glass,
/obj/effect/turf_decal/delivery,
/obj/effect/mapping_helpers/airlock/cyclelink_helper{
	dir = 1
	},
/obj/machinery/atmospherics/pipe/simple/scrubbers/hidden/layer4,
/obj/machinery/atmospherics/pipe/manifold/supply/hidden/layer2{
	dir = 8
	},
/obj/structure/cable/yellow{
	icon_state = "1-2"
	},
/turf/open/floor/mineral/titanium,
/area/shuttle/exploration)
"ea" = (
/obj/machinery/atmospherics/pipe/simple/scrubbers/hidden/layer4,
/obj/machinery/atmospherics/pipe/simple/supply/hidden/layer2,
/obj/structure/cable/yellow{
	icon_state = "1-2"
	},
/turf/open/floor/mineral/titanium,
/area/shuttle/exploration)
"eN" = (
/mob/living/simple_animal/chicken/turkey{
	atmos_requirements = list("min_oxy" = 0, "max_oxy" = 0, "min_tox" = 0, "max_tox" = 0, "min_co2" = 0, "max_co2" = 0, "min_n2" = 0, "max_n2" = 0);
	desc = "A veteran of Nanotrasen's Animal Experimentation Program that attempted to replicate the organic space suit that some hostile entities are known to have exhibited, Tom now serves Nanotrasen as the mascot of the Exploration Crew.";
	health = 200;
	maxHealth = 200;
	melee_damage = 5;
	minbodytemp = 2.7;
	name = "Tom"
	},
/turf/open/floor/mineral/titanium,
/area/shuttle/exploration)
"fy" = (
/obj/machinery/suit_storage_unit/open,
/obj/effect/turf_decal/box,
/turf/open/floor/mineral/titanium,
/area/shuttle/exploration)
"fO" = (
/turf/open/floor/mineral/titanium,
/area/shuttle/exploration)
"fU" = (
/obj/structure/extinguisher_cabinet{
	pixel_x = -25
	},
/obj/machinery/atmospherics/pipe/simple/supply/hidden/layer2,
/obj/machinery/atmospherics/pipe/simple/scrubbers/hidden/layer4,
/obj/structure/cable/yellow{
	icon_state = "1-2"
	},
/turf/open/floor/mineral/titanium,
/area/shuttle/exploration)
"gJ" = (
/turf/closed/wall/mineral/titanium,
/area/shuttle/exploration)
"gS" = (
/obj/effect/turf_decal/bot,
/obj/machinery/power/port_gen/pacman,
/obj/structure/cable/yellow,
/turf/open/floor/plating,
/area/shuttle/exploration)
"gW" = (
/obj/machinery/atmospherics/pipe/simple/supply/hidden/layer2{
	dir = 4
	},
/obj/machinery/atmospherics/pipe/simple/scrubbers/hidden/layer4{
	dir = 4
	},
/turf/open/floor/mineral/titanium,
/area/shuttle/exploration)
"hi" = (
/obj/effect/turf_decal/bot,
/obj/item/toy/cards/deck/cas,
/obj/item/toy/cards/deck/cas/black{
	pixel_y = 3
	},
/obj/item/toy/cards/deck{
	pixel_x = -8
	},
/obj/item/toy/cards/deck/unum{
	pixel_x = 4;
	pixel_y = 8
	},
/obj/machinery/light{
	dir = 4
	},
/obj/structure/closet/crate/wooden,
/turf/open/floor/mineral/plastitanium,
/area/shuttle/exploration)
"hP" = (
/obj/machinery/atmospherics/components/unary/portables_connector/visible{
	dir = 4
	},
/obj/effect/turf_decal/delivery,
/obj/machinery/light{
	dir = 8
	},
/turf/open/floor/plating,
/area/shuttle/exploration)
"hT" = (
/obj/machinery/light{
	dir = 8
	},
/turf/open/floor/mineral/titanium/blue,
/area/shuttle/exploration)
"iG" = (
/obj/structure/chair/fancy/shuttle,
/turf/open/floor/mineral/plastitanium,
/area/shuttle/exploration)
"iH" = (
/obj/machinery/atmospherics/pipe/manifold/purple/visible{
	dir = 4
	},
/obj/effect/turf_decal/stripes/line{
	dir = 8
	},
/obj/structure/cable/yellow{
	icon_state = "1-4"
	},
/turf/open/floor/mineral/titanium,
/area/shuttle/exploration)
"iT" = (
/obj/machinery/computer/rdconsole,
/obj/effect/turf_decal/delivery,
/turf/open/floor/mineral/plastitanium,
/area/shuttle/exploration)
"jt" = (
/obj/machinery/portable_atmospherics/canister/plasma,
/obj/effect/turf_decal/bot,
/turf/open/floor/mineral/plastitanium,
/area/shuttle/exploration)
"jB" = (
/obj/effect/spawner/structure/window/shuttle,
/turf/open/floor/plating,
/area/shuttle/exploration)
"jO" = (
/obj/machinery/light{
	dir = 8
	},
/obj/structure/closet/crate/secure/science/contraband,
/obj/effect/turf_decal/bot,
/turf/open/floor/mineral/plastitanium,
/area/shuttle/exploration)
"jR" = (
/obj/structure/extinguisher_cabinet{
	pixel_x = 25
	},
/obj/machinery/light/small{
	dir = 4
	},
/turf/open/floor/mineral/plastitanium,
/area/shuttle/exploration)
"jS" = (
/obj/machinery/atmospherics/pipe/simple/purple/visible{
	dir = 9
	},
/obj/effect/turf_decal/stripes/corner{
	dir = 4
	},
/obj/machinery/light{
	dir = 4
	},
/turf/open/floor/mineral/titanium,
/area/shuttle/exploration)
"kx" = (
/obj/machinery/computer/security,
/obj/effect/turf_decal/delivery,
/turf/open/floor/mineral/plastitanium,
/area/shuttle/exploration)
"kH" = (
/obj/effect/turf_decal/bot,
/turf/open/floor/mineral/plastitanium,
/area/shuttle/exploration)
"kI" = (
/obj/effect/turf_decal/stripes/line{
	dir = 8
	},
/obj/effect/turf_decal/stripes/line{
	dir = 4
	},
/obj/machinery/door/airlock/shuttle,
/obj/effect/turf_decal/delivery,
/turf/open/floor/mineral/plastitanium,
/area/shuttle/exploration)
"kO" = (
/obj/structure/chair/fancy/shuttle{
	dir = 1
	},
/turf/open/floor/mineral/plastitanium,
/area/shuttle/exploration)
"lc" = (
/obj/structure/chair/fancy/shuttle{
	dir = 4
	},
/turf/open/floor/mineral/titanium/blue,
/area/shuttle/exploration)
"lg" = (
/obj/structure/extinguisher_cabinet{
	pixel_x = -25
	},
/obj/machinery/atmospherics/pipe/simple/scrubbers/hidden/layer4,
/obj/machinery/atmospherics/pipe/simple/supply/hidden/layer2,
/obj/structure/cable/yellow{
	icon_state = "1-2"
	},
/turf/open/floor/mineral/titanium,
/area/shuttle/exploration)
"lS" = (
/obj/machinery/atmospherics/pipe/manifold4w/scrubbers/hidden/layer4,
/obj/machinery/atmospherics/pipe/manifold4w/supply/hidden/layer2,
/obj/structure/cable/yellow{
	icon_state = "2-8"
	},
/obj/structure/cable/yellow{
	icon_state = "1-2"
	},
/turf/open/floor/mineral/titanium,
/area/shuttle/exploration)
"lY" = (
/obj/machinery/portable_atmospherics/canister/plasma,
/turf/open/floor/mineral/plastitanium,
/area/shuttle/exploration)
"mb" = (
/obj/machinery/atmospherics/components/unary/shuttle/heater{
	dir = 4
	},
/obj/structure/window/reinforced/survival_pod{
	dir = 4
	},
/turf/open/floor/engine,
/area/shuttle/exploration)
"mk" = (
/obj/machinery/door/airlock/external/glass,
/obj/effect/turf_decal/delivery,
/obj/effect/mapping_helpers/airlock/cyclelink_helper,
/obj/machinery/atmospherics/pipe/simple/scrubbers/hidden/layer4,
/obj/machinery/atmospherics/pipe/manifold/supply/hidden/layer2{
	dir = 8
	},
/obj/structure/cable/yellow{
	icon_state = "1-2"
	},
/turf/open/floor/mineral/titanium,
/area/shuttle/exploration)
"mr" = (
/obj/machinery/atmospherics/pipe/manifold/supply/hidden/layer2{
	dir = 1
	},
/obj/machinery/atmospherics/pipe/manifold/scrubbers/hidden/layer4,
/turf/open/floor/mineral/titanium,
/area/shuttle/exploration)
"mL" = (
/obj/machinery/computer/objective{
	dir = 1
	},
/obj/effect/turf_decal/delivery,
/turf/open/floor/mineral/plastitanium,
/area/shuttle/exploration)
"mR" = (
/obj/machinery/door/airlock/external/glass,
/obj/effect/turf_decal/delivery,
/obj/effect/mapping_helpers/airlock/cyclelink_helper{
	dir = 1
	},
/obj/machinery/atmospherics/pipe/layer_manifold,
/obj/structure/cable/yellow{
	icon_state = "1-2"
	},
/turf/open/floor/mineral/titanium,
/area/shuttle/exploration)
"nu" = (
/obj/structure/extinguisher_cabinet{
	pixel_y = 29
	},
/turf/open/floor/mineral/titanium,
/area/shuttle/exploration)
"nF" = (
/obj/structure/table,
/obj/item/storage/box/donkpockets,
/obj/item/storage/box/donkpockets,
/turf/open/floor/mineral/titanium/blue,
/area/shuttle/exploration)
"nK" = (
/obj/effect/turf_decal/stripes/corner{
	dir = 1
	},
/obj/machinery/suit_storage_unit/open,
/obj/effect/turf_decal/box,
/turf/open/floor/mineral/titanium,
/area/shuttle/exploration)
"nY" = (
/obj/structure/chair/fancy/shuttle{
	dir = 4
	},
/turf/open/floor/mineral/plastitanium,
/area/shuttle/exploration)
"om" = (
/obj/effect/turf_decal/stripes/corner{
	dir = 8
	},
/obj/machinery/suit_storage_unit/open,
/obj/effect/turf_decal/box,
/turf/open/floor/mineral/titanium,
/area/shuttle/exploration)
"pd" = (
/obj/effect/turf_decal/caution,
/obj/effect/turf_decal/stripes/line{
	dir = 1
	},
/obj/machinery/atmospherics/pipe/simple/supply/hidden/layer2,
/obj/machinery/atmospherics/pipe/simple/scrubbers/hidden/layer4,
/obj/structure/cable/yellow{
	icon_state = "1-2"
	},
/turf/open/floor/mineral/titanium,
/area/shuttle/exploration)
"pi" = (
/obj/structure/tank_dispenser/oxygen,
/turf/open/floor/mineral/plastitanium,
/area/shuttle/exploration)
"pu" = (
/obj/machinery/atmospherics/pipe/simple/scrubbers/hidden/layer4{
	dir = 4
	},
/turf/closed/wall/mineral/titanium,
/area/shuttle/exploration)
"qs" = (
/turf/open/floor/mineral/titanium/blue,
/area/shuttle/exploration)
"qJ" = (
/obj/structure/extinguisher_cabinet{
	pixel_x = 24
	},
/obj/machinery/light{
	dir = 4
	},
/obj/machinery/power/terminal{
	dir = 1
	},
/obj/structure/cable/yellow{
	icon_state = "0-2"
	},
/obj/machinery/atmospherics/pipe/simple/purple/visible{
	dir = 10
	},
/turf/open/floor/mineral/titanium,
/area/shuttle/exploration)
"sh" = (
/obj/effect/spawner/structure/window/shuttle,
/obj/machinery/atmospherics/pipe/simple/scrubbers/hidden/layer4{
	dir = 5
	},
/turf/open/floor/plating,
/area/shuttle/exploration)
"sD" = (
/obj/machinery/computer/shuttle_flight/custom_shuttle/exploration{
	dir = 8
	},
/obj/effect/turf_decal/delivery,
/turf/open/floor/mineral/plastitanium,
/area/shuttle/exploration)
"sO" = (
/obj/effect/turf_decal/stripes/line{
	dir = 1
	},
/turf/open/floor/mineral/titanium,
/area/shuttle/exploration)
"sY" = (
/obj/structure/chair/fancy/shuttle{
	dir = 4
	},
/obj/machinery/light/small{
	dir = 8
	},
/turf/open/floor/mineral/titanium/blue,
/area/shuttle/exploration)
"te" = (
/obj/machinery/atmospherics/pipe/manifold/supply/hidden/layer2{
	dir = 1
	},
/obj/machinery/atmospherics/pipe/manifold/scrubbers/hidden/layer4,
/obj/structure/cable/yellow{
	icon_state = "4-8"
	},
/turf/open/floor/mineral/titanium,
/area/shuttle/exploration)
"tt" = (
/obj/machinery/computer/crew{
	dir = 1
	},
/obj/effect/turf_decal/delivery,
/turf/open/floor/mineral/plastitanium,
/area/shuttle/exploration)
"tD" = (
/obj/effect/turf_decal/caution{
	dir = 1
	},
/obj/effect/turf_decal/stripes/line,
/obj/machinery/atmospherics/pipe/simple/scrubbers/hidden/layer4,
/obj/machinery/atmospherics/pipe/simple/supply/hidden/layer2,
/obj/structure/cable/yellow{
	icon_state = "1-2"
	},
/turf/open/floor/mineral/titanium,
/area/shuttle/exploration)
"um" = (
/obj/machinery/power/smes{
	charge = 1e+006
	},
/obj/structure/cable/yellow{
	icon_state = "0-8"
	},
/turf/open/floor/mineral/titanium,
/area/shuttle/exploration)
"up" = (
/obj/machinery/atmospherics/pipe/manifold4w/purple/visible,
/obj/effect/turf_decal/stripes/line{
	dir = 8
	},
/turf/open/floor/mineral/titanium,
/area/shuttle/exploration)
"uQ" = (
/obj/effect/turf_decal/stripes/line,
/turf/open/floor/mineral/titanium,
/area/shuttle/exploration)
"vb" = (
/obj/effect/turf_decal/stripes/line{
	dir = 8
	},
/turf/open/floor/mineral/plastitanium,
/area/shuttle/exploration)
"vx" = (
/obj/effect/turf_decal/stripes/line{
	dir = 8
	},
/obj/structure/cable/yellow{
	icon_state = "1-2"
	},
/obj/machinery/atmospherics/pipe/simple/purple/visible,
/turf/open/floor/mineral/titanium,
/area/shuttle/exploration)
"vT" = (
/obj/machinery/airalarm/unlocked{
	pixel_y = 25
	},
/turf/open/floor/mineral/titanium,
/area/shuttle/exploration)
"wo" = (
/obj/effect/turf_decal/stripes/line{
	dir = 1
	},
/obj/effect/turf_decal/stripes/line,
/obj/machinery/atmospherics/pipe/simple/supply/hidden/layer2,
/obj/machinery/light/small{
	dir = 4
	},
/turf/open/floor/mineral/titanium,
/area/shuttle/exploration)
"xl" = (
/obj/machinery/light{
	dir = 4
	},
/turf/open/floor/mineral/titanium/blue,
/area/shuttle/exploration)
"yh" = (
/turf/closed/wall/mineral/plastitanium/nodiagonal,
/area/shuttle/exploration)
"ym" = (
/obj/machinery/atmospherics/pipe/simple/purple/visible{
	dir = 9
	},
/obj/effect/turf_decal/stripes/corner{
	dir = 1
	},
/turf/open/floor/mineral/titanium,
/area/shuttle/exploration)
"yM" = (
/obj/machinery/atmospherics/components/unary/outlet_injector/on/layer4,
/turf/open/floor/plating,
/area/shuttle/exploration)
"zN" = (
/obj/machinery/atmospherics/pipe/manifold/purple/visible{
	dir = 4
	},
/obj/effect/turf_decal/stripes/line{
	dir = 8
	},
/turf/open/floor/mineral/titanium,
/area/shuttle/exploration)
"Ac" = (
/obj/machinery/door/airlock/external/glass,
/obj/effect/turf_decal/delivery,
/obj/effect/mapping_helpers/airlock/cyclelink_helper,
/obj/machinery/atmospherics/pipe/layer_manifold,
/obj/structure/cable/yellow{
	icon_state = "1-2"
	},
/turf/open/floor/mineral/titanium,
/area/shuttle/exploration)
"Ax" = (
/obj/machinery/atmospherics/pipe/simple/supply/hidden/layer2{
	dir = 4
	},
/obj/machinery/atmospherics/pipe/simple/scrubbers/hidden/layer4{
	dir = 4
	},
/obj/structure/cable/yellow{
	icon_state = "4-8"
	},
/turf/open/floor/mineral/titanium,
/area/shuttle/exploration)
"Ay" = (
/turf/closed/wall/mineral/plastitanium,
/area/shuttle/exploration)
"AN" = (
/obj/machinery/door/airlock/external/glass,
/obj/effect/turf_decal/delivery,
/obj/docking_port/mobile{
	dwidth = 16;
	height = 15;
	id = "exploration";
	name = "Exploration Shuttle";
	port_direction = 4;
	shuttle_object_type = /datum/orbital_object/shuttle/custom_shuttle;
	width = 23
	},
/obj/effect/mapping_helpers/airlock/cyclelink_helper{
	dir = 1
	},
/obj/machinery/atmospherics/pipe/simple/supply/hidden/layer2,
/turf/open/floor/mineral/titanium,
/area/shuttle/exploration)
"AU" = (
/obj/effect/turf_decal/bot,
/obj/machinery/atmospherics/components/unary/plasma_refiner{
	dir = 4
	},
/turf/open/floor/plating,
/area/shuttle/exploration)
"Cc" = (
/obj/effect/turf_decal/stripes/line{
	dir = 8
	},
/obj/structure/cable/yellow{
	icon_state = "1-2"
	},
/obj/machinery/atmospherics/pipe/manifold4w/purple/visible,
/turf/open/floor/mineral/titanium,
/area/shuttle/exploration)
"Cu" = (
/obj/machinery/door/airlock/external/glass,
/obj/effect/turf_decal/delivery,
/obj/effect/mapping_helpers/airlock/cyclelink_helper{
	dir = 1
	},
/obj/machinery/atmospherics/pipe/simple/supply/hidden/layer2{
	dir = 9
	},
/turf/open/floor/mineral/titanium,
/area/shuttle/exploration)
"CG" = (
/obj/machinery/camera/autoname{
	dir = 5;
	name = "Exploration Shuttle";
	network = list("exploration shuttle")
	},
/obj/machinery/atmospherics/pipe/simple/supply/hidden/layer2,
/obj/machinery/atmospherics/pipe/simple/scrubbers/hidden/layer4,
/obj/machinery/light{
	bulb_colour = "#22bfa2";
	bulb_vacuum_colour = "#22bfa2";
	dir = 8;
	nightshift_light_color = "#22bfa2"
	},
/obj/structure/cable/yellow{
	icon_state = "1-2"
	},
/turf/open/floor/mineral/titanium,
/area/shuttle/exploration)
"CU" = (
/obj/machinery/door/airlock/external/glass,
/obj/effect/turf_decal/delivery,
/obj/effect/mapping_helpers/airlock/cyclelink_helper,
/obj/machinery/atmospherics/pipe/simple/supply/hidden/layer2{
	dir = 10
	},
/turf/open/floor/mineral/titanium,
/area/shuttle/exploration)
"Dn" = (
/turf/open/floor/mineral/plastitanium,
/area/shuttle/exploration)
"Fg" = (
/obj/machinery/atmospherics/components/unary/vent_scrubber/on/layer4,
/turf/open/floor/mineral/titanium,
/area/shuttle/exploration)
"Gb" = (
/obj/structure/table,
/obj/item/storage/toolbox/electrical,
/obj/item/gps/mining/exploration,
/obj/effect/turf_decal/bot,
/turf/open/floor/mineral/plastitanium,
/area/shuttle/exploration)
"GI" = (
/obj/effect/turf_decal/bot,
/obj/structure/closet/crate/science/mining,
/turf/open/floor/mineral/plastitanium,
/area/shuttle/exploration)
"HU" = (
/obj/effect/turf_decal/bot,
/obj/structure/closet/crate/science/shuttle,
/obj/item/stack/sheet/mineral/plasma/twenty,
/turf/open/floor/mineral/plastitanium,
/area/shuttle/exploration)
"JG" = (
/obj/effect/turf_decal/stripes/line{
	dir = 10
	},
/obj/structure/cable/yellow{
	icon_state = "1-2"
	},
/obj/structure/cable/yellow{
	icon_state = "1-4"
	},
/obj/machinery/atmospherics/pipe/simple/purple/visible{
	dir = 9
	},
/turf/open/floor/mineral/titanium,
/area/shuttle/exploration)
"Ko" = (
/obj/machinery/atmospherics/components/unary/vent_pump/on/layer2{
	dir = 1
	},
/turf/open/floor/mineral/titanium,
/area/shuttle/exploration)
"Lc" = (
/obj/machinery/atmospherics/pipe/simple/purple/visible{
	dir = 10
	},
/obj/effect/turf_decal/stripes/line{
	dir = 9
	},
/turf/open/floor/mineral/titanium,
/area/shuttle/exploration)
"LA" = (
/obj/machinery/atmospherics/components/unary/vent_pump/on/layer2{
	dir = 1
	},
/turf/open/floor/mineral/plastitanium,
/area/shuttle/exploration)
"Mr" = (
/obj/effect/turf_decal/stripes/line{
	dir = 8
	},
/obj/structure/cable/yellow{
	icon_state = "1-2"
	},
/obj/machinery/atmospherics/pipe/manifold/purple/visible{
	dir = 4
	},
/obj/item/wrench,
/turf/open/floor/mineral/titanium,
/area/shuttle/exploration)
"My" = (
/obj/machinery/atmospherics/components/unary/vent_scrubber/on/layer4,
/turf/open/floor/mineral/plastitanium,
/area/shuttle/exploration)
"Nl" = (
/obj/effect/turf_decal/stripes/line,
/turf/open/floor/mineral/titanium/blue,
/area/shuttle/exploration)
"NO" = (
/obj/machinery/door/airlock/external/glass,
/obj/effect/turf_decal/delivery,
/obj/effect/mapping_helpers/airlock/cyclelink_helper,
/obj/machinery/atmospherics/pipe/simple/supply/hidden/layer2,
/turf/open/floor/mineral/titanium,
/area/shuttle/exploration)
"NZ" = (
/obj/effect/turf_decal/stripes/corner{
	dir = 8
	},
/obj/machinery/power/apc/auto_name/east{
	locked = 0
	},
/obj/structure/cable/yellow{
	icon_state = "2-8"
	},
/obj/structure/cable/yellow,
/obj/machinery/atmospherics/pipe/simple/purple/visible,
/turf/open/floor/mineral/titanium,
/area/shuttle/exploration)
"OA" = (
/obj/effect/turf_decal/stripes/line{
	dir = 1
	},
/obj/machinery/camera/autoname{
	dir = 8;
	name = "Exploration Shuttle";
	network = list("exploration shuttle")
	},
/turf/open/floor/mineral/titanium/blue,
/area/shuttle/exploration)
"OG" = (
/obj/effect/turf_decal/delivery,
/obj/machinery/telecomms/relay/preset/mining{
	name = "Exploration"
	},
/turf/open/floor/mineral/plastitanium,
/area/shuttle/exploration)
"QG" = (
/obj/machinery/shuttle/engine/plasma{
	dir = 4
	},
/turf/open/floor/engine,
/area/shuttle/exploration)
"RH" = (
/obj/machinery/atmospherics/pipe/simple/supply/hidden/layer2{
	dir = 6
	},
/obj/machinery/atmospherics/pipe/simple/scrubbers/hidden/layer4{
	dir = 5
	},
/obj/structure/cable/yellow{
	icon_state = "4-8"
	},
/turf/open/floor/mineral/titanium,
/area/shuttle/exploration)
"SG" = (
/obj/item/beacon,
/obj/machinery/atmospherics/pipe/simple/supply/hidden/layer2{
	dir = 4
	},
/obj/machinery/atmospherics/pipe/simple/scrubbers/hidden/layer4{
	dir = 4
	},
/obj/structure/cable/yellow{
	icon_state = "4-8"
	},
/turf/open/floor/mineral/titanium,
/area/shuttle/exploration)
"Tz" = (
/obj/structure/table,
/obj/machinery/microwave,
/turf/open/floor/mineral/titanium/blue,
/area/shuttle/exploration)
"TV" = (
/obj/machinery/light,
/turf/open/floor/mineral/titanium,
/area/shuttle/exploration)
"Up" = (
/obj/effect/turf_decal/stripes/line{
	dir = 1
	},
/turf/open/floor/mineral/titanium/blue,
/area/shuttle/exploration)
"Vw" = (
/obj/structure/table,
/obj/machinery/recharger,
/obj/effect/turf_decal/bot,
/turf/open/floor/mineral/plastitanium,
/area/shuttle/exploration)
"VA" = (
/obj/effect/turf_decal/stripes/corner{
	dir = 8
	},
/obj/structure/cable/yellow{
	icon_state = "2-4"
	},
/obj/machinery/atmospherics/pipe/simple/purple/visible{
	dir = 10
	},
/turf/open/floor/mineral/titanium,
/area/shuttle/exploration)
"VO" = (
/obj/machinery/atmospherics/pipe/simple/supply/hidden/layer2{
	dir = 10
	},
/obj/machinery/atmospherics/pipe/simple/scrubbers/hidden/layer4{
	dir = 9
	},
/turf/open/floor/mineral/plastitanium,
/area/shuttle/exploration)
"VV" = (
/obj/effect/turf_decal/bot,
/obj/machinery/portable_atmospherics/canister/air,
/obj/item/analyzer,
/turf/open/floor/mineral/plastitanium,
/area/shuttle/exploration)
"Wh" = (
/obj/machinery/atmospherics/pipe/simple/purple/visible,
/obj/effect/turf_decal/stripes/corner{
	dir = 1
	},
/obj/effect/turf_decal/stripes/line{
	dir = 4
	},
/turf/open/floor/mineral/titanium,
/area/shuttle/exploration)
"Xp" = (
/obj/machinery/requests_console{
	announcementConsole = 1;
	department = "Exploration Shuttle";
	departmentType = 5;
	pixel_x = -32
	},
/obj/machinery/light{
	dir = 8
	},
/turf/open/floor/mineral/plastitanium,
/area/shuttle/exploration)
"XG" = (
/obj/machinery/atmospherics/pipe/simple/scrubbers/hidden/layer4,
/obj/machinery/atmospherics/pipe/simple/supply/hidden/layer2,
/obj/structure/cable/yellow{
	icon_state = "1-2"
	},
/obj/machinery/light{
	bulb_colour = "#22bfa2";
	bulb_vacuum_colour = "#22bfa2";
	dir = 8;
	nightshift_light_color = "#22bfa2"
	},
/turf/open/floor/mineral/titanium,
/area/shuttle/exploration)
"XI" = (
/obj/effect/turf_decal/stripes/line{
	dir = 1
	},
/obj/effect/turf_decal/stripes/line,
/obj/machinery/atmospherics/components/binary/dp_vent_pump/layer2,
/obj/machinery/atmospherics/pipe/simple/scrubbers/hidden/layer4,
/obj/structure/cable/yellow{
	icon_state = "1-2"
	},
/turf/open/floor/mineral/titanium,
/area/shuttle/exploration)
"YE" = (
/obj/machinery/door/airlock/shuttle,
/obj/effect/turf_decal/delivery,
/obj/effect/turf_decal/stripes/line,
/obj/effect/turf_decal/stripes/line{
	dir = 1
	},
/turf/open/floor/mineral/plastitanium,
/area/shuttle/exploration)
"YF" = (
/obj/machinery/door/airlock/shuttle,
/obj/effect/turf_decal/delivery,
/obj/machinery/atmospherics/pipe/simple/supply/hidden/layer2{
	dir = 4
	},
/obj/machinery/atmospherics/pipe/simple/scrubbers/hidden/layer4{
	dir = 4
	},
/obj/structure/cable/yellow{
	icon_state = "4-8"
	},
/turf/open/floor/mineral/titanium,
/area/shuttle/exploration)
"YO" = (
/obj/machinery/light{
	dir = 1
	},
/turf/open/floor/mineral/titanium,
/area/shuttle/exploration)
"YR" = (
/obj/structure/chair/fancy/shuttle{
	dir = 8
	},
/obj/machinery/light/small{
	dir = 4
	},
/turf/open/floor/mineral/titanium/blue,
/area/shuttle/exploration)
"ZB" = (
/obj/structure/chair/fancy/shuttle{
	dir = 8
	},
/turf/open/floor/mineral/titanium/blue,
/area/shuttle/exploration)
"ZM" = (
/turf/template_noop,
/area/template_noop)
"ZT" = (
/obj/structure/table,
/obj/item/paper_bin,
/obj/item/pen,
/turf/open/floor/mineral/titanium/blue,
/area/shuttle/exploration)

(1,1,1) = {"
ZM
Ay
QG
QG
QG
yh
ZM
ZM
ZM
yh
QG
QG
QG
Ay
ZM
"}
(2,1,1) = {"
Ay
Ay
mb
mb
mb
yh
yh
yh
yh
yh
mb
mb
mb
Ay
Ay
"}
(3,1,1) = {"
yh
yh
VA
Cc
JG
gS
aA
hP
aA
AU
Lc
up
ym
yh
yh
"}
(4,1,1) = {"
df
df
um
qJ
NZ
vx
Mr
iH
zN
dv
Wh
jS
fO
df
df
"}
(5,1,1) = {"
gJ
gJ
df
df
df
df
Fg
RH
Ko
df
kI
df
df
gJ
gJ
"}
(6,1,1) = {"
ZM
jB
OG
jO
pi
df
df
YF
df
df
vb
dq
jt
jB
ZM
"}
(7,1,1) = {"
ZM
jB
Dn
Dn
Dn
df
nu
Ax
eN
df
jt
lY
kH
jB
ZM
"}
(8,1,1) = {"
ZM
jB
Dn
Dn
Dn
df
YO
Ax
TV
df
kH
jR
VV
jB
ZM
"}
(9,1,1) = {"
gJ
gJ
Dn
Dn
Dn
YE
Fg
te
Ko
df
df
df
gJ
gJ
gJ
"}
(10,1,1) = {"
gJ
gJ
GI
hi
HU
df
fO
Ax
fO
df
qs
hT
qs
gJ
gJ
"}
(11,1,1) = {"
gJ
gJ
df
df
df
df
vT
Ax
fO
Up
qs
qs
qs
gJ
gJ
"}
(12,1,1) = {"
ZM
jB
lc
sY
lc
Nl
fO
SG
fO
Up
qs
qs
qs
jB
ZM
"}
(13,1,1) = {"
ZM
jB
Tz
nF
ZT
jB
fO
Ax
fO
OA
qs
qs
qs
jB
ZM
"}
(14,1,1) = {"
yM
sh
ZB
YR
ZB
Nl
fO
bS
fO
df
qs
xl
qs
jB
ZM
"}
(15,1,1) = {"
gJ
pu
df
df
df
df
fO
Ax
fO
df
df
df
df
gJ
gJ
"}
(16,1,1) = {"
Ac
bb
dN
pd
fU
CG
ea
lS
ea
XG
lg
tD
mk
XI
mR
"}
(17,1,1) = {"
NO
wo
Cu
sO
fO
fO
Fg
mr
Ko
fO
fO
uQ
CU
wo
AN
"}
(18,1,1) = {"
gJ
gJ
df
nK
fy
fO
fO
gW
fO
fO
fy
om
df
gJ
gJ
"}
(19,1,1) = {"
ZM
gJ
gJ
df
df
df
df
ce
df
df
df
df
gJ
gJ
ZM
"}
(20,1,1) = {"
ZM
ZM
gJ
jB
iT
aV
My
VO
LA
Xp
mL
jB
gJ
ZM
ZM
"}
(21,1,1) = {"
ZM
ZM
ZM
jB
kx
kO
Dn
nY
Dn
iG
tt
jB
ZM
ZM
ZM
"}
(22,1,1) = {"
ZM
ZM
ZM
jB
jB
Gb
kH
sD
kH
Vw
jB
jB
ZM
ZM
ZM
"}
(23,1,1) = {"
ZM
ZM
ZM
ZM
jB
jB
jB
jB
jB
jB
jB
ZM
ZM
ZM
ZM
"}
