//MAP CONVERTED BY dmm2tgm.py THIS HEADER COMMENT PREVENTS RECONVERSION, DO NOT REMOVE
"aR" = (
/obj/machinery/computer/objective,
/obj/effect/turf_decal/stripes/line,
/obj/effect/turf_decal/bot,
/turf/open/floor/mineral/plastitanium,
/area/shuttle/exploration)
"cg" = (
/obj/effect/turf_decal/stripes/line,
/obj/machinery/atmospherics/pipe/smart/simple/supply/hidden/layer2,
/obj/machinery/atmospherics/pipe/smart/simple/scrubbers/hidden/layer4,
/turf/open/floor/mineral/plastitanium,
/area/shuttle/exploration)
"cH" = (
/obj/machinery/computer/rdconsole{
	dir = 1
	},
/obj/structure/railing,
/obj/effect/turf_decal/bot,
/turf/open/floor/mineral/plastitanium,
/area/shuttle/exploration)
"da" = (
/turf/closed/wall/mineral/titanium,
/area/shuttle/exploration)
"fF" = (
/obj/effect/turf_decal/stripes/line{
	dir = 1
	},
/obj/effect/turf_decal/delivery,
/obj/machinery/atmospherics/components/unary/plasma_refiner{
	dir = 8
	},
/obj/structure/sign/warning/nosmoking/circle{
	pixel_x = 32
	},
/obj/effect/turf_decal/bot,
/turf/open/floor/mineral/plastitanium,
/area/shuttle/exploration)
"hl" = (
/obj/machinery/shuttle/engine/plasma{
	dir = 1
	},
/turf/open/floor/plating,
/area/shuttle/exploration)
"hY" = (
/obj/machinery/atmospherics/pipe/smart/manifold/scrubbers/hidden/layer4,
/obj/machinery/atmospherics/pipe/smart/manifold/supply/hidden/layer2,
/obj/machinery/atmospherics/pipe/smart/manifold/purple/visible,
/turf/open/floor/mineral/plastitanium,
/area/shuttle/exploration)
"ir" = (
/turf/open/floor/mineral/plastitanium,
/area/shuttle/exploration)
"jR" = (
/obj/machinery/door/poddoor/shutters/window{
	id = "exploration2"
	},
/obj/machinery/atmospherics/pipe/smart/simple/purple/visible{
	dir = 4
	},
/obj/machinery/atmospherics/pipe/smart/simple/scrubbers/hidden/layer4{
	dir = 4
	},
/obj/machinery/button/door{
	desc = "A remote control switch.";
	id = "exploration2";
	name = "Exploration Shuttle Shutters";
	pixel_y = 22;
	pixel_x = 7
	},
/obj/machinery/atmospherics/pipe/smart/simple/supply/hidden/layer2{
	dir = 4
	},
/turf/open/floor/mineral/plastitanium,
/area/shuttle/exploration)
"kp" = (
/obj/structure/table,
/obj/effect/turf_decal/edges/borderfloor/black/cee,
/obj/item/sbeacondrop/exploration,
/obj/machinery/camera/preset,
/turf/open/floor/mineral/titanium/white,
/area/shuttle/exploration)
"ll" = (
/obj/effect/turf_decal/stripes/line{
	dir = 4
	},
/obj/structure/cable/yellow,
/obj/machinery/power/port_gen/pacman,
/obj/item/stack/sheet/mineral/plasma/five,
/obj/item/wrench,
/turf/open/floor/mineral/plastitanium,
/area/shuttle/exploration)
"mi" = (
/obj/machinery/telecomms/relay/preset/exploration,
/obj/effect/turf_decal/bot,
/turf/open/floor/mineral/plastitanium,
/area/shuttle/exploration)
"oC" = (
/obj/effect/spawner/structure/window/reinforced/shuttle,
/turf/open/floor/plating,
/area/shuttle/exploration)
"oH" = (
/obj/machinery/atmospherics/components/unary/vent_pump/on/layer2{
	dir = 4
	},
/obj/effect/turf_decal/stripes/line,
/obj/structure/chair/fancy/shuttle,
/turf/open/floor/mineral/plastitanium,
/area/shuttle/exploration)
"po" = (
/obj/machinery/light/floor,
/obj/effect/turf_decal/stripes/line,
/obj/machinery/atmospherics/pipe/smart/simple/supply/hidden/layer2{
	dir = 10
	},
/obj/machinery/atmospherics/pipe/smart/simple/scrubbers/hidden/layer4{
	dir = 6
	},
/turf/open/floor/mineral/plastitanium,
/area/shuttle/exploration)
"qa" = (
/obj/effect/turf_decal/stripes/line{
	dir = 4
	},
/obj/structure/cable/yellow{
	icon_state = "2-4"
	},
/turf/open/floor/mineral/plastitanium,
/area/shuttle/exploration)
"qi" = (
/obj/machinery/atmospherics/pipe/smart/simple/purple/visible{
	dir = 10
	},
/obj/machinery/atmospherics/pipe/smart/simple/supply/hidden/layer2{
	dir = 10
	},
/obj/machinery/light/small{
	dir = 4;
	light_color = "#d8b1b1"
	},
/obj/machinery/atmospherics/components/unary/vent_scrubber/on/layer4{
	dir = 8
	},
/turf/open/floor/mineral/plastitanium,
/area/shuttle/exploration)
"qX" = (
/obj/structure/tank_dispenser/oxygen,
/obj/effect/turf_decal/bot,
/obj/structure/railing,
/obj/machinery/light/small{
	brightness = 3;
	dir = 8
	},
/obj/item/holosign_creator/atmos{
	pixel_x = 6;
	pixel_y = 12
	},
/turf/open/floor/mineral/plastitanium,
/area/shuttle/exploration)
"rQ" = (
/obj/effect/turf_decal/edges/borderfloor/black/cee,
/obj/machinery/atmospherics/pipe/smart/simple/supply/hidden/layer2,
/obj/machinery/atmospherics/pipe/smart/simple/scrubbers/hidden/layer4,
/turf/open/floor/mineral/titanium/white,
/area/shuttle/exploration)
"sz" = (
/obj/structure/railing{
	dir = 8
	},
/turf/closed/wall/mineral/titanium,
/area/shuttle/exploration)
"sE" = (
/obj/machinery/modular_computer/console/preset/engineering{
	desc = "A stationary computer. for when the silence is too much to bare.";
	name = "Exploration Console"
	},
/obj/effect/turf_decal/stripes/line,
/obj/effect/turf_decal/bot,
/turf/open/floor/mineral/plastitanium,
/area/shuttle/exploration)
"sT" = (
/obj/effect/turf_decal/stripes/line{
	dir = 10
	},
/obj/structure/railing,
/obj/structure/chair/fancy/shuttle{
	dir = 1
	},
/turf/open/floor/mineral/plastitanium,
/area/shuttle/exploration)
"sY" = (
/obj/effect/turf_decal/stripes/line{
	dir = 8
	},
/obj/structure/chair/fancy/shuttle,
/turf/open/floor/mineral/plastitanium,
/area/shuttle/exploration)
"tq" = (
/obj/machinery/atmospherics/pipe/smart/simple/scrubbers/hidden/layer4,
/obj/machinery/atmospherics/pipe/smart/simple/supply/hidden/layer2,
/obj/machinery/light/floor,
/obj/machinery/door/airlock/titanium,
/turf/open/floor/mineral/plastitanium,
/area/shuttle/exploration)
"ts" = (
/obj/machinery/airalarm/directional/west,
/obj/structure/chair/fancy/shuttle,
/obj/machinery/button/door{
	desc = "A remote control switch.";
	id = "exploration1";
	name = "Exploration Shuttle Shutters";
	pixel_y = 24;
	pixel_w = -9
	},
/obj/machinery/button/door{
	desc = "A remote control switch.";
	id = "exploration2";
	name = "Exploration Shuttle Shutters";
	pixel_y = 24;
	pixel_x = 8
	},
/turf/open/floor/mineral/plastitanium,
/area/shuttle/exploration)
"tz" = (
/turf/closed/wall/mineral/plastitanium/nodiagonal,
/area/shuttle/exploration)
"vc" = (
/obj/effect/turf_decal/edges/borderfloor/black/cee,
/obj/machinery/atmospherics/pipe/smart/manifold/scrubbers/hidden/layer4{
	dir = 8
	},
/obj/machinery/atmospherics/pipe/smart/manifold/supply/hidden/layer2{
	dir = 8
	},
/obj/structure/cable/yellow{
	icon_state = "4-8"
	},
/turf/open/floor/mineral/titanium/white,
/area/shuttle/exploration)
"vd" = (
/obj/effect/turf_decal/stripes/line,
/obj/structure/railing,
/obj/structure/chair/fancy/shuttle{
	dir = 1
	},
/turf/open/floor/mineral/plastitanium,
/area/shuttle/exploration)
"vi" = (
/obj/machinery/door/poddoor/shutters/window{
	id = "exploration3"
	},
/obj/machinery/atmospherics/pipe/smart/simple/purple/visible{
	dir = 4
	},
/obj/machinery/atmospherics/pipe/smart/simple/scrubbers/hidden/layer4{
	dir = 4
	},
/obj/machinery/atmospherics/pipe/smart/simple/supply/hidden/layer2{
	dir = 8
	},
/obj/machinery/button/door{
	desc = "A remote control switch.";
	id = "exploration3";
	name = "Exploration Shuttle Shutters";
	pixel_y = 22;
	pixel_x = -7
	},
/turf/open/floor/mineral/plastitanium,
/area/shuttle/exploration)
"zN" = (
/obj/machinery/computer/shuttle_flight/custom_shuttle/exploration,
/obj/effect/turf_decal/stripes/line,
/obj/effect/turf_decal/bot,
/turf/open/floor/mineral/plastitanium,
/area/shuttle/exploration)
"Ax" = (
/turf/closed/wall/mineral/titanium/nodiagonal,
/area/shuttle/exploration)
"BF" = (
/obj/effect/turf_decal/edges/borderfloor/black/cee,
/obj/structure/cable/yellow{
	icon_state = "4-8"
	},
/obj/machinery/atmospherics/pipe/smart/simple/supply/hidden/layer2{
	dir = 4
	},
/obj/machinery/atmospherics/pipe/smart/simple/scrubbers/hidden/layer4{
	dir = 4
	},
/turf/open/floor/mineral/titanium/white,
/area/shuttle/exploration)
"BX" = (
/obj/effect/turf_decal/stripes/line{
	dir = 8
	},
/obj/structure/cable/yellow{
	icon_state = "2-8"
	},
/obj/machinery/atmospherics/pipe/smart/simple/scrubbers/hidden/layer4{
	dir = 10
	},
/obj/machinery/atmospherics/pipe/smart/simple/supply/hidden/layer2{
	dir = 10
	},
/turf/open/floor/mineral/plastitanium,
/area/shuttle/exploration)
"CU" = (
/obj/machinery/atmospherics/pipe/smart/simple/purple/visible,
/obj/structure/closet/emcloset,
/obj/effect/turf_decal/bot,
/turf/open/floor/mineral/plastitanium,
/area/shuttle/exploration)
"Dl" = (
/obj/machinery/atmospherics/components/unary/vent_scrubber/on/layer4{
	dir = 8
	},
/obj/effect/turf_decal/stripes/line,
/obj/structure/chair/fancy/shuttle,
/turf/open/floor/mineral/plastitanium,
/area/shuttle/exploration)
"DM" = (
/obj/effect/turf_decal/stripes/line{
	dir = 1
	},
/obj/effect/turf_decal/bot,
/obj/machinery/atmospherics/components/unary/portables_connector/visible{
	dir = 4
	},
/obj/machinery/portable_atmospherics/canister/plasma,
/turf/open/floor/mineral/plastitanium,
/area/shuttle/exploration)
"GH" = (
/obj/structure/railing{
	dir = 4
	},
/turf/closed/wall/mineral/titanium,
/area/shuttle/exploration)
"Hf" = (
/obj/effect/turf_decal/edges/borderfloor/black/cee,
/obj/structure/cable/yellow{
	icon_state = "4-8"
	},
/turf/open/floor/mineral/titanium/white,
/area/shuttle/exploration)
"HD" = (
/obj/effect/turf_decal/stripes/line{
	dir = 8
	},
/obj/structure/cable/yellow{
	icon_state = "1-4"
	},
/obj/machinery/atmospherics/pipe/smart/simple/scrubbers/hidden/layer4{
	dir = 5
	},
/obj/machinery/atmospherics/pipe/smart/simple/supply/hidden/layer2{
	dir = 5
	},
/turf/open/floor/mineral/plastitanium,
/area/shuttle/exploration)
"In" = (
/obj/machinery/camera/directional/east,
/obj/effect/turf_decal/stripes/line,
/obj/structure/railing,
/obj/item/storage/box/donkpockets,
/obj/item/storage/box/donkpockets,
/obj/machinery/microwave,
/obj/structure/table,
/obj/machinery/light/small{
	dir = 4
	},
/obj/effect/turf_decal/bot,
/turf/open/floor/mineral/plastitanium,
/area/shuttle/exploration)
"IP" = (
/obj/effect/turf_decal/stripes/line{
	dir = 8
	},
/obj/structure/cable/yellow{
	icon_state = "1-2"
	},
/obj/machinery/atmospherics/pipe/smart/simple/scrubbers/hidden/layer4,
/obj/machinery/atmospherics/pipe/smart/simple/supply/hidden/layer2{
	dir = 1
	},
/turf/open/floor/mineral/plastitanium,
/area/shuttle/exploration)
"IQ" = (
/obj/machinery/computer/crew{
	dir = 1
	},
/obj/structure/railing,
/obj/machinery/camera/preset{
	dir = 4
	},
/obj/effect/turf_decal/bot,
/turf/open/floor/mineral/plastitanium,
/area/shuttle/exploration)
"IS" = (
/obj/effect/turf_decal/edges/borderfloor/black/cee,
/obj/machinery/atmospherics/pipe/smart/simple/scrubbers/hidden/layer4,
/obj/machinery/atmospherics/pipe/smart/simple/supply/hidden/layer2,
/turf/open/floor/mineral/titanium/white,
/area/shuttle/exploration)
"KU" = (
/obj/machinery/atmospherics/components/unary/vent_scrubber/on/layer4{
	dir = 4
	},
/obj/machinery/atmospherics/pipe/smart/simple/supply/hidden/layer2{
	dir = 6
	},
/obj/machinery/atmospherics/pipe/smart/simple/purple/visible{
	dir = 6
	},
/obj/machinery/light/small{
	brightness = 3;
	dir = 8
	},
/turf/open/floor/mineral/plastitanium,
/area/shuttle/exploration)
"LS" = (
/obj/structure/sign/nanotrasen,
/turf/closed/wall/mineral/titanium/nodiagonal,
/area/shuttle/exploration)
"Nc" = (
/obj/effect/turf_decal/stripes/line{
	dir = 4
	},
/obj/structure/chair/fancy/shuttle,
/turf/open/floor/mineral/plastitanium,
/area/shuttle/exploration)
"Nx" = (
/obj/machinery/door/poddoor/shutters/window{
	id = "exploration1"
	},
/obj/machinery/button/door{
	desc = "A remote control switch.";
	id = "exploration1";
	name = "Exploration Shuttle Shutters";
	pixel_y = 22;
	pixel_x = -7
	},
/turf/open/floor/plating,
/area/shuttle/exploration)
"NT" = (
/obj/structure/chair/fancy/shuttle,
/obj/machinery/button/door{
	desc = "A remote control switch.";
	id = "exploration4";
	name = "Exploration Shuttle Shutters";
	pixel_y = 24;
	pixel_x = 9
	},
/obj/machinery/button/door{
	desc = "A remote control switch.";
	id = "exploration3";
	name = "Exploration Shuttle Shutters";
	pixel_y = 24;
	pixel_x = -8
	},
/turf/open/floor/mineral/plastitanium,
/area/shuttle/exploration)
"OE" = (
/obj/structure/chair/fancy/shuttle{
	dir = 1
	},
/turf/open/floor/mineral/plastitanium,
/area/shuttle/exploration)
"OU" = (
/obj/structure/closet/crate/science,
/obj/item/multitool,
/obj/item/storage/toolbox/mechanical,
/obj/item/gps/mining,
/obj/item/stack/sheet/mineral/plasma/five,
/obj/item/circuitboard/computer/shuttle/exploration_shuttle,
/obj/effect/turf_decal/bot,
/obj/machinery/light/small,
/turf/open/floor/mineral/plastitanium,
/area/shuttle/exploration)
"PA" = (
/obj/effect/turf_decal/stripes/line{
	dir = 6
	},
/obj/structure/railing,
/obj/structure/chair/fancy/shuttle{
	dir = 1
	},
/turf/open/floor/mineral/plastitanium,
/area/shuttle/exploration)
"Qb" = (
/obj/effect/turf_decal/stripes/line{
	dir = 1
	},
/obj/machinery/atmospherics/pipe/smart/simple/supply/hidden/layer2,
/obj/machinery/atmospherics/pipe/smart/simple/scrubbers/hidden/layer4,
/obj/machinery/atmospherics/pipe/smart/manifold/purple/visible{
	dir = 1
	},
/turf/open/floor/mineral/plastitanium,
/area/shuttle/exploration)
"Qx" = (
/obj/machinery/power/apc/auto_name/directional/west{
	pixel_x = -24
	},
/obj/effect/turf_decal/stripes/line{
	dir = 4
	},
/obj/structure/cable/yellow{
	icon_state = "0-2"
	},
/obj/structure/cable/yellow{
	icon_state = "1-2"
	},
/turf/open/floor/mineral/plastitanium,
/area/shuttle/exploration)
"Qy" = (
/obj/structure/closet/crate,
/obj/item/wrench,
/obj/item/pickaxe,
/obj/item/mining_scanner,
/obj/item/radio/headset/headset_exploration,
/obj/item/radio/headset/headset_exploration,
/obj/effect/turf_decal/bot,
/obj/machinery/atmospherics/pipe/smart/simple/purple/visible,
/obj/item/wrench,
/turf/open/floor/mineral/plastitanium,
/area/shuttle/exploration)
"Rk" = (
/obj/structure/window/reinforced/survival_pod/spawner/directional/north,
/obj/machinery/atmospherics/components/unary/shuttle/heater{
	dir = 1
	},
/turf/open/floor/plating,
/area/shuttle/exploration)
"Rp" = (
/obj/effect/turf_decal/bot,
/obj/machinery/gear_requisition/exploration,
/turf/open/floor/mineral/plastitanium,
/area/shuttle/exploration)
"RQ" = (
/turf/template_noop,
/area/template_noop)
"SA" = (
/obj/effect/turf_decal/delivery,
/obj/structure/closet/crate/secure/weapon,
/obj/item/firing_pin/clown,
/obj/machinery/atmospherics/pipe/smart/simple/purple/visible,
/turf/open/floor/mineral/plastitanium,
/area/shuttle/exploration)
"UB" = (
/obj/structure/railing{
	dir = 8
	},
/turf/open/floor/mineral/plastitanium,
/area/shuttle/exploration)
"Vj" = (
/obj/machinery/door/poddoor/shutters/window{
	id = "exploration4"
	},
/obj/machinery/button/door{
	desc = "A remote control switch.";
	id = "exploration4";
	name = "Exploration Shuttle Shutters";
	pixel_y = 22;
	pixel_x = 7
	},
/turf/open/floor/plating,
/area/shuttle/exploration)
"Vl" = (
/turf/closed/wall/mineral/plastitanium,
/area/shuttle/exploration)
"Wp" = (
/obj/structure/table,
/obj/machinery/recharger,
/obj/effect/turf_decal/edges/borderfloor/black/cee,
/turf/open/floor/mineral/titanium/white,
/area/shuttle/exploration)
"Xj" = (
/obj/machinery/atmospherics/pipe/smart/simple/scrubbers/hidden/layer4{
	dir = 4
	},
/obj/machinery/atmospherics/pipe/smart/simple/supply/hidden/layer2{
	dir = 4
	},
/obj/machinery/atmospherics/pipe/smart/manifold/purple/visible{
	dir = 1
	},
/turf/open/floor/mineral/plastitanium,
/area/shuttle/exploration)
"XI" = (
/obj/structure/railing{
	dir = 4
	},
/turf/open/floor/mineral/plastitanium,
/area/shuttle/exploration)
"Yi" = (
/obj/machinery/atmospherics/pipe/smart/simple/purple/visible,
/obj/machinery/atmospherics/components/unary/vent_pump/on/layer2{
	dir = 1
	},
/turf/open/floor/mineral/plastitanium,
/area/shuttle/exploration)
"ZX" = (
/obj/docking_port/mobile{
	dir = 8;
	dwidth = 6;
	height = 9;
	id = "exploration";
	name = "Exploration Shuttle";
	port_direction = 4;
	shuttle_object_type = /datum/orbital_object/shuttle/custom_shuttle;
	width = 17
	},
/obj/structure/cable/yellow{
	icon_state = "4-8"
	},
/obj/machinery/door/airlock/external/glass,
/obj/machinery/atmospherics/pipe/smart/simple/scrubbers/hidden/layer4{
	dir = 4
	},
/obj/machinery/atmospherics/pipe/smart/simple/supply/hidden/layer2{
	dir = 4
	},
/obj/structure/fans/tiny,
/turf/open/floor/mineral/plastitanium,
/area/shuttle/exploration)

(1,1,1) = {"
RQ
RQ
RQ
da
sz
UB
sz
da
oC
da
oC
da
da
Nx
Vl
Vl
RQ
"}
(2,1,1) = {"
da
da
da
da
da
da
Ax
qX
qa
Qx
ll
oC
KU
Yi
CU
Rk
hl
"}
(3,1,1) = {"
RQ
oC
oC
da
Rp
Ax
ts
vd
Hf
Ax
Ax
Ax
jR
da
Vl
Vl
Vl
"}
(4,1,1) = {"
RQ
oC
zN
ir
oH
cH
Nc
PA
Hf
kp
da
DM
Xj
SA
Rk
hl
RQ
"}
(5,1,1) = {"
RQ
oC
sE
OE
po
cg
rQ
rQ
vc
IS
tq
Qb
hY
OU
Vl
RQ
RQ
"}
(6,1,1) = {"
RQ
oC
aR
ir
Dl
IQ
sY
sT
BF
Wp
da
fF
Xj
Qy
Rk
hl
RQ
"}
(7,1,1) = {"
RQ
oC
oC
da
mi
Ax
NT
vd
BF
Ax
Ax
Ax
vi
da
Vl
tz
Vl
"}
(8,1,1) = {"
da
da
da
da
da
da
LS
In
BX
IP
HD
oC
qi
Yi
CU
Rk
hl
"}
(9,1,1) = {"
RQ
RQ
RQ
da
GH
XI
GH
da
oC
da
ZX
da
da
Vj
Vl
Vl
RQ
"}
