//MAP CONVERTED BY dmm2tgm.py THIS HEADER COMMENT PREVENTS RECONVERSION, DO NOT REMOVE
"ao" = (
/obj/effect/turf_decal/tile/blue/opposingcorners,
/obj/machinery/light,
/obj/machinery/button/door{
	desc = "A remote control switch.";
	id = "exploration";
	name = "Exploration Shuttle Shutters";
	pixel_y = -24;
	pixel_x = -6
	},
/obj/structure/cable/orange{
	icon_state = "4-8"
	},
/obj/machinery/button/door/directional/west{
	id = "explo_holo";
	name = "Holofield Button";
	pixel_x = 6;
	pixel_y = -24
	},
/turf/open/floor/mineral/titanium/white,
/area/shuttle/exploration)
"aT" = (
/obj/effect/turf_decal/tile/blue/opposingcorners,
/obj/machinery/light,
/obj/effect/mapping_helpers/airalarm/unlocked,
/obj/machinery/airalarm/directional/south,
/obj/structure/tank_dispenser/oxygen,
/turf/open/floor/mineral/titanium/white,
/area/shuttle/exploration)
"aY" = (
/obj/effect/turf_decal/tile/neutral/opposingcorners,
/obj/effect/turf_decal/siding/dark/corner{
	dir = 4
	},
/turf/open/floor/mineral/plastitanium,
/area/shuttle/exploration)
"dt" = (
/obj/machinery/atmospherics/pipe/smart/manifold/purple/visible{
	dir = 1
	},
/turf/open/floor/catwalk_floor,
/area/shuttle/exploration)
"gk" = (
/obj/structure/table/reinforced,
/obj/effect/turf_decal/tile/neutral/opposingcorners,
/obj/effect/turf_decal/siding/dark{
	dir = 8
	},
/obj/item/flashlight/lamp/green{
	on = 0;
	pixel_x = -3;
	pixel_y = 8
	},
/turf/open/floor/mineral/plastitanium,
/area/shuttle/exploration)
"gl" = (
/obj/effect/turf_decal/delivery,
/obj/effect/turf_decal/stripes/closeup{
	dir = 1
	},
/obj/structure/cable/orange{
	icon_state = "0-4"
	},
/obj/structure/cable/orange{
	icon_state = "1-4"
	},
/obj/machinery/door/poddoor/shutters{
	id = "exploration"
	},
/obj/machinery/power/shieldwallgen/atmos{
	dir = 1;
	id = "explo_holo"
	},
/turf/open/floor/plating,
/area/shuttle/exploration)
"gO" = (
/obj/structure/table/reinforced,
/obj/effect/turf_decal/tile/neutral/opposingcorners,
/obj/effect/turf_decal/siding/dark{
	dir = 4
	},
/obj/machinery/recharger{
	pixel_x = -6
	},
/obj/machinery/recharger{
	pixel_x = 6
	},
/turf/open/floor/mineral/plastitanium,
/area/shuttle/exploration)
"hz" = (
/obj/machinery/light{
	dir = 8
	},
/obj/effect/turf_decal/siding/dark{
	dir = 10
	},
/obj/effect/turf_decal/tile/neutral/opposingcorners,
/obj/machinery/vendor/exploration,
/turf/open/floor/mineral/plastitanium,
/area/shuttle/exploration)
"iU" = (
/obj/machinery/power/smes,
/obj/structure/cable/orange{
	icon_state = "0-8"
	},
/turf/open/floor/plating,
/area/shuttle/exploration)
"km" = (
/obj/effect/turf_decal/tile/brown/opposingcorners,
/obj/structure/cable/yellow{
	icon_state = "4-8"
	},
/turf/open/floor/mineral/titanium/yellow,
/area/shuttle/exploration)
"nI" = (
/obj/machinery/atmospherics/components/unary/plasma_refiner{
	dir = 8
	},
/obj/effect/turf_decal/delivery,
/obj/effect/turf_decal/tile/brown/opposingcorners,
/turf/open/floor/mineral/titanium/yellow,
/area/shuttle/exploration)
"nZ" = (
/obj/machinery/computer/objective,
/obj/effect/turf_decal/tile/neutral/opposingcorners,
/obj/effect/turf_decal/siding/dark{
	dir = 1
	},
/turf/open/floor/mineral/plastitanium,
/area/shuttle/exploration)
"pY" = (
/obj/effect/turf_decal/tile/blue/opposingcorners,
/turf/open/floor/mineral/titanium/white,
/area/shuttle/exploration)
"qZ" = (
/obj/machinery/door/airlock/external/glass{
	req_one_access_txt = "49";
	name = "Exploration Shuttle"
	},
/obj/docking_port/mobile{
	dir = 4;
	dwidth = 10;
	height = 8;
	id = "exploration";
	name = "Exploration Shuttle";
	port_direction = 8;
	shuttle_object_type = /datum/orbital_object/shuttle/custom_shuttle;
	width = 14
	},
/obj/effect/turf_decal/stripes/closeup{
	dir = 1
	},
/obj/structure/cable/yellow{
	icon_state = "4-8"
	},
/turf/open/floor/mineral/plastitanium,
/area/shuttle/exploration)
"si" = (
/obj/structure/sign/warning/fire,
/turf/closed/wall/mineral/plastitanium/nodiagonal,
/area/shuttle/exploration)
"uE" = (
/obj/effect/turf_decal/tile/blue/opposingcorners,
/obj/structure/cable/orange{
	icon_state = "2-8"
	},
/turf/open/floor/mineral/titanium/white,
/area/shuttle/exploration)
"uU" = (
/obj/structure/window/reinforced/survival_pod{
	dir = 1
	},
/obj/machinery/atmospherics/components/unary/shuttle/heater{
	dir = 1
	},
/turf/open/floor/plating,
/area/shuttle/exploration)
"uX" = (
/obj/structure/cable/yellow{
	icon_state = "4-8"
	},
/obj/effect/turf_decal/tile/brown/opposingcorners,
/turf/open/floor/mineral/titanium/yellow,
/area/shuttle/exploration)
"vf" = (
/obj/structure/sign/nanotrasen,
/turf/closed/wall/mineral/titanium,
/area/shuttle/exploration)
"vC" = (
/obj/effect/turf_decal/tile/blue/opposingcorners,
/obj/machinery/firealarm/directional/north,
/turf/open/floor/mineral/titanium/white,
/area/shuttle/exploration)
"wn" = (
/obj/machinery/firealarm/directional/east,
/obj/machinery/power/terminal{
	dir = 1
	},
/obj/structure/cable/yellow{
	icon_state = "0-8"
	},
/obj/machinery/power/port_gen/pacman,
/turf/open/floor/plating,
/area/shuttle/exploration)
"wE" = (
/obj/effect/turf_decal/tile/neutral/opposingcorners,
/obj/structure/chair/fancy/shuttle{
	dir = 1
	},
/turf/open/floor/mineral/plastitanium,
/area/shuttle/exploration)
"wG" = (
/turf/closed/wall/mineral/titanium,
/area/shuttle/exploration)
"xT" = (
/obj/effect/turf_decal/tile/brown/opposingcorners,
/obj/structure/cable/orange{
	icon_state = "4-8"
	},
/turf/open/floor/mineral/titanium/yellow,
/area/shuttle/exploration)
"AE" = (
/turf/closed/wall/mineral/titanium/nodiagonal,
/area/shuttle/exploration)
"AZ" = (
/obj/effect/spawner/structure/window/shuttle,
/turf/open/floor/plating,
/area/shuttle/exploration)
"Bk" = (
/obj/machinery/computer/shuttle_flight/custom_shuttle/exploration,
/obj/effect/turf_decal/tile/neutral/opposingcorners,
/obj/effect/turf_decal/siding/dark{
	dir = 1
	},
/turf/open/floor/mineral/plastitanium,
/area/shuttle/exploration)
"Dr" = (
/obj/machinery/door/airlock/shuttle{
	req_one_access_txt = "49";
	name = "Cockpit"
	},
/obj/effect/turf_decal/stripes/closeup,
/obj/machinery/door/firedoor,
/turf/open/floor/mineral/plastitanium,
/area/shuttle/exploration)
"Fy" = (
/obj/machinery/microwave{
	pixel_y = 6
	},
/obj/structure/table/reinforced,
/obj/effect/turf_decal/siding/dark{
	dir = 9
	},
/obj/effect/turf_decal/tile/neutral/opposingcorners,
/turf/open/floor/mineral/plastitanium,
/area/shuttle/exploration)
"Gr" = (
/obj/effect/turf_decal/delivery,
/obj/effect/turf_decal/stripes/closeup{
	dir = 1
	},
/obj/structure/cable/orange{
	icon_state = "1-2"
	},
/obj/machinery/door/poddoor/shutters{
	id = "exploration"
	},
/turf/open/floor/plating,
/area/shuttle/exploration)
"HS" = (
/obj/structure/chair/fancy/shuttle,
/obj/effect/turf_decal/siding/dark{
	dir = 5
	},
/turf/open/floor/mineral/plastitanium,
/area/shuttle/exploration)
"HX" = (
/obj/effect/turf_decal/tile/neutral/opposingcorners,
/obj/effect/turf_decal/siding/dark,
/turf/open/floor/mineral/plastitanium,
/area/shuttle/exploration)
"Ij" = (
/obj/machinery/light{
	dir = 4
	},
/obj/effect/turf_decal/siding/dark{
	dir = 6
	},
/obj/effect/turf_decal/tile/neutral/opposingcorners,
/obj/machinery/firealarm/directional/east,
/obj/machinery/airalarm/directional/south,
/obj/effect/mapping_helpers/airalarm/unlocked,
/obj/structure/closet/crate/secure/weapon/contraband,
/turf/open/floor/mineral/plastitanium,
/area/shuttle/exploration)
"In" = (
/obj/structure/table/reinforced,
/obj/item/tank/internals/emergency_oxygen/engi{
	pixel_x = -10;
	pixel_y = 3
	},
/obj/item/storage/toolbox/emergency,
/obj/item/radio{
	pixel_x = 7;
	pixel_y = 8
	},
/obj/effect/turf_decal/tile/neutral/opposingcorners,
/obj/effect/turf_decal/siding/dark{
	dir = 5
	},
/turf/open/floor/mineral/plastitanium,
/area/shuttle/exploration)
"IE" = (
/obj/machinery/door/firedoor,
/turf/open/floor/catwalk_floor/titanium,
/area/shuttle/exploration)
"JR" = (
/obj/effect/turf_decal/tile/neutral/opposingcorners,
/obj/effect/turf_decal/siding/dark/corner{
	dir = 1
	},
/obj/effect/decal/cleanable/blood/old,
/turf/open/floor/mineral/plastitanium,
/area/shuttle/exploration)
"NL" = (
/obj/structure/lattice/catwalk,
/obj/item/stack/marker_beacon{
	anchored = 1;
	icon_state = "markerburgundy-on";
	light_color = "#FA644B";
	light_power = 3;
	light_range = 2;
	name = "landing marker";
	picked_color = "Burgundy"
	},
/turf/template_noop,
/area/shuttle/exploration)
"OZ" = (
/obj/effect/turf_decal/delivery,
/obj/effect/turf_decal/stripes/closeup{
	dir = 1
	},
/obj/structure/cable/orange{
	icon_state = "0-2"
	},
/obj/machinery/door/poddoor/shutters{
	id = "exploration"
	},
/obj/machinery/power/shieldwallgen/atmos{
	id = "explo_holo"
	},
/turf/open/floor/plating,
/area/shuttle/exploration)
"Pb" = (
/obj/effect/turf_decal/tile/blue/opposingcorners,
/obj/structure/closet/crate/bin,
/obj/item/toy/beach_ball,
/obj/item/bikehorn/rubberducky,
/obj/item/trash/pistachios,
/turf/open/floor/mineral/titanium/white,
/area/shuttle/exploration)
"PK" = (
/obj/machinery/shuttle/engine/plasma{
	dir = 1
	},
/turf/open/floor/plating,
/area/shuttle/exploration)
"PO" = (
/obj/effect/turf_decal/tile/blue/opposingcorners,
/obj/structure/closet/crate/science/shuttle,
/turf/open/floor/mineral/titanium/white,
/area/shuttle/exploration)
"Qu" = (
/obj/machinery/telecomms/relay/preset/exploration,
/obj/effect/turf_decal/delivery,
/obj/effect/turf_decal/siding/dark{
	dir = 5
	},
/turf/open/floor/mineral/plastitanium,
/area/shuttle/exploration)
"Rb" = (
/obj/machinery/power/apc/auto_name/directional/north,
/obj/structure/cable/orange{
	icon_state = "0-4"
	},
/obj/effect/turf_decal/tile/brown/opposingcorners,
/obj/structure/closet/crate/science/mining,
/turf/open/floor/mineral/titanium/yellow,
/area/shuttle/exploration)
"SQ" = (
/obj/effect/turf_decal/siding/dark,
/obj/machinery/holopad{
	pixel_x = 15
	},
/obj/effect/turf_decal/tile/neutral/fourcorners/contrasted,
/obj/effect/turf_decal/box/corners{
	dir = 1
	},
/obj/effect/turf_decal/box/corners{
	dir = 8
	},
/turf/open/floor/mineral/plastitanium,
/area/shuttle/exploration)
"TQ" = (
/obj/machinery/atmospherics/components/unary/portables_connector/visible{
	dir = 4
	},
/obj/machinery/light{
	dir = 8;
	light_color = "#e8eaff"
	},
/obj/effect/turf_decal/tile/brown/opposingcorners,
/obj/effect/turf_decal/box,
/obj/machinery/airalarm/directional/west,
/obj/effect/mapping_helpers/airalarm/unlocked,
/obj/machinery/portable_atmospherics/canister/plasma,
/turf/open/floor/mineral/titanium/yellow,
/area/shuttle/exploration)
"TZ" = (
/obj/structure/table/reinforced,
/obj/item/storage/box/donkpockets,
/obj/item/storage/box/donkpockets/donkpockethonk{
	pixel_x = 5;
	pixel_y = 5
	},
/obj/effect/turf_decal/tile/neutral/opposingcorners,
/obj/effect/turf_decal/siding/dark{
	dir = 9
	},
/turf/open/floor/mineral/plastitanium,
/area/shuttle/exploration)
"Vg" = (
/turf/closed/wall/mineral/plastitanium,
/area/shuttle/exploration)
"VA" = (
/obj/structure/chair/fancy/shuttle,
/obj/effect/turf_decal/siding/dark{
	dir = 9
	},
/turf/open/floor/mineral/plastitanium,
/area/shuttle/exploration)
"VH" = (
/obj/effect/turf_decal/siding/dark,
/obj/effect/turf_decal/tile/neutral/fourcorners/contrasted,
/obj/effect/turf_decal/box/corners{
	dir = 4
	},
/obj/effect/turf_decal/box/corners,
/turf/open/floor/mineral/plastitanium,
/area/shuttle/exploration)
"WG" = (
/obj/machinery/door/firedoor,
/obj/structure/cable/orange{
	icon_state = "1-2"
	},
/turf/open/floor/catwalk_floor/titanium,
/area/shuttle/exploration)
"XD" = (
/obj/structure/chair/fancy/shuttle{
	dir = 1
	},
/obj/effect/turf_decal/siding/dark{
	dir = 10
	},
/turf/open/floor/mineral/plastitanium,
/area/shuttle/exploration)
"XZ" = (
/obj/effect/decal/cleanable/blood/old,
/obj/effect/turf_decal/tile/blue/opposingcorners,
/turf/open/floor/mineral/titanium/white,
/area/shuttle/exploration)
"Ze" = (
/obj/structure/chair/fancy/shuttle{
	dir = 1
	},
/obj/effect/turf_decal/siding/dark{
	dir = 6
	},
/turf/open/floor/mineral/plastitanium,
/area/shuttle/exploration)
"ZG" = (
/obj/effect/turf_decal/tile/brown/opposingcorners,
/obj/structure/cable/orange{
	icon_state = "1-4"
	},
/obj/structure/cable/orange{
	icon_state = "4-8"
	},
/turf/open/floor/mineral/titanium/yellow,
/area/shuttle/exploration)

(1,1,1) = {"
NL
AZ
wG
wG
vf
OZ
Gr
gl
wG
AZ
qZ
AE
Vg
NL
"}
(2,1,1) = {"
AZ
AZ
Fy
hz
wG
vC
pY
ao
wG
Rb
km
TQ
si
Vg
"}
(3,1,1) = {"
AZ
TZ
JR
HX
Dr
pY
pY
uE
WG
ZG
uX
dt
uU
PK
"}
(4,1,1) = {"
AZ
Bk
wE
SQ
AZ
VA
gk
XD
IE
xT
km
dt
uU
PK
"}
(5,1,1) = {"
AZ
nZ
wE
VH
AZ
HS
gO
Ze
IE
xT
km
dt
uU
PK
"}
(6,1,1) = {"
AZ
In
aY
HX
Dr
pY
XZ
pY
IE
xT
km
dt
uU
PK
"}
(7,1,1) = {"
AZ
AZ
Qu
Ij
wG
Pb
PO
aT
wG
iU
wn
nI
si
Vg
"}
(8,1,1) = {"
NL
AZ
AZ
wG
vf
AZ
AZ
AZ
wG
wG
wG
AE
Vg
NL
"}
