//MAP CONVERTED BY dmm2tgm.py THIS HEADER COMMENT PREVENTS RECONVERSION, DO NOT REMOVE
"bz" = (
/obj/structure/table,
/turf/open/floor/mineral/titanium,
/area/shuttle/exploration)
"cu" = (
/obj/structure/lattice/catwalk,
/obj/machinery/atmospherics/components/unary/outlet_injector/on,
/turf/template_noop,
/area/shuttle/exploration)
"cx" = (
/obj/machinery/airalarm/unlocked{
	dir = 1;
	pixel_y = -25
	},
/turf/open/floor/mineral/titanium,
/area/shuttle/exploration)
"da" = (
/turf/closed/wall/mineral/titanium,
/area/shuttle/exploration)
"es" = (
/obj/effect/turf_decal/bot,
/obj/structure/closet/emcloset/anchored,
/turf/open/floor/mineral/titanium,
/area/shuttle/exploration)
"fh" = (
/obj/machinery/atmospherics/components/unary/vent_scrubber/on/layer4{
	dir = 4
	},
/turf/open/floor/mineral/titanium,
/area/shuttle/exploration)
"fC" = (
/obj/effect/turf_decal/stripes/line,
/obj/effect/turf_decal/stripes/line{
	dir = 1
	},
/obj/machinery/door/firedoor,
/obj/machinery/door/airlock/shuttle/glass,
/turf/open/floor/mineral/plastitanium,
/area/shuttle/exploration)
"gl" = (
/obj/effect/turf_decal/stripes/line{
	dir = 1
	},
/obj/structure/cable/yellow{
	icon_state = "4-8"
	},
/obj/effect/turf_decal/bot,
/obj/machinery/portable_atmospherics/canister/plasma,
/obj/machinery/firealarm/directional/north,
/turf/open/floor/mineral/titanium,
/area/shuttle/exploration)
"go" = (
/obj/machinery/light/small{
	dir = 8
	},
/obj/effect/turf_decal/delivery,
/obj/machinery/telecomms/relay/preset/mining,
/obj/machinery/door/window/eastright,
/obj/structure/window/reinforced,
/obj/structure/window/reinforced{
	dir = 1
	},
/turf/open/floor/mineral/titanium,
/area/shuttle/exploration)
"gM" = (
/obj/machinery/computer/arcade/orion_trail,
/turf/open/floor/mineral/titanium,
/area/shuttle/exploration)
"gP" = (
/obj/structure/cable/yellow{
	icon_state = "2-4"
	},
/obj/machinery/atmospherics/pipe/manifold/supply/hidden/layer2{
	dir = 8
	},
/obj/machinery/atmospherics/pipe/manifold/scrubbers/hidden/layer4{
	dir = 8
	},
/turf/open/floor/mineral/titanium,
/area/shuttle/exploration)
"hl" = (
/obj/machinery/shuttle/engine/plasma{
	dir = 1
	},
/turf/open/floor/plating,
/area/shuttle/exploration)
"ii" = (
/obj/effect/turf_decal/stripes/line{
	dir = 1
	},
/obj/structure/cable/yellow{
	icon_state = "0-8"
	},
/obj/machinery/power/apc/auto_name/north,
/obj/structure/cable/yellow{
	icon_state = "4-8"
	},
/obj/effect/turf_decal/bot,
/obj/machinery/portable_atmospherics/canister/plasma,
/obj/structure/railing{
	dir = 8
	},
/obj/merge_conflict_marker{
	name = "---Merge Conflict Marker---";
	
	desc = "A best-effort merge was performed. You must resolve this conflict yourself (manually) and remove this object once complete."
	},
/obj/effect/turf_decal/stripes/line{
	dir = 1
	},
/obj/structure/cable/yellow{
	icon_state = "0-8"
	},
/obj/machinery/power/apc/auto_name/directional/east,
/obj/machinery/atmospherics/pipe/manifold/supply/hidden{
	dir = 8
	},
/turf/open/floor/mineral/titanium,
/area/shuttle/exploration)
"ir" = (
/turf/open/floor/mineral/plastitanium,
/area/shuttle/exploration)
"jq" = (
/obj/machinery/atmospherics/components/unary/portables_connector/visible,
/obj/machinery/light/small{
	dir = 4
	},
/turf/open/floor/mineral/titanium,
/area/shuttle/exploration)
"jH" = (
/obj/structure/chair/fancy/shuttle{
	dir = 1
	},
/turf/open/floor/mineral/plastitanium,
/area/shuttle/exploration)
"jI" = (
/obj/effect/turf_decal/stripes/line{
	dir = 1
	},
/obj/structure/cable/yellow{
	icon_state = "1-4"
	},
/obj/machinery/atmospherics/pipe/simple/supply/hidden/layer2,
/obj/machinery/atmospherics/pipe/simple/scrubbers/hidden/layer4,
/turf/open/floor/mineral/titanium,
/area/shuttle/exploration)
"ld" = (
/obj/machinery/atmospherics/pipe/simple/purple/visible{
	dir = 9
	},
/obj/structure/tank_dispenser/oxygen,
/obj/effect/turf_decal/delivery,
/turf/open/floor/mineral/titanium,
/area/shuttle/exploration)
"le" = (
/obj/machinery/atmospherics/pipe/manifold/purple/visible{
	dir = 1
	},
/obj/structure/closet/crate/science/mining,
/obj/effect/turf_decal/bot,
/turf/open/floor/mineral/titanium,
/area/shuttle/exploration)
"lF" = (
/obj/machinery/suit_storage_unit/open,
/turf/open/floor/mineral/titanium,
/area/shuttle/exploration)
"mt" = (
/obj/structure/table,
/obj/item/paper/crumpled{
	default_raw_text = "<p>I bought you some food, but I ate it all before you came, sorry.</p><p>- RTH</p>";
	name = "scribbled note"
	},
/obj/machinery/recharger,
/turf/open/floor/mineral/titanium,
/area/shuttle/exploration)
"mQ" = (
/obj/machinery/firealarm/directional/west,
/obj/structure/closet/crate/bin,
/obj/machinery/light{
	dir = 8
	},
/turf/open/floor/mineral/titanium,
/area/shuttle/exploration)
"nk" = (
/obj/item/radio/intercom{
	frequency = 1453;
	pixel_y = -30
	},
/obj/machinery/light/small{
	dir = 8
	},
/turf/open/floor/mineral/plastitanium,
/area/shuttle/exploration)
"nA" = (
/obj/structure/cable/yellow{
	icon_state = "4-8"
	},
/obj/docking_port/mobile{
	dir = 8;
	dwidth = 6;
	height = 8;
	id = "exploration";
	name = "Exploration Shuttle";
	port_direction = 4;
	shuttle_object_type = /datum/orbital_object/shuttle/custom_shuttle;
	width = 16
	},
/obj/machinery/atmospherics/pipe/simple/supply/hidden/layer2{
	dir = 4
	},
/obj/machinery/atmospherics/pipe/simple/scrubbers/hidden/layer4{
	dir = 9
	},
/obj/machinery/door/airlock/external{
	req_access_txt = "49";
	name = "Exploration Shuttle airlock"
	},
/turf/open/floor/mineral/titanium,
/area/shuttle/exploration)
"op" = (
/obj/machinery/atmospherics/pipe/manifold/purple/visible{
	dir = 1
	},
/obj/structure/closet/crate/secure/weapon/contraband,
/obj/effect/turf_decal/bot,
/turf/open/floor/mineral/titanium,
/area/shuttle/exploration)
"oC" = (
/obj/effect/spawner/structure/window/shuttle,
/turf/open/floor/plating,
/area/shuttle/exploration)
"pd" = (
/obj/effect/turf_decal/stripes/line{
	dir = 1
	},
/obj/machinery/atmospherics/components/unary/tank/air{
	dir = 1;
	initialize_directions = 1;
	piping_layer = 2
	},
/obj/effect/turf_decal/delivery,
/turf/open/floor/mineral/titanium,
/area/shuttle/exploration)
"po" = (
/obj/machinery/computer/crew,
/turf/open/floor/mineral/plastitanium,
/area/shuttle/exploration)
"pW" = (
/obj/machinery/advanced_airlock_controller/directional/south,
/obj/structure/cable/yellow{
	icon_state = "4-8"
	},
/obj/machinery/atmospherics/pipe/simple/supply/hidden/layer2{
	dir = 8
	},
/obj/machinery/atmospherics/pipe/simple/scrubbers/hidden/layer4{
	dir = 8
	},
/turf/open/floor/mineral/titanium,
/area/shuttle/exploration)
"qb" = (
/obj/structure/chair/fancy/shuttle,
/turf/open/floor/mineral/titanium,
/area/shuttle/exploration)
"rg" = (
/obj/machinery/atmospherics/components/unary/plasma_refiner{
	dir = 4
	},
/turf/open/floor/mineral/titanium,
/area/shuttle/exploration)
"ri" = (
/obj/machinery/atmospherics/pipe/simple/scrubbers/hidden/layer4{
	dir = 4
	},
/obj/machinery/vendor/exploration,
/obj/merge_conflict_marker{
	name = "---Merge Conflict Marker---";
	
	desc = "A best-effort merge was performed. You must resolve this conflict yourself (manually) and remove this object once complete."
	},
/obj/machinery/airalarm/directional/north{
	pixel_y = 23
	},
/obj/machinery/atmospherics/pipe/simple/scrubbers/hidden{
	dir = 4
	},
/obj/structure/chair/fancy/shuttle,
/turf/open/floor/mineral/titanium,
/area/shuttle/exploration)
"so" = (
/obj/machinery/newscaster{
	pixel_x = -25
	},
/obj/machinery/suit_storage_unit/open,
/turf/open/floor/mineral/titanium,
/area/shuttle/exploration)
"sT" = (
/obj/structure/chair/fancy/shuttle{
	dir = 1
	},
/turf/open/floor/mineral/titanium,
/area/shuttle/exploration)
"ty" = (
/obj/machinery/computer/objective,
/turf/open/floor/mineral/plastitanium,
/area/shuttle/exploration)
"tz" = (
/turf/closed/wall/mineral/plastitanium/nodiagonal,
/area/shuttle/exploration)
"uc" = (
/obj/structure/cable/yellow{
	icon_state = "4-8"
	},
/obj/machinery/atmospherics/pipe/simple/supply/hidden/layer2{
	dir = 8
	},
/obj/machinery/atmospherics/pipe/simple/scrubbers/hidden/layer4{
	dir = 8
	},
/turf/open/floor/mineral/titanium,
/area/shuttle/exploration)
"ut" = (
/obj/machinery/atmospherics/pipe/simple/scrubbers/hidden/layer4{
	dir = 9
	},
/obj/structure/table,
/obj/machinery/microwave,
/turf/open/floor/mineral/titanium,
/area/shuttle/exploration)
"yN" = (
/obj/effect/spawner/structure/window/shuttle,
/obj/machinery/atmospherics/pipe/simple/scrubbers/hidden/layer4{
	dir = 6
	},
/turf/open/floor/plating,
/area/shuttle/exploration)
"Aj" = (
/obj/machinery/atmospherics/pipe/manifold/purple/visible{
	dir = 1
	},
/obj/effect/turf_decal/bot,
/turf/open/floor/mineral/titanium,
/area/shuttle/exploration)
"Aq" = (
/obj/machinery/atmospherics/pipe/simple/supply/hidden/layer2{
	dir = 9
	},
/obj/machinery/atmospherics/pipe/simple/scrubbers/hidden/layer4{
	dir = 5
	},
/turf/open/floor/mineral/titanium,
/area/shuttle/exploration)
"Ax" = (
/turf/closed/wall/mineral/titanium/nodiagonal,
/area/shuttle/exploration)
"AX" = (
/obj/structure/table,
/obj/item/storage/box/donkpockets,
/turf/open/floor/mineral/titanium,
/area/shuttle/exploration)
"BA" = (
/obj/effect/turf_decal/stripes/line{
	dir = 1
	},
/turf/open/floor/mineral/titanium,
/area/shuttle/exploration)
"DV" = (
/obj/machinery/atmospherics/components/unary/vent_pump/on/layer2{
	dir = 4
	},
/turf/open/floor/mineral/titanium,
/area/shuttle/exploration)
"Gg" = (
/obj/machinery/atmospherics/pipe/simple/supply/hidden/layer2,
/obj/machinery/atmospherics/pipe/simple/scrubbers/hidden/layer4,
/turf/open/floor/mineral/titanium,
/area/shuttle/exploration)
"Hc" = (
/obj/structure/cable/yellow{
	icon_state = "4-8"
	},
/obj/machinery/atmospherics/pipe/simple/supply/hidden/layer2{
	dir = 8
	},
/obj/machinery/atmospherics/pipe/simple/scrubbers/hidden/layer4{
	dir = 8
	},
/obj/machinery/light,
/turf/open/floor/mineral/titanium,
/area/shuttle/exploration)
"Hf" = (
/turf/open/floor/mineral/titanium,
/area/shuttle/exploration)
"IW" = (
/obj/item/radio/intercom{
	frequency = 1453;
	pixel_y = 24
	},
/obj/machinery/atmospherics/pipe/simple/scrubbers/hidden/layer4{
	dir = 6
	},
/turf/open/floor/mineral/titanium,
/area/shuttle/exploration)
"LC" = (
/obj/structure/cable/yellow{
	icon_state = "1-2"
	},
/obj/machinery/atmospherics/pipe/simple/supply/hidden/layer2,
/obj/machinery/atmospherics/pipe/simple/scrubbers/hidden/layer4,
/obj/machinery/door/firedoor,
/obj/machinery/door/airlock/shuttle/glass{
	autoclose = 0.1;
	name = "Exploration Engine";
	req_access_txt = "49"
	},
/turf/open/floor/mineral/titanium,
/area/shuttle/exploration)
"MU" = (
/mob/living/simple_animal/chicken/turkey{
	atmos_requirements = list("min_oxy" = 0, "max_oxy" = 0, "min_tox" = 0, "max_tox" = 0, "min_co2" = 0, "max_co2" = 0, "min_n2" = 0, "max_n2" = 0);
	desc = "A veteran of Nanotrasen's Animal Experimentation Program that attempted to replicate the organic space suit that some hostile entities are known to have exhibited, Tom now serves Nanotrasen as the mascot of the Exploration Crew.";
	health = 200;
	maxHealth = 200;
	melee_damage = 5;
	minbodytemp = 2.7;
	name = "Tom"
	},
/obj/machinery/atmospherics/pipe/simple/supply/hidden/layer2,
/obj/machinery/atmospherics/pipe/manifold/scrubbers/hidden/layer4{
	dir = 4
	},
/turf/open/floor/mineral/titanium,
/area/shuttle/exploration)
"OJ" = (
/obj/effect/turf_decal/stripes/line{
	dir = 1
	},
/obj/machinery/power/port_gen/pacman,
/obj/structure/cable/yellow{
	icon_state = "0-8"
	},
/turf/open/floor/mineral/titanium,
/area/shuttle/exploration)
"PT" = (
/obj/structure/lattice,
/obj/machinery/atmospherics/pipe/simple/scrubbers/visible,
/turf/template_noop,
/area/shuttle/exploration)
"PY" = (
/obj/machinery/atmospherics/components/unary/vent_scrubber/on/layer4{
	dir = 8
	},
/turf/open/floor/mineral/titanium,
/area/shuttle/exploration)
"Rk" = (
/obj/structure/window/reinforced/survival_pod{
	dir = 1
	},
/obj/machinery/atmospherics/components/unary/shuttle/heater{
	dir = 1
	},
/turf/open/floor/plating,
/area/shuttle/exploration)
"RQ" = (
/turf/template_noop,
/area/template_noop)
"RS" = (
/obj/machinery/computer/shuttle_flight/custom_shuttle/exploration,
/obj/machinery/firealarm/directional/west,
/turf/open/floor/mineral/plastitanium,
/area/shuttle/exploration)
"Sb" = (
/obj/item/wrench,
/turf/open/floor/mineral/titanium,
/area/shuttle/exploration)
"SW" = (
/obj/effect/spawner/structure/window/shuttle,
/obj/machinery/atmospherics/pipe/layer_manifold,
/turf/open/floor/plating,
/area/shuttle/exploration)
"Ux" = (
/obj/machinery/atmospherics/pipe/manifold/purple/visible{
	dir = 1
	},
/obj/structure/closet/crate/science/shuttle,
/obj/effect/turf_decal/bot,
/turf/open/floor/mineral/titanium,
/area/shuttle/exploration)
"UU" = (
/obj/structure/chair/stool{
	dir = 1;
	pixel_y = 4
	},
/turf/open/floor/mineral/titanium,
/area/shuttle/exploration)
"Vl" = (
/turf/closed/wall/mineral/plastitanium,
/area/shuttle/exploration)
"VG" = (
/obj/structure/table,
/obj/item/gps/mining/exploration,
/obj/machinery/firealarm/directional/east,
/obj/machinery/light{
	dir = 4
	},
/turf/open/floor/mineral/titanium,
/area/shuttle/exploration)
"VV" = (
/obj/machinery/holopad,
/obj/machinery/atmospherics/pipe/simple/scrubbers/hidden/layer4{
	dir = 1
	},
/obj/machinery/atmospherics/pipe/simple/supply/hidden/layer2{
	dir = 10
	},
/turf/open/floor/mineral/titanium,
/area/shuttle/exploration)

(1,1,1) = {"
da
da
da
da
Ax
oC
Ax
oC
Ax
Ax
Ax
Ax
Ax
tz
Vl
RQ
"}
(2,1,1) = {"
oC
RS
nk
da
gM
UU
mQ
lF
so
lF
Ax
pd
go
rg
tz
Vl
"}
(3,1,1) = {"
oC
ty
jH
fC
Hf
DV
Hf
Hf
fh
cx
Ax
BA
DV
le
Rk
hl
"}
(4,1,1) = {"
oC
po
ir
da
IW
VV
Gg
Gg
MU
gP
LC
jI
Aq
op
Rk
hl
"}
(5,1,1) = {"
oC
oC
oC
da
ri
qb
bz
sT
Hf
Hc
Ax
ii
PY
Ux
Rk
hl
"}
(6,1,1) = {"
cu
PT
PT
SW
ut
qb
mt
sT
Hf
uc
Ax
gl
Sb
Aj
Rk
hl
"}
(7,1,1) = {"
RQ
RQ
RQ
oC
AX
qb
VG
sT
es
pW
Ax
OJ
jq
ld
tz
Vl
"}
(8,1,1) = {"
RQ
RQ
RQ
da
da
oC
Ax
Ax
yN
nA
Ax
Ax
Ax
tz
Vl
RQ
"}
