//MAP CONVERTED BY dmm2tgm.py THIS HEADER COMMENT PREVENTS RECONVERSION, DO NOT REMOVE
"a" = (
/obj/effect/turf_decal/delivery,
/obj/machinery/atmospherics/components/unary/portables_connector/visible{
	dir = 4
	},
/obj/machinery/portable_atmospherics/canister/plasma,
/obj/machinery/light/small,
/obj/structure/cable/yellow{
	icon_state = "0-4"
	},
/obj/machinery/power/apc/auto_name/west{
	pixel_x = -24
	},
/turf/open/floor/mineral/plastitanium,
/area/shuttle/exploration)
"b" = (
/obj/structure/cable/yellow{
	icon_state = "1-2"
	},
/obj/structure/extinguisher_cabinet{
	pixel_x = -32;
	pixel_y = -1
	},
/turf/open/floor/mineral/titanium,
/area/shuttle/exploration)
"c" = (
/obj/effect/turf_decal/loading_area{
	dir = 4
	},
/turf/open/floor/mineral/plastitanium,
/area/shuttle/exploration)
"d" = (
/obj/structure/fans/tiny,
/obj/machinery/door/airlock/external/glass,
/obj/docking_port/mobile{
	dir = 4;
	dwidth = 5;
	height = 7;
	id = "exploration";
	name = "Exploration Shuttle";
	port_direction = 8;
	shuttle_object_type = /datum/orbital_object/shuttle/custom_shuttle;
	width = 13
	},
/obj/structure/cable/yellow{
	icon_state = "4-8"
	},
/obj/machinery/atmospherics/pipe/simple/scrubbers/hidden/layer4{
	dir = 4
	},
/obj/machinery/atmospherics/pipe/simple/supply/hidden/layer2{
	dir = 4
	},
/turf/open/floor/plating,
/area/shuttle/exploration)
"e" = (
/obj/machinery/light/floor,
/obj/machinery/atmospherics/pipe/simple/scrubbers/hidden/layer4{
	dir = 6
	},
/obj/machinery/atmospherics/pipe/simple/supply/hidden/layer2{
	dir = 10
	},
/turf/open/floor/mineral/plastitanium,
/area/shuttle/exploration)
"f" = (
/obj/effect/turf_decal/stripes/line{
	dir = 1
	},
/obj/structure/closet/emcloset/anchored,
/obj/effect/turf_decal/bot,
/turf/open/floor/mineral/plastitanium,
/area/shuttle/exploration)
"g" = (
/turf/open/floor/mineral/titanium,
/area/shuttle/exploration)
"h" = (
/turf/open/floor/mineral/plastitanium,
/area/shuttle/exploration)
"i" = (
/obj/machinery/atmospherics/pipe/manifold/purple/visible{
	dir = 1
	},
/obj/machinery/power/port_gen/pacman,
/obj/structure/cable/yellow{
	icon_state = "0-8"
	},
/obj/effect/turf_decal/bot,
/obj/structure/cable/yellow{
	icon_state = "1-8"
	},
/turf/open/floor/mineral/plastitanium,
/area/shuttle/exploration)
"j" = (
/obj/machinery/atmospherics/pipe/simple/supply/hidden/layer2{
	dir = 10
	},
/turf/open/floor/mineral/titanium,
/area/shuttle/exploration)
"k" = (
/obj/effect/turf_decal/stripes/line{
	dir = 1
	},
/obj/structure/cable/yellow{
	icon_state = "1-2"
	},
/turf/open/floor/mineral/plastitanium,
/area/shuttle/exploration)
"l" = (
/turf/template_noop,
/area/template_noop)
"m" = (
/obj/machinery/computer/objective,
/turf/open/floor/mineral/plastitanium,
/area/shuttle/exploration)
"n" = (
/obj/machinery/computer/rdconsole{
	dir = 8
	},
/obj/machinery/button/door{
	desc = "A remote control switch.";
	id = "exploration2";
	name = "Exploration Shuttle Shutters";
	pixel_y = -32
	},
/turf/open/floor/mineral/plastitanium,
/area/shuttle/exploration)
"o" = (
/obj/machinery/atmospherics/pipe/simple/scrubbers/hidden/layer4{
	dir = 1
	},
/obj/machinery/atmospherics/pipe/simple/supply/hidden/layer2{
	dir = 1
	},
/turf/open/floor/mineral/titanium,
/area/shuttle/exploration)
"p" = (
/obj/machinery/shuttle/engine/plasma{
	dir = 1
	},
/turf/open/floor/plating,
/area/shuttle/exploration)
"q" = (
/obj/effect/turf_decal/stripes/line,
/obj/structure/tank_dispenser/oxygen,
/obj/effect/turf_decal/bot,
/turf/open/floor/mineral/plastitanium,
/area/shuttle/exploration)
"r" = (
/obj/machinery/atmospherics/components/unary/plasma_refiner{
	dir = 8
	},
/obj/machinery/light/small,
/obj/structure/sign/warning/nosmoking/circle{
	pixel_x = 32
	},
/obj/effect/turf_decal/delivery,
/turf/open/floor/mineral/plastitanium,
/area/shuttle/exploration)
"t" = (
/obj/structure/sign/nanotrasen,
/turf/closed/wall/mineral/titanium/nodiagonal,
/area/shuttle/exploration)
"u" = (
/obj/machinery/holopad,
/turf/open/floor/mineral/titanium,
/area/shuttle/exploration)
"v" = (
/obj/machinery/camera/preset{
	dir = 8
	},
/obj/effect/turf_decal/stripes/line{
	dir = 1
	},
/obj/machinery/telecomms/relay/preset/exploration,
/obj/effect/turf_decal/delivery,
/turf/open/floor/mineral/plastitanium,
/area/shuttle/exploration)
"w" = (
/obj/structure/chair/fancy/shuttle{
	dir = 1
	},
/obj/machinery/atmospherics/components/unary/vent_pump/on/layer2{
	dir = 4
	},
/turf/open/floor/mineral/plastitanium,
/area/shuttle/exploration)
"x" = (
/obj/effect/turf_decal/loading_area{
	dir = 8
	},
/turf/open/floor/mineral/plastitanium,
/area/shuttle/exploration)
"y" = (
/obj/machinery/atmospherics/components/unary/vent_pump/on/layer2{
	dir = 1
	},
/turf/open/floor/mineral/titanium,
/area/shuttle/exploration)
"z" = (
/turf/closed/wall/mineral/titanium/nodiagonal,
/area/shuttle/exploration)
"A" = (
/obj/effect/turf_decal/stripes/line{
	dir = 1
	},
/obj/machinery/door/airlock/shuttle,
/obj/effect/turf_decal/stripes/line,
/obj/machinery/atmospherics/pipe/simple/scrubbers/hidden/layer4{
	dir = 1
	},
/obj/machinery/atmospherics/pipe/simple/supply/hidden/layer2{
	dir = 1
	},
/turf/open/floor/mineral/plastitanium,
/area/shuttle/exploration)
"B" = (
/obj/structure/cable/yellow{
	icon_state = "2-8"
	},
/obj/machinery/atmospherics/pipe/manifold/scrubbers/hidden/layer4{
	dir = 1
	},
/obj/machinery/atmospherics/pipe/simple/supply/hidden/layer2{
	dir = 4
	},
/turf/open/floor/mineral/titanium,
/area/shuttle/exploration)
"C" = (
/mob/living/simple_animal/chicken/turkey{
	atmos_requirements = list("min_oxy" = 0, "max_oxy" = 0, "min_tox" = 0, "max_tox" = 0, "min_co2" = 0, "max_co2" = 0, "min_n2" = 0, "max_n2" = 0);
	desc = "A veteran of Nanotrasen's Animal Experimentation Program that attempted to replicate the organic space suit that some hostile entities are known to have exhibited, Tom now serves Nanotrasen as the mascot of the Exploration Crew.";
	health = 200;
	maxHealth = 200;
	melee_damage = 5;
	minbodytemp = 2.7;
	name = "Tom"
	},
/obj/machinery/atmospherics/pipe/simple/scrubbers/hidden/layer4{
	dir = 9
	},
/obj/machinery/atmospherics/pipe/manifold/supply/hidden/layer2,
/turf/open/floor/mineral/titanium,
/area/shuttle/exploration)
"D" = (
/obj/structure/table,
/obj/machinery/recharger,
/turf/open/floor/mineral/plastitanium,
/area/shuttle/exploration)
"E" = (
/obj/structure/chair/fancy/shuttle{
	dir = 8
	},
/obj/machinery/light/small{
	dir = 4
	},
/obj/effect/turf_decal/stripes/line{
	dir = 8
	},
/turf/open/floor/mineral/titanium/blue,
/area/shuttle/exploration)
"F" = (
/obj/machinery/camera/preset{
	dir = 8
	},
/obj/machinery/newscaster{
	pixel_x = 32;
	pixel_y = 1
	},
/turf/open/floor/mineral/titanium,
/area/shuttle/exploration)
"G" = (
/obj/effect/turf_decal/caution{
	dir = 8;
	pixel_x = 7
	},
/turf/open/floor/mineral/plastitanium,
/area/shuttle/exploration)
"H" = (
/obj/machinery/door/poddoor/shutters/window{
	id = "exploration2"
	},
/obj/machinery/button/door{
	desc = "A remote control switch.";
	id = "exploration2";
	name = "Exploration Shuttle Shutters";
	pixel_y = 24
	},
/turf/open/floor/plating,
/area/shuttle/exploration)
"I" = (
/turf/closed/wall/mineral/plastitanium,
/area/shuttle/exploration)
"J" = (
/obj/structure/cable/yellow{
	icon_state = "1-2"
	},
/obj/machinery/atmospherics/components/unary/vent_scrubber/on/layer4{
	dir = 1
	},
/turf/open/floor/mineral/titanium,
/area/shuttle/exploration)
"K" = (
/obj/machinery/camera/preset{
	dir = 5
	},
/obj/machinery/vendor/exploration,
/obj/machinery/button/door{
	desc = "A remote control switch.";
	id = "exploration";
	name = "Exploration Shuttle Shutters";
	pixel_y = -32
	},
/turf/open/floor/mineral/plastitanium,
/area/shuttle/exploration)
"L" = (
/obj/structure/window/reinforced/survival_pod{
	dir = 1
	},
/obj/machinery/atmospherics/components/unary/shuttle/heater{
	dir = 1
	},
/turf/open/floor/plating,
/area/shuttle/exploration)
"M" = (
/obj/machinery/computer/shuttle_flight/custom_shuttle/exploration,
/turf/open/floor/mineral/plastitanium,
/area/shuttle/exploration)
"N" = (
/obj/effect/turf_decal/stripes/line{
	dir = 1
	},
/turf/open/floor/mineral/plastitanium,
/area/shuttle/exploration)
"O" = (
/obj/machinery/button/door{
	desc = "A remote control switch.";
	id = "exploration";
	name = "Exploration Shuttle Shutters";
	pixel_y = 24
	},
/obj/machinery/door/poddoor/shutters/window{
	id = "exploration"
	},
/turf/open/floor/plating,
/area/shuttle/exploration)
"P" = (
/obj/structure/chair/fancy/shuttle{
	dir = 1
	},
/obj/machinery/atmospherics/components/unary/vent_scrubber/on/layer4{
	dir = 8
	},
/turf/open/floor/mineral/plastitanium,
/area/shuttle/exploration)
"Q" = (
/turf/closed/wall/mineral/titanium,
/area/shuttle/exploration)
"R" = (
/obj/effect/spawner/structure/window/shuttle,
/turf/open/floor/plating,
/area/shuttle/exploration)
"S" = (
/obj/structure/cable/yellow{
	icon_state = "4-8"
	},
/obj/machinery/atmospherics/pipe/simple/scrubbers/hidden/layer4{
	dir = 4
	},
/obj/machinery/atmospherics/pipe/simple/supply/hidden/layer2{
	dir = 4
	},
/turf/open/floor/mineral/titanium,
/area/shuttle/exploration)
"T" = (
/obj/machinery/atmospherics/pipe/manifold/purple/visible{
	dir = 1
	},
/obj/structure/closet/crate/science,
/obj/item/multitool,
/obj/item/storage/toolbox/mechanical,
/obj/item/gps/mining,
/obj/item/stack/sheet/mineral/plasma/five,
/obj/item/circuitboard/computer/shuttle/exploration_shuttle,
/obj/effect/turf_decal/bot,
/turf/open/floor/mineral/plastitanium,
/area/shuttle/exploration)
"U" = (
/obj/structure/table,
/obj/machinery/microwave,
/obj/effect/turf_decal/stripes/line{
	dir = 6
	},
/obj/item/storage/box/donkpockets,
/obj/item/storage/box/donkpockets,
/turf/open/floor/mineral/plastitanium,
/area/shuttle/exploration)
"V" = (
/obj/machinery/atmospherics/pipe/manifold/purple/visible{
	dir = 1
	},
/obj/structure/closet/crate,
/obj/item/wrench,
/obj/item/pickaxe,
/obj/item/mining_scanner,
/obj/item/radio/headset/headset_exploration,
/obj/item/radio/headset/headset_exploration,
/obj/effect/turf_decal/bot,
/turf/open/floor/mineral/plastitanium,
/area/shuttle/exploration)
"W" = (
/turf/closed/wall/mineral/plastitanium/nodiagonal,
/area/shuttle/exploration)
"X" = (
/obj/structure/chair/fancy/shuttle{
	dir = 8
	},
/obj/effect/turf_decal/stripes/line{
	dir = 8
	},
/turf/open/floor/mineral/titanium/blue,
/area/shuttle/exploration)
"Y" = (
/obj/machinery/light/small{
	dir = 8
	},
/obj/structure/chair/fancy/shuttle{
	dir = 4
	},
/obj/effect/turf_decal/stripes/line{
	dir = 5
	},
/turf/open/floor/mineral/titanium/blue,
/area/shuttle/exploration)
"Z" = (
/obj/structure/cable/yellow{
	icon_state = "1-2"
	},
/obj/effect/turf_decal/caution{
	dir = 4;
	pixel_x = -6
	},
/turf/open/floor/mineral/plastitanium,
/area/shuttle/exploration)

(1,1,1) = {"
l
Q
R
t
z
d
z
z
z
O
z
I
l
"}
(2,1,1) = {"
R
R
K
z
q
S
Y
z
f
x
a
W
I
"}
(3,1,1) = {"
R
M
w
R
U
B
J
b
k
Z
i
L
p
"}
(4,1,1) = {"
R
D
e
A
o
C
u
g
N
h
T
L
p
"}
(5,1,1) = {"
R
m
P
R
g
j
y
F
N
G
V
L
p
"}
(6,1,1) = {"
R
R
n
z
X
X
E
z
v
c
r
W
I
"}
(7,1,1) = {"
l
Q
R
t
z
R
z
z
z
H
z
I
l
"}
