//MAP CONVERTED BY dmm2tgm.py THIS HEADER COMMENT PREVENTS RECONVERSION, DO NOT REMOVE
"ax" = (
/obj/effect/decal/cleanable/dirt,
/obj/effect/turf_decal/stripes/corner,
/turf/open/floor/plasteel/grid/steel,
/area/shuttle/exploration)
"aA" = (
/obj/machinery/door/airlock/shuttle,
/turf/open/floor/mineral/plastitanium,
/area/shuttle/exploration)
"aO" = (
/obj/machinery/light{
	dir = 1
	},
/obj/machinery/light{
	dir = 1
	},
/obj/effect/turf_decal/tile/neutral/opposingcorners,
/turf/open/floor/mineral/titanium,
/area/shuttle/exploration)
"aS" = (
/obj/structure/bed,
/obj/effect/decal/cleanable/blood/old{
	pixel_y = 10
	},
/obj/machinery/light{
	dir = 4
	},
/obj/item/bedsheet/dorms,
/obj/structure/sign/poster/random{
	pixel_x = 32
	},
/turf/open/floor/wood,
/area/shuttle/exploration)
"ck" = (
/obj/structure/table/reinforced,
/obj/structure/sign/poster/contraband/power{
	pixel_x = 32
	},
/obj/effect/decal/cleanable/dirt/dust,
/obj/item/trash/can/food/beans{
	pixel_x = 6;
	pixel_y = 3
	},
/obj/item/reagent_containers/food/drinks/syndicatebeer{
	pixel_x = -8;
	pixel_y = 2
	},
/obj/machinery/light/small{
	dir = 4;
	light_color = "#d8b1b1"
	},
/turf/open/floor/plasteel/techmaint,
/area/shuttle/exploration)
"ds" = (
/obj/machinery/atmospherics/pipe/manifold/purple/visible{
	dir = 4
	},
/obj/effect/decal/cleanable/dirt/dust,
/obj/effect/turf_decal/caution{
	dir = 4
	},
/turf/open/floor/plasteel/techmaint,
/area/shuttle/exploration)
"du" = (
/obj/effect/turf_decal/siding/wideplating_new{
	dir = 4
	},
/turf/open/floor/carpet,
/area/shuttle/exploration)
"dH" = (
/obj/machinery/computer/crew,
/turf/open/floor/mineral/plastitanium,
/area/shuttle/exploration)
"dL" = (
/obj/structure/table/reinforced,
/obj/item/toy/plush/beeplushie,
/obj/effect/turf_decal/tile/neutral/opposingcorners,
/turf/open/floor/mineral/titanium,
/area/shuttle/exploration)
"dT" = (
/obj/machinery/atmospherics/pipe/manifold/purple/visible{
	dir = 1
	},
/obj/effect/turf_decal/box,
/obj/effect/decal/cleanable/oil{
	icon_state = "floor6"
	},
/obj/effect/decal/cleanable/dirt,
/obj/effect/decal/cleanable/dirt/dust,
/turf/open/floor/plasteel/techmaint,
/area/shuttle/exploration)
"eA" = (
/obj/structure/table,
/obj/item/storage/box/donkpockets,
/obj/item/storage/box/donkpockets{
	pixel_x = 3;
	pixel_y = 3
	},
/obj/effect/turf_decal/siding/wideplating_new{
	dir = 4
	},
/turf/open/floor/carpet,
/area/shuttle/exploration)
"eJ" = (
/obj/machinery/light{
	dir = 8
	},
/obj/effect/turf_decal/tile/neutral/opposingcorners,
/turf/open/floor/mineral/titanium,
/area/shuttle/exploration)
"eM" = (
/obj/machinery/vending/cigarette,
/obj/effect/turf_decal/bot,
/obj/effect/turf_decal/tile/neutral/opposingcorners,
/turf/open/floor/mineral/titanium,
/area/shuttle/exploration)
"fo" = (
/obj/structure/table/reinforced,
/obj/item/flashlight/lamp{
	pixel_x = -1;
	pixel_y = 4
	},
/obj/item/toy/figure/rd{
	pixel_x = -9;
	pixel_y = -3
	},
/obj/item/newspaper{
	pixel_x = 3;
	pixel_y = -3
	},
/turf/open/floor/mineral/plastitanium,
/area/shuttle/exploration)
"fp" = (
/obj/machinery/computer/rdconsole,
/turf/open/floor/mineral/plastitanium,
/area/shuttle/exploration)
"fW" = (
/obj/effect/turf_decal/siding/wideplating_new{
	dir = 4
	},
/obj/item/kirbyplants/random,
/turf/open/floor/carpet,
/area/shuttle/exploration)
"ge" = (
/obj/machinery/atmospherics/components/unary/portables_connector/visible{
	dir = 4
	},
/obj/machinery/portable_atmospherics/canister/toxins,
/obj/effect/turf_decal/bot,
/turf/open/floor/plasteel/tech/grid,
/area/shuttle/exploration)
"gz" = (
/obj/structure/sign/nanotrasen,
/turf/closed/wall/mineral/titanium/nodiagonal,
/area/shuttle/exploration)
"gM" = (
/obj/machinery/atmospherics/components/unary/plasma_refiner{
	dir = 8
	},
/turf/open/floor/plasteel/techmaint,
/area/shuttle/exploration)
"hJ" = (
/obj/machinery/atmospherics/pipe/manifold/purple/visible{
	dir = 1
	},
/obj/effect/turf_decal/box,
/obj/effect/decal/cleanable/dirt,
/obj/effect/decal/cleanable/dirt/dust,
/turf/open/floor/plasteel/techmaint,
/area/shuttle/exploration)
"hQ" = (
/obj/effect/turf_decal/bot,
/obj/structure/chair{
	dir = 8
	},
/obj/machinery/light{
	dir = 1
	},
/turf/open/floor/carpet,
/area/shuttle/exploration)
"id" = (
/obj/machinery/computer/shuttle_flight/custom_shuttle/exploration{
	dir = 4
	},
/turf/open/floor/mineral/plastitanium,
/area/shuttle/exploration)
"ik" = (
/obj/structure/dresser,
/obj/machinery/newscaster{
	pixel_y = 32
	},
/obj/effect/spawner/lootdrop/minor/kittyears_or_rabbitears,
/turf/open/floor/wood,
/area/shuttle/exploration)
"iy" = (
/obj/machinery/vending/boozeomat/pubby_maint,
/obj/effect/turf_decal/tile/neutral/opposingcorners,
/turf/open/floor/mineral/titanium,
/area/shuttle/exploration)
"iF" = (
/turf/closed/wall/r_wall/syndicate,
/area/shuttle/exploration)
"kt" = (
/obj/structure/table/reinforced,
/obj/item/stack/sheet/mineral/plastitanium{
	amount = 30
	},
/obj/item/stack/cable_coil/red,
/obj/item/assembly/prox_sensor{
	desc = "Used for scanning and alerting when someone enters a certain proximity. This one is slightly shifted to the left.";
	pixel_x = -6;
	pixel_y = 6
	},
/obj/item/storage/belt/utility{
	pixel_y = -3
	},
/obj/effect/decal/cleanable/dirt/dust,
/obj/effect/decal/cleanable/generic{
	pixel_x = -12;
	pixel_y = 14
	},
/obj/effect/turf_decal/stripes/line{
	dir = 1
	},
/obj/structure/sign/poster/contraband/random{
	pixel_y = 32
	},
/obj/machinery/light/small{
	dir = 1
	},
/obj/effect/turf_decal/tile/neutral/half/contrasted{
	dir = 4
	},
/turf/open/floor/plasteel/techmaint,
/area/shuttle/exploration)
"kV" = (
/obj/effect/decal/cleanable/dirt/dust,
/obj/structure/chair/fancy/shuttle{
	dir = 1
	},
/turf/open/floor/mineral/plastitanium,
/area/shuttle/exploration)
"lw" = (
/obj/structure/table/reinforced,
/obj/item/paper_bin{
	pixel_x = 5;
	pixel_y = 4
	},
/obj/item/pen{
	pixel_x = 5;
	pixel_y = 6
	},
/obj/item/taperecorder{
	pixel_x = -7;
	pixel_y = -1
	},
/obj/effect/decal/cleanable/dirt/dust,
/turf/open/floor/mineral/plastitanium,
/area/shuttle/exploration)
"mc" = (
/obj/machinery/computer/objective{
	dir = 8
	},
/turf/open/floor/mineral/plastitanium,
/area/shuttle/exploration)
"nG" = (
/turf/closed/wall/mineral/titanium/nodiagonal,
/area/shuttle/exploration)
"oA" = (
/obj/effect/turf_decal/box,
/obj/effect/decal/cleanable/generic{
	pixel_x = 11
	},
/turf/open/floor/plasteel/grid/steel,
/area/shuttle/exploration)
"pl" = (
/obj/machinery/camera{
	dir = 10
	},
/turf/template_noop,
/area/template_noop)
"py" = (
/obj/structure/table/reinforced,
/obj/item/storage/fancy/cigarettes/cigpack_shadyjims{
	pixel_x = -6;
	pixel_y = -8
	},
/obj/item/lighter/greyscale{
	pixel_x = -9;
	pixel_y = -7
	},
/obj/machinery/recharger,
/obj/structure/sign/poster/contraband/fun_police{
	pixel_x = -32
	},
/turf/open/floor/mineral/plastitanium,
/area/shuttle/exploration)
"pJ" = (
/turf/template_noop,
/area/template_noop)
"qX" = (
/obj/machinery/light,
/turf/open/floor/mineral/plastitanium,
/area/shuttle/exploration)
"rb" = (
/turf/open/floor/mineral/plastitanium,
/area/shuttle/exploration)
"rj" = (
/obj/structure/chair/fancy/shuttle{
	dir = 1
	},
/turf/open/floor/mineral/titanium,
/area/shuttle/exploration)
"rY" = (
/obj/effect/decal/cleanable/dirt/dust,
/obj/machinery/recharger,
/obj/structure/table/reinforced,
/obj/machinery/status_display/evac{
	pixel_y = 32
	},
/obj/item/paper/fluff{
	default_raw_text = "We congratulate you on the purchase of the SF-1000 'Slimer' class exploration and pioneer shuttle, this shuttle features a minibar and an expanded cargo bay for your exploration needs, alongside a sleeping room for longer trips.";
	name = "Congratulation on the New shuttle";
	pixel_x = 9;
	pixel_y = 6
	},
/turf/open/floor/mineral/titanium,
/area/shuttle/exploration)
"su" = (
/obj/structure/chair/fancy/shuttle{
	dir = 4
	},
/turf/open/floor/mineral/plastitanium,
/area/shuttle/exploration)
"sy" = (
/obj/machinery/atmospherics/pipe/simple/purple/visible{
	dir = 4
	},
/turf/open/floor/plasteel/techmaint,
/area/shuttle/exploration)
"tF" = (
/obj/effect/decal/cleanable/dirt/dust,
/obj/effect/decal/cleanable/dirt/dust,
/obj/machinery/light{
	dir = 4
	},
/obj/machinery/firealarm{
	dir = 8;
	pixel_x = 24
	},
/obj/structure/table/reinforced,
/obj/item/gps/mining/exploration{
	pixel_x = 4;
	pixel_y = -3
	},
/obj/item/circuitboard/computer/shuttle/exploration_shuttle{
	pixel_x = -2;
	pixel_y = 6
	},
/turf/open/floor/mineral/plastitanium,
/area/shuttle/exploration)
"us" = (
/turf/closed/wall/mineral/titanium,
/area/shuttle/exploration)
"uw" = (
/obj/machinery/computer/cargo/request,
/obj/effect/turf_decal/delivery,
/turf/open/floor/plasteel/grid/steel,
/area/shuttle/exploration)
"uE" = (
/obj/machinery/atmospherics/pipe/manifold/purple/visible{
	dir = 1
	},
/obj/effect/turf_decal/box,
/obj/effect/decal/cleanable/dirt,
/turf/open/floor/plasteel/techmaint,
/area/shuttle/exploration)
"vp" = (
/obj/structure/tank_dispenser/oxygen,
/obj/effect/turf_decal/delivery,
/obj/machinery/light{
	dir = 1
	},
/obj/effect/turf_decal/stripes/corner,
/obj/structure/sign/warning/vacuum/external{
	pixel_x = 32
	},
/turf/open/floor/mineral/plastitanium,
/area/shuttle/exploration)
"vA" = (
/obj/structure/reagent_dispensers/fueltank,
/obj/effect/turf_decal/delivery,
/obj/machinery/light/small{
	dir = 1
	},
/obj/machinery/firealarm{
	pixel_y = 26
	},
/turf/open/floor/plasteel/grid/steel,
/area/shuttle/exploration)
"wo" = (
/obj/structure/table/reinforced,
/obj/item/storage/firstaid/regular{
	pixel_x = -3;
	pixel_y = 9
	},
/obj/item/toy/cards/deck{
	pixel_x = 2
	},
/obj/effect/turf_decal/tile/neutral/opposingcorners,
/turf/open/floor/mineral/titanium,
/area/shuttle/exploration)
"wy" = (
/obj/effect/decal/cleanable/glass,
/obj/structure/chair/fancy/shuttle{
	dir = 8
	},
/turf/open/floor/carpet,
/area/shuttle/exploration)
"xd" = (
/obj/structure/reagent_dispensers/watertank,
/obj/effect/turf_decal/delivery,
/obj/structure/extinguisher_cabinet{
	pixel_y = 30
	},
/turf/open/floor/plasteel/grid/steel,
/area/shuttle/exploration)
"xe" = (
/obj/structure/fans/tiny,
/obj/effect/turf_decal/stripes/line{
	dir = 8
	},
/obj/effect/turf_decal/sand,
/obj/effect/turf_decal/stripes/line{
	dir = 4
	},
/obj/machinery/door/poddoor/shutters{
	id = "exploration"
	},
/turf/open/floor/plasteel/tech/grid,
/area/shuttle/exploration)
"xC" = (
/obj/effect/decal/cleanable/dirt/dust,
/obj/effect/decal/cleanable/dirt,
/obj/effect/turf_decal/loading_area{
	dir = 4
	},
/obj/effect/turf_decal/stripes/line{
	dir = 9
	},
/turf/open/floor/plasteel/grid/steel,
/area/shuttle/exploration)
"yx" = (
/obj/structure/chair/office{
	dir = 4;
	name = "tactical swivel chair"
	},
/obj/effect/decal/cleanable/oil/streak,
/obj/effect/decal/cleanable/dirt/dust,
/turf/open/floor/plasteel/techmaint,
/area/shuttle/exploration)
"yV" = (
/obj/structure/lattice/catwalk/over,
/obj/machinery/power/port_gen/pacman,
/obj/structure/cable/yellow{
	icon_state = "0-4"
	},
/obj/structure/sign/warning/nosmoking/circle{
	pixel_y = 32
	},
/turf/open/floor/plating,
/area/shuttle/exploration)
"zC" = (
/obj/effect/turf_decal/stripes/line{
	dir = 1
	},
/obj/structure/closet/crate/large,
/obj/effect/spawner/lootdrop/maintenance/three,
/obj/effect/spawner/lootdrop/ruinloot/medical,
/turf/open/floor/plasteel/grid/steel,
/area/shuttle/exploration)
"zG" = (
/obj/machinery/door/airlock/shuttle,
/turf/open/floor/mineral/titanium,
/area/shuttle/exploration)
"Ai" = (
/obj/machinery/atmospherics/components/unary/portables_connector/visible{
	dir = 4
	},
/obj/machinery/portable_atmospherics/canister/toxins,
/obj/effect/turf_decal/bot,
/obj/machinery/light/small{
	dir = 8
	},
/turf/open/floor/plasteel/tech/grid,
/area/shuttle/exploration)
"BP" = (
/obj/effect/decal/cleanable/dirt,
/obj/effect/decal/cleanable/dirt,
/obj/effect/turf_decal/stripes/line{
	dir = 1
	},
/turf/open/floor/plasteel/grid/steel,
/area/shuttle/exploration)
"BR" = (
/obj/effect/decal/cleanable/dirt/dust,
/obj/effect/turf_decal/stripes/line{
	dir = 4
	},
/turf/open/floor/mineral/titanium,
/area/shuttle/exploration)
"BT" = (
/obj/effect/turf_decal/box,
/obj/machinery/atmospherics/pipe/manifold/purple/visible{
	dir = 1
	},
/turf/open/floor/plasteel/techmaint,
/area/shuttle/exploration)
"Cf" = (
/obj/effect/turf_decal/box,
/obj/structure/closet/crate/critter,
/mob/living/simple_animal/chicken/turkey{
	atmos_requirements = list("min_oxy" = 0, "max_oxy" = 0, "min_tox" = 0, "max_tox" = 0, "min_co2" = 0, "max_co2" = 0, "min_n2" = 0, "max_n2" = 0);
	desc = "A veteran of Nanotrasen's Animal Experimentation Program that attempted to replicate the organic space suit that some hostile entities are known to have exhibited, Tom now serves Nanotrasen as the mascot of the Exploration Crew.";
	dir = 4;
	health = 200;
	maxHealth = 200;
	melee_damage = 5;
	minbodytemp = 2.7;
	name = "Tom"
	},
/obj/structure/sign/poster/official/random{
	pixel_x = -32
	},
/turf/open/floor/plasteel/grid/steel,
/area/shuttle/exploration)
"Cj" = (
/turf/open/floor/carpet,
/area/shuttle/exploration)
"Cx" = (
/obj/effect/turf_decal/stripes/line{
	dir = 1
	},
/obj/structure/table/reinforced,
/obj/machinery/cell_charger,
/obj/item/stock_parts/cell/high,
/obj/item/stock_parts/cell/high{
	pixel_x = 7;
	pixel_y = 4
	},
/obj/effect/decal/cleanable/dirt/dust,
/turf/open/floor/plasteel/techmaint,
/area/shuttle/exploration)
"CZ" = (
/obj/structure/chair/stool/bar,
/obj/effect/decal/cleanable/vomit,
/obj/effect/turf_decal/tile/neutral/opposingcorners,
/turf/open/floor/mineral/titanium,
/area/shuttle/exploration)
"Df" = (
/obj/effect/turf_decal/stripes/line{
	dir = 8
	},
/turf/open/floor/mineral/plastitanium,
/area/shuttle/exploration)
"DG" = (
/obj/machinery/door/airlock/external/glass,
/obj/effect/mapping_helpers/airlock/cyclelink_helper{
	dir = 4
	},
/obj/effect/turf_decal/delivery,
/turf/open/floor/mineral/plastitanium,
/area/shuttle/exploration)
"Ec" = (
/obj/machinery/light,
/obj/effect/turf_decal/tile/neutral/opposingcorners,
/turf/open/floor/mineral/titanium,
/area/shuttle/exploration)
"Fm" = (
/obj/structure/railing/corner{
	dir = 8
	},
/obj/effect/decal/cleanable/dirt/dust,
/turf/open/floor/mineral/titanium,
/area/shuttle/exploration)
"Gb" = (
/turf/open/floor/plasteel/techmaint,
/area/shuttle/exploration)
"Gc" = (
/obj/structure/fans/tiny,
/obj/effect/turf_decal/stripes/line{
	dir = 8
	},
/obj/effect/turf_decal/stripes/line{
	dir = 4
	},
/obj/machinery/door/poddoor/shutters{
	id = "exploration"
	},
/turf/open/floor/plasteel/tech/grid,
/area/shuttle/exploration)
"Gt" = (
/obj/effect/turf_decal/loading_area{
	dir = 4
	},
/obj/effect/turf_decal/stripes/line{
	dir = 8
	},
/turf/open/floor/plasteel/grid/steel,
/area/shuttle/exploration)
"GJ" = (
/obj/effect/decal/cleanable/dirt,
/turf/open/floor/plasteel/grid/steel,
/area/shuttle/exploration)
"HU" = (
/obj/effect/decal/cleanable/dirt,
/turf/open/floor/plasteel/techmaint,
/area/shuttle/exploration)
"It" = (
/obj/structure/railing/corner{
	dir = 1
	},
/obj/effect/decal/cleanable/dirt/dust,
/obj/effect/turf_decal/tile/neutral/opposingcorners,
/turf/open/floor/mineral/titanium,
/area/shuttle/exploration)
"Iv" = (
/obj/machinery/firealarm{
	dir = 8;
	pixel_x = 24
	},
/obj/effect/turf_decal/tile/neutral/opposingcorners,
/turf/open/floor/mineral/titanium,
/area/shuttle/exploration)
"IM" = (
/obj/effect/turf_decal/box,
/obj/effect/decal/cleanable/dirt/dust,
/obj/structure/cable/yellow{
	icon_state = "0-4"
	},
/obj/machinery/atmospherics/pipe/manifold/purple/visible,
/obj/machinery/light/small,
/turf/open/floor/plasteel/techmaint,
/area/shuttle/exploration)
"JF" = (
/obj/effect/decal/cleanable/dirt/dust,
/obj/machinery/door/airlock/shuttle,
/turf/open/floor/mineral/titanium,
/area/shuttle/exploration)
"JR" = (
/obj/structure/table/reinforced,
/obj/item/reagent_containers/glass/rag{
	pixel_y = 5
	},
/obj/item/reagent_containers/food/drinks/shaker{
	pixel_x = 4;
	pixel_y = 1
	},
/obj/effect/turf_decal/tile/neutral/opposingcorners,
/turf/open/floor/mineral/titanium,
/area/shuttle/exploration)
"Kh" = (
/obj/effect/turf_decal/stripes/line{
	dir = 4
	},
/obj/machinery/light,
/turf/open/floor/mineral/plastitanium,
/area/shuttle/exploration)
"Kj" = (
/obj/effect/mapping_helpers/airlock/cyclelink_helper{
	dir = 4
	},
/obj/machinery/door/airlock/external/glass,
/obj/effect/turf_decal/delivery,
/obj/docking_port/mobile{
	dir = 8;
	dwidth = 14;
	height = 11;
	id = "exploration";
	name = "Exploration Shuttle";
	port_direction = 3;
	shuttle_object_type = /datum/orbital_object/shuttle/custom_shuttle;
	width = 22
	},
/turf/open/floor/mineral/plastitanium,
/area/shuttle/exploration)
"Lx" = (
/obj/effect/turf_decal/stripes/line{
	dir = 10
	},
/obj/machinery/button/door{
	desc = "A remote control switch.";
	id = "exploration";
	name = "Exploration Shuttle Shutters";
	pixel_x = -24
	},
/turf/open/floor/plasteel/grid/steel,
/area/shuttle/exploration)
"LM" = (
/obj/effect/turf_decal/stripes/line,
/turf/open/floor/plasteel/grid/steel,
/area/shuttle/exploration)
"Mk" = (
/obj/structure/chair/stool/bar,
/obj/effect/turf_decal/tile/neutral/opposingcorners,
/turf/open/floor/mineral/titanium,
/area/shuttle/exploration)
"Nj" = (
/obj/effect/turf_decal/box,
/obj/effect/decal/cleanable/dirt/dust,
/obj/effect/turf_decal/sand,
/obj/structure/extinguisher_cabinet{
	pixel_x = 24
	},
/turf/open/floor/plasteel/grid/steel,
/area/shuttle/exploration)
"Nt" = (
/obj/effect/turf_decal/stripes/line{
	dir = 4
	},
/turf/open/floor/mineral/plastitanium,
/area/shuttle/exploration)
"Nv" = (
/obj/machinery/telecomms/relay/preset/exploration,
/obj/effect/turf_decal/delivery,
/obj/effect/turf_decal/stripes/line{
	dir = 1
	},
/obj/structure/window/reinforced{
	dir = 8
	},
/obj/structure/window/reinforced{
	dir = 4
	},
/obj/machinery/door/window,
/turf/open/floor/plasteel/techmaint,
/area/shuttle/exploration)
"Oa" = (
/obj/effect/turf_decal/stripes/line{
	dir = 6
	},
/turf/open/floor/plasteel/grid/steel,
/area/shuttle/exploration)
"Og" = (
/obj/structure/window/reinforced/survival_pod{
	dir = 1
	},
/obj/machinery/atmospherics/components/unary/shuttle/heater{
	dir = 1
	},
/turf/open/floor/plating,
/area/shuttle/exploration)
"Om" = (
/obj/effect/spawner/structure/window/shuttle,
/turf/open/floor/plating,
/area/shuttle/exploration)
"OJ" = (
/obj/structure/table,
/obj/machinery/microwave{
	pixel_y = 3
	},
/turf/open/floor/carpet,
/area/shuttle/exploration)
"Pa" = (
/obj/machinery/door/airlock/external/glass,
/obj/effect/turf_decal/delivery,
/turf/open/floor/mineral/plastitanium,
/area/shuttle/exploration)
"Pb" = (
/obj/structure/railing/corner,
/obj/effect/turf_decal/stripes/corner{
	dir = 4
	},
/obj/structure/extinguisher_cabinet{
	pixel_x = 24
	},
/turf/open/floor/mineral/titanium,
/area/shuttle/exploration)
"Qv" = (
/obj/machinery/shuttle/engine/plasma{
	dir = 1
	},
/turf/open/floor/plating,
/area/shuttle/exploration)
"QL" = (
/obj/structure/janitorialcart{
	dir = 8
	},
/obj/item/mop,
/obj/item/reagent_containers/glass/bucket,
/obj/item/reagent_containers/spray/cleaner,
/obj/machinery/light/small{
	dir = 8
	},
/obj/effect/turf_decal/box,
/turf/open/floor/plasteel/grid/steel,
/area/shuttle/exploration)
"QV" = (
/obj/machinery/computer/arcade/orion_trail{
	dir = 4
	},
/obj/effect/turf_decal/bot,
/obj/machinery/light{
	dir = 8;
	light_color = "#e8eaff"
	},
/turf/open/floor/carpet,
/area/shuttle/exploration)
"Rm" = (
/obj/structure/railing{
	dir = 4
	},
/obj/machinery/door/firedoor,
/turf/open/floor/plasteel/stairs,
/area/shuttle/exploration)
"Rt" = (
/obj/effect/decal/cleanable/dirt,
/obj/effect/decal/cleanable/dirt/dust,
/turf/open/floor/plasteel/techmaint,
/area/shuttle/exploration)
"RB" = (
/obj/structure/bed/dogbed,
/obj/effect/decal/cleanable/oil,
/obj/effect/decal/cleanable/cobweb,
/obj/item/toy/plush/beeplushie,
/obj/machinery/light/small{
	dir = 1
	},
/turf/open/floor/wood{
	icon_state = "wood-broken6"
	},
/area/shuttle/exploration)
"RG" = (
/obj/effect/turf_decal/box,
/obj/machinery/light/small,
/turf/open/floor/plasteel/grid/steel,
/area/shuttle/exploration)
"Sf" = (
/obj/effect/turf_decal/box,
/obj/structure/sign/poster/contraband/random{
	pixel_x = 32
	},
/obj/structure/closet/crate/large,
/obj/effect/decal/cleanable/dirt,
/obj/item/soap/nanotrasen,
/obj/item/storage/bag/trash,
/obj/item/reagent_containers/spray/cleaner,
/turf/open/floor/plasteel/grid/steel,
/area/shuttle/exploration)
"Sw" = (
/obj/machinery/door/airlock/shuttle,
/obj/effect/turf_decal/stripes/line{
	dir = 1
	},
/obj/effect/turf_decal/stripes/line{
	dir = 8
	},
/obj/effect/turf_decal/stripes/line{
	dir = 4
	},
/turf/open/floor/mineral/plastitanium,
/area/shuttle/exploration)
"SO" = (
/turf/open/floor/wood,
/area/shuttle/exploration)
"Tf" = (
/obj/effect/turf_decal/tile/neutral/opposingcorners,
/turf/open/floor/mineral/titanium,
/area/shuttle/exploration)
"TJ" = (
/obj/structure/railing{
	dir = 8
	},
/obj/machinery/door/firedoor,
/obj/effect/decal/cleanable/dirt/dust,
/turf/open/floor/plasteel/stairs,
/area/shuttle/exploration)
"UN" = (
/obj/structure/table/reinforced,
/obj/item/reagent_containers/food/drinks/britcup{
	pixel_x = 9;
	pixel_y = -3
	},
/obj/effect/decal/cleanable/dirt/dust,
/obj/item/trash/chips{
	pixel_x = -3;
	pixel_y = 5
	},
/obj/item/reagent_containers/food/drinks/beer/light{
	pixel_x = 4;
	pixel_y = 7
	},
/turf/open/floor/carpet,
/area/shuttle/exploration)
"VZ" = (
/turf/open/floor/mineral/titanium,
/area/shuttle/exploration)
"Wv" = (
/obj/structure/table/reinforced,
/obj/item/toy/cards/deck/unum{
	pixel_x = 9;
	pixel_y = 1
	},
/obj/item/trash/pistachios,
/obj/item/reagent_containers/food/drinks/beer/almost_empty{
	pixel_x = -8
	},
/obj/machinery/light,
/turf/open/floor/carpet,
/area/shuttle/exploration)
"WU" = (
/turf/closed/wall/r_wall/syndicate/nodiagonal,
/area/shuttle/exploration)
"Xd" = (
/obj/structure/chair/fancy/shuttle{
	dir = 4
	},
/turf/open/floor/carpet,
/area/shuttle/exploration)
"Xk" = (
/obj/structure/table,
/obj/machinery/chem_dispenser/drinks{
	dir = 8
	},
/obj/effect/turf_decal/tile/neutral/opposingcorners,
/turf/open/floor/mineral/titanium,
/area/shuttle/exploration)
"Xm" = (
/obj/structure/closet/crate,
/obj/item/stack/sheet/mineral/plasma/five,
/obj/item/pickaxe,
/obj/item/mining_scanner,
/obj/item/radio/headset/headset_exploration,
/obj/item/radio/headset/headset_exploration,
/obj/item/gps/mining,
/obj/machinery/atmospherics/pipe/manifold/purple/visible{
	dir = 1
	},
/obj/effect/turf_decal/box,
/obj/item/stack/sheet/mineral/plasma/fifty{
	pixel_x = 3;
	pixel_y = -3
	},
/obj/effect/decal/cleanable/dirt,
/obj/effect/decal/cleanable/dirt/dust,
/turf/open/floor/plasteel/techmaint,
/area/shuttle/exploration)
"Xo" = (
/obj/structure/table/reinforced,
/obj/item/stack/sheet/mineral/plasma/fifty{
	pixel_x = 3;
	pixel_y = -3
	},
/obj/item/storage/toolbox/mechanical{
	pixel_x = -3;
	pixel_y = 6
	},
/obj/effect/turf_decal/stripes/line{
	dir = 1
	},
/obj/structure/extinguisher_cabinet{
	pixel_y = 30
	},
/turf/open/floor/plasteel/techmaint,
/area/shuttle/exploration)
"XD" = (
/obj/structure/table,
/obj/machinery/chem_dispenser/drinks/beer{
	dir = 8
	},
/obj/effect/turf_decal/tile/neutral/opposingcorners,
/turf/open/floor/mineral/titanium,
/area/shuttle/exploration)
"XP" = (
/obj/structure/chair/fancy/shuttle{
	dir = 8
	},
/turf/open/floor/carpet,
/area/shuttle/exploration)
"YJ" = (
/obj/structure/railing/corner{
	dir = 4
	},
/obj/effect/decal/cleanable/dirt/dust,
/obj/effect/turf_decal/tile/neutral/opposingcorners,
/turf/open/floor/mineral/titanium,
/area/shuttle/exploration)
"Zf" = (
/obj/machinery/atmospherics/components/unary/portables_connector/visible{
	dir = 4
	},
/obj/machinery/portable_atmospherics/canister/toxins,
/obj/effect/turf_decal/bot,
/obj/effect/turf_decal/stripes/line{
	dir = 1
	},
/obj/effect/decal/cleanable/cobweb,
/obj/effect/decal/cleanable/glass,
/turf/open/floor/plasteel/tech/grid,
/area/shuttle/exploration)
"Zq" = (
/obj/effect/turf_decal/stripes/line{
	dir = 1
	},
/obj/machinery/atmospherics/pipe/simple/purple/visible{
	dir = 10
	},
/obj/effect/decal/cleanable/dirt,
/obj/effect/decal/cleanable/dirt/dust,
/obj/effect/turf_decal/caution{
	dir = 4
	},
/obj/machinery/light/small{
	dir = 1
	},
/obj/structure/extinguisher_cabinet{
	pixel_y = 30
	},
/turf/open/floor/plasteel/techmaint,
/area/shuttle/exploration)
"ZU" = (
/obj/effect/turf_decal/stripes/line{
	dir = 1
	},
/obj/effect/decal/cleanable/dirt/dust,
/turf/open/floor/plasteel/techmaint,
/area/shuttle/exploration)
"ZY" = (
/obj/effect/turf_decal/stripes/line{
	dir = 1
	},
/obj/effect/decal/cleanable/dirt/dust,
/obj/structure/cable/yellow{
	icon_state = "0-8"
	},
/obj/machinery/power/apc/auto_name/north{
	cell_type = /obj/item/stock_parts/cell/high
	},
/turf/open/floor/plasteel/techmaint,
/area/shuttle/exploration)

(1,1,1) = {"
pJ
pJ
pJ
pl
us
nG
xe
Gc
nG
Om
nG
nG
nG
Om
Om
nG
nG
WU
WU
iF
iF
pJ
"}
(2,1,1) = {"
pJ
pJ
pJ
pJ
nG
uw
xC
Gt
Lx
oA
Cf
nG
QV
Cj
Xd
Xd
nG
Zf
Ai
ge
WU
pJ
"}
(3,1,1) = {"
pJ
Om
gz
nG
nG
vA
zC
GJ
LM
QL
RG
nG
hQ
Cj
UN
Wv
nG
Zq
ds
IM
WU
iF
"}
(4,1,1) = {"
Om
Om
id
py
nG
xd
BP
ax
Oa
Nj
Sf
nG
OJ
Cj
wy
XP
nG
yV
Rt
BT
Og
Qv
"}
(5,1,1) = {"
Om
dH
kV
qX
nG
nG
zG
zG
nG
nG
nG
nG
eA
du
du
fW
nG
ZY
Rt
Xm
Og
Qv
"}
(6,1,1) = {"
Om
fo
lw
rb
aA
rj
VZ
VZ
Fm
TJ
It
eJ
Tf
Tf
Tf
Tf
JF
ZU
HU
hJ
Og
Qv
"}
(7,1,1) = {"
Om
fp
kV
qX
nG
rY
BR
BR
Pb
Rm
YJ
Iv
Tf
Mk
CZ
Mk
nG
Nv
Gb
uE
Og
Qv
"}
(8,1,1) = {"
Om
Om
mc
tF
nG
nG
Pa
Pa
nG
nG
Sw
nG
Tf
wo
JR
dL
nG
Xo
HU
dT
Og
Qv
"}
(9,1,1) = {"
pJ
Om
gz
nG
nG
su
Df
Df
nG
RB
SO
nG
aO
Tf
Tf
Ec
nG
kt
yx
sy
WU
iF
"}
(10,1,1) = {"
pJ
pJ
pJ
pJ
nG
vp
Nt
Kh
nG
ik
aS
nG
eM
Xk
XD
iy
nG
Cx
ck
gM
WU
pJ
"}
(11,1,1) = {"
pJ
pJ
pJ
pJ
us
nG
DG
Kj
nG
Om
nG
nG
nG
Om
Om
nG
nG
WU
WU
WU
iF
pJ
"}
