//MAP CONVERTED BY dmm2tgm.py THIS HEADER COMMENT PREVENTS RECONVERSION, DO NOT REMOVE
"a" = (
/obj/structure/fans/tiny,
/obj/structure/fans/tiny,
/turf/open/floor/plating,
/area/storage/primary)
"c" = (
/obj/structure/lattice/catwalk,
/obj/structure/cable{
	icon_state = "1-2"
	},
/turf/open/space/basic,
/area/space/nearstation)
"d" = (
/obj/structure/table,
/obj/item/storage/firstaid/regular,
/turf/open/floor/plasteel,
/area/storage/primary)
"e" = (
/turf/open/space/basic,
/area/space)
"h" = (
/obj/structure/lattice/catwalk,
/obj/structure/cable{
	icon_state = "1-2"
	},
/obj/structure/cable{
	icon_state = "2-8"
	},
/obj/structure/cable{
	icon_state = "2-4"
	},
/turf/open/space/basic,
/area/space/nearstation)
"j" = (
/obj/structure/table,
/obj/item/autosurgeon/syndicate/xray_eyes,
/turf/open/floor/plasteel,
/area/storage/primary)
"l" = (
/obj/machinery/gravity_generator/main/station,
/turf/open/floor/plasteel,
/area/storage/primary)
"m" = (
/obj/machinery/power/rtg/advanced,
/obj/structure/cable{
	icon_state = "0-8"
	},
/turf/open/floor/plating/airless,
/area/space/nearstation)
"o" = (
/obj/structure/cable{
	icon_state = "1-8"
	},
/turf/open/floor/plasteel,
/area/storage/primary)
"p" = (
/obj/structure/table,
/obj/item/storage/toolbox/syndicate,
/turf/open/floor/plasteel,
/area/storage/primary)
"r" = (
/obj/structure/table,
/obj/item/flashlight/seclite{
	brightness_on = 15;
	name = "supa light"
	},
/turf/open/floor/plasteel,
/area/storage/primary)
"s" = (
/obj/structure/lattice/catwalk,
/obj/structure/cable{
	icon_state = "2-8"
	},
/obj/structure/cable{
	icon_state = "2-4"
	},
/turf/open/space/basic,
/area/space/nearstation)
"w" = (
/obj/effect/landmark/observer_start,
/turf/open/floor/plasteel,
/area/storage/primary)
"A" = (
/obj/item/flashlight/seclite{
	brightness_on = 15;
	name = "supa light"
	},
/turf/open/floor/plasteel,
/area/storage/primary)
"B" = (
/turf/closed/wall/r_wall,
/area/storage/primary)
"F" = (
/obj/effect/spawner/structure/window/reinforced,
/obj/structure/fans/tiny,
/turf/open/floor/plating,
/area/storage/primary)
"H" = (
/obj/effect/landmark/start,
/turf/open/floor/plasteel,
/area/storage/primary)
"J" = (
/obj/structure/table,
/obj/item/flashlight/flare,
/obj/item/flashlight/glowstick,
/obj/item/flashlight/glowstick/pink,
/obj/item/flashlight/glowstick/orange,
/obj/item/flashlight/flare/torch,
/turf/open/floor/plasteel,
/area/storage/primary)
"K" = (
/obj/structure/lattice,
/turf/open/space/basic,
/area/space/nearstation)
"L" = (
/obj/structure/fans/tiny,
/turf/open/floor/plating,
/area/storage/primary)
"M" = (
/obj/item/flashlight/lamp/green{
	brightness_on = 8;
	flashlight_power = 22
	},
/turf/open/floor/plasteel,
/area/storage/primary)
"Q" = (
/obj/effect/spawner/structure/window/reinforced,
/obj/structure/cable{
	icon_state = "1-2"
	},
/obj/structure/fans/tiny,
/turf/open/floor/plating,
/area/storage/primary)
"R" = (
/obj/machinery/power/rtg/advanced,
/obj/structure/cable{
	icon_state = "0-4"
	},
/turf/open/floor/plating/airless,
/area/space/nearstation)
"S" = (
/turf/open/floor/plasteel,
/area/storage/primary)
"T" = (
/obj/structure/table,
/obj/item/melee/transforming/energy/axe,
/turf/open/floor/plasteel,
/area/storage/primary)
"U" = (
/obj/structure/cable{
	icon_state = "4-8"
	},
/obj/machinery/airalarm/unlocked{
	pixel_y = 23
	},
/turf/open/floor/plasteel,
/area/storage/primary)
"X" = (
/obj/structure/table,
/obj/item/flashlight,
/obj/item/flashlight/seclite,
/turf/open/floor/plasteel,
/area/storage/primary)
"Z" = (
/obj/machinery/power/apc{
	dir = 8;
	pixel_x = -24
	},
/obj/structure/cable{
	icon_state = "0-4"
	},
/turf/open/floor/plasteel,
/area/storage/primary)

(1,1,1) = {"
e
e
e
e
e
e
e
e
e
e
e
e
e
e
e
e
e
e
e
e
e
e
e
e
e
e
e
e
e
e
e
e
e
e
e
e
e
e
e
e
"}
(2,1,1) = {"
e
e
e
e
e
e
e
e
e
e
e
e
e
e
e
e
e
e
e
e
e
e
e
e
e
e
e
e
e
e
e
e
e
e
e
e
e
e
e
e
"}
(3,1,1) = {"
e
e
e
e
e
e
e
e
e
e
e
e
e
e
e
e
e
e
e
e
e
e
e
e
e
e
e
e
e
e
e
e
e
e
e
e
e
e
e
e
"}
(4,1,1) = {"
e
e
e
e
e
e
e
e
e
e
e
e
e
e
e
e
e
K
K
K
K
K
K
K
K
K
K
e
e
e
e
e
e
e
e
e
e
e
e
e
"}
(5,1,1) = {"
e
e
e
e
e
e
e
e
e
e
e
e
e
e
e
e
e
e
K
e
e
K
e
e
e
K
e
e
e
e
e
e
e
e
e
e
e
e
e
e
"}
(6,1,1) = {"
e
e
e
e
e
a
L
L
L
L
L
L
L
L
L
L
L
a
F
F
F
F
F
F
F
L
L
L
L
L
L
L
L
L
a
e
e
e
e
e
"}
(7,1,1) = {"
e
e
e
e
e
L
Z
S
S
S
S
S
S
S
S
S
S
S
S
S
S
S
S
S
S
S
S
S
S
S
S
S
S
S
L
e
e
e
e
e
"}
(8,1,1) = {"
e
e
R
R
e
L
U
S
S
S
S
B
S
S
S
S
S
S
S
S
S
S
S
S
S
S
S
S
S
S
S
S
S
S
L
e
e
e
e
e
"}
(9,1,1) = {"
e
e
s
h
c
Q
o
S
S
S
S
S
S
S
S
S
S
S
S
S
S
S
S
S
S
S
S
S
S
S
S
S
S
S
L
e
e
e
e
e
"}
(10,1,1) = {"
e
e
m
m
e
L
S
S
S
S
B
S
S
B
S
S
S
S
S
S
S
S
S
S
S
S
S
B
S
S
S
S
S
S
L
e
e
e
e
e
"}
(11,1,1) = {"
e
e
e
e
e
a
S
S
S
S
S
S
S
S
S
B
S
S
S
S
S
S
S
S
S
S
S
B
S
S
S
S
S
S
L
e
e
e
e
e
"}
(12,1,1) = {"
e
e
e
e
e
L
S
S
B
S
S
S
A
S
S
S
S
S
S
S
S
S
S
S
S
A
S
B
S
A
S
S
S
S
L
e
e
e
e
e
"}
(13,1,1) = {"
e
e
e
e
e
L
S
S
S
S
S
S
S
S
S
S
S
S
S
S
S
S
S
S
B
B
B
B
B
B
B
S
S
S
L
e
e
e
e
e
"}
(14,1,1) = {"
e
e
e
e
e
L
S
S
S
S
B
S
S
B
S
S
S
S
S
S
S
S
S
S
S
S
S
B
S
S
S
S
S
S
L
e
e
e
e
e
"}
(15,1,1) = {"
e
e
e
e
e
L
S
S
S
S
S
S
S
S
S
S
S
S
S
S
S
S
S
S
S
S
S
B
S
S
S
S
S
S
L
e
K
e
e
e
"}
(16,1,1) = {"
e
e
e
K
e
L
S
S
S
S
S
B
S
S
S
S
S
S
S
S
S
S
S
S
S
S
S
B
S
S
S
S
S
S
F
e
K
e
e
e
"}
(17,1,1) = {"
e
e
e
K
K
L
S
S
S
S
S
S
S
S
S
S
S
S
S
S
S
S
S
S
S
S
S
S
S
S
S
S
S
S
F
e
K
e
e
e
"}
(18,1,1) = {"
e
e
e
K
e
F
S
S
S
S
S
S
S
S
S
S
S
S
H
S
p
S
H
S
S
S
S
S
S
S
S
S
S
S
F
K
K
K
e
e
"}
(19,1,1) = {"
e
e
e
K
e
F
S
S
S
B
B
B
B
B
S
S
S
S
H
S
d
S
H
S
S
S
S
S
S
S
S
S
S
S
F
e
K
e
e
e
"}
(20,1,1) = {"
e
e
e
K
e
F
S
S
S
S
S
B
S
S
S
S
S
S
H
S
T
S
H
S
S
S
S
S
S
S
S
S
S
S
F
e
K
e
e
e
"}
(21,1,1) = {"
e
e
e
K
e
F
S
S
S
S
S
S
S
S
S
S
S
S
H
M
r
w
H
S
S
S
S
S
S
S
S
S
S
S
F
e
K
e
e
e
"}
(22,1,1) = {"
e
e
e
K
K
L
S
S
S
S
S
B
S
S
S
S
S
S
H
S
X
S
H
S
S
S
S
S
S
S
S
S
S
S
F
e
K
e
e
e
"}
(23,1,1) = {"
e
e
e
K
e
L
S
S
S
B
B
B
B
B
S
S
S
S
H
S
j
S
H
S
S
S
S
S
S
S
S
S
S
S
L
K
K
K
e
e
"}
(24,1,1) = {"
e
e
e
e
e
L
S
S
S
S
S
S
S
S
S
S
S
S
H
S
J
S
H
S
S
S
S
S
S
S
S
S
S
S
F
e
K
e
e
e
"}
(25,1,1) = {"
e
e
e
e
e
L
S
S
S
S
S
S
S
S
S
S
S
S
S
S
S
S
S
S
S
S
S
S
S
S
S
S
S
S
F
e
K
e
e
e
"}
(26,1,1) = {"
e
e
e
e
e
L
S
S
S
S
S
S
S
S
S
S
S
S
S
S
S
S
S
S
S
S
S
B
S
S
S
S
S
S
F
e
K
e
e
e
"}
(27,1,1) = {"
e
e
e
e
e
L
S
S
S
S
S
S
S
S
S
S
S
S
S
S
S
S
S
S
S
S
S
B
S
S
S
S
S
S
L
e
K
e
e
e
"}
(28,1,1) = {"
e
e
e
e
e
L
S
S
S
S
S
A
S
S
S
S
S
S
S
S
S
S
S
S
S
S
S
B
S
S
S
S
S
S
L
e
K
e
e
e
"}
(29,1,1) = {"
e
e
e
e
e
L
S
S
S
S
S
S
S
S
S
S
S
S
S
S
S
S
S
S
S
A
S
B
S
S
S
S
S
S
L
e
e
e
e
e
"}
(30,1,1) = {"
e
a
L
L
L
a
S
S
B
B
B
B
B
B
B
S
S
S
S
S
S
S
S
S
S
S
S
B
S
S
S
S
S
S
L
e
e
e
e
e
"}
(31,1,1) = {"
e
L
S
S
S
L
S
S
S
S
S
S
S
S
S
S
S
S
S
S
S
S
B
B
B
B
B
B
S
S
S
S
S
S
L
e
e
e
e
e
"}
(32,1,1) = {"
e
L
S
S
l
L
S
S
S
S
S
A
S
S
S
S
S
S
S
S
S
S
S
S
S
S
S
S
S
A
S
S
S
S
L
e
e
e
e
e
"}
(33,1,1) = {"
e
L
S
S
S
L
S
S
S
S
S
S
S
S
S
S
S
S
S
S
S
S
S
S
S
S
S
S
S
S
S
S
S
S
L
e
e
e
e
e
"}
(34,1,1) = {"
e
a
L
L
L
a
S
S
S
S
S
S
S
S
S
S
S
S
S
S
S
S
S
S
S
S
S
S
S
S
S
S
S
S
L
e
e
e
e
e
"}
(35,1,1) = {"
e
e
e
e
e
a
L
L
L
L
L
L
L
F
F
F
F
L
L
L
L
L
L
L
L
L
L
L
L
L
L
L
L
L
a
e
e
e
e
e
"}
(36,1,1) = {"
e
e
e
e
e
e
e
e
e
e
e
e
K
e
e
e
e
K
e
e
e
e
e
e
e
e
e
e
e
e
e
e
e
e
e
e
e
e
e
e
"}
(37,1,1) = {"
e
e
e
e
e
e
e
e
e
e
e
K
K
K
K
K
K
K
K
e
e
e
e
e
e
e
e
e
e
e
e
e
e
e
e
e
e
e
e
e
"}
(38,1,1) = {"
e
e
e
e
e
e
e
e
e
e
e
e
e
e
e
e
e
e
e
e
e
e
e
e
e
e
e
e
e
e
e
e
e
e
e
e
e
e
e
e
"}
(39,1,1) = {"
e
e
e
e
e
e
e
e
e
e
e
e
e
e
e
e
e
e
e
e
e
e
e
e
e
e
e
e
e
e
e
e
e
e
e
e
e
e
e
e
"}
(40,1,1) = {"
e
e
e
e
e
e
e
e
e
e
e
e
e
e
e
e
e
e
e
e
e
e
e
e
e
e
e
e
e
e
e
e
e
e
e
e
e
e
e
e
"}
