//MAP CONVERTED BY dmm2tgm.py THIS HEADER COMMENT PREVENTS RECONVERSION, DO NOT REMOVE
"z" = (
/turf/open/floor/plasteel,
/area/space)
"A" = (
/turf/closed/wall/debug,
/area/space)
"C" = (
/obj/structure/table/debug,
/turf/open/space/basic,
/area/space)
"T" = (
/turf/open/space/basic,
/area/space)

(1,1,1) = {"
z
z
z
z
z
z
z
z
z
z
z
z
z
z
z
z
z
z
z
z
z
z
z
z
"}
(2,1,1) = {"
z
T
T
T
T
T
T
T
T
T
T
T
T
T
T
T
T
T
T
T
T
T
T
z
"}
(3,1,1) = {"
z
T
A
A
T
A
A
T
A
A
A
A
A
T
T
T
A
T
T
T
A
T
T
z
"}
(4,1,1) = {"
z
T
A
A
A
A
A
T
A
A
A
A
A
T
T
A
A
A
T
T
A
T
T
z
"}
(5,1,1) = {"
z
T
T
A
T
A
T
T
A
A
T
A
A
T
A
A
T
A
A
T
A
T
T
z
"}
(6,1,1) = {"
z
T
A
A
A
A
A
T
A
A
A
A
A
T
T
A
A
A
T
T
T
T
T
z
"}
(7,1,1) = {"
z
T
A
A
T
A
A
T
A
A
A
A
A
T
T
T
A
T
T
A
A
A
T
z
"}
(8,1,1) = {"
z
T
T
T
T
T
T
T
T
T
T
T
T
T
T
T
T
T
T
T
T
T
T
z
"}
(9,1,1) = {"
z
T
A
A
T
T
T
A
T
T
T
A
A
T
T
A
A
A
A
A
A
A
T
z
"}
(10,1,1) = {"
z
T
A
A
A
T
A
A
A
T
A
A
A
A
T
A
T
A
A
A
T
A
T
z
"}
(11,1,1) = {"
z
T
T
A
A
T
T
A
T
T
T
A
A
T
T
A
A
A
T
A
A
A
T
z
"}
(12,1,1) = {"
z
T
T
T
T
T
T
T
T
T
T
A
A
T
T
A
A
T
T
T
A
A
T
z
"}
(13,1,1) = {"
z
T
T
A
A
T
A
A
A
T
T
T
T
T
T
A
A
A
T
A
A
A
T
z
"}
(14,1,1) = {"
z
T
A
A
A
T
A
A
A
T
T
A
T
T
T
A
T
A
A
A
T
A
T
z
"}
(15,1,1) = {"
z
T
A
A
T
T
A
A
A
T
A
A
A
A
T
A
A
A
A
A
A
A
T
z
"}
(16,1,1) = {"
z
T
T
T
T
T
T
T
T
T
A
A
A
A
T
T
T
T
T
T
T
T
T
z
"}
(17,1,1) = {"
z
T
T
T
A
A
A
T
A
T
T
A
T
T
T
C
T
T
C
z
z
z
z
z
"}
(18,1,1) = {"
z
T
A
T
T
A
T
T
T
T
T
T
T
T
C
C
C
T
C
C
T
C
C
C
"}
(19,1,1) = {"
z
T
A
A
T
T
T
A
T
C
z
C
C
z
z
z
z
z
C
z
T
C
C
C
"}
(20,1,1) = {"
z
T
A
T
T
T
A
A
T
z
T
T
T
C
T
C
C
T
T
z
T
C
C
C
"}
(21,1,1) = {"
z
T
T
T
A
T
T
A
T
C
C
C
T
C
T
C
C
T
T
z
T
T
T
z
"}
(22,1,1) = {"
z
T
T
A
A
A
T
T
T
C
z
C
T
T
T
T
T
T
C
z
C
C
T
z
"}
(23,1,1) = {"
z
T
T
T
T
T
T
T
T
C
C
C
T
C
C
C
T
C
C
z
C
C
C
z
"}
(24,1,1) = {"
z
z
z
z
z
z
z
z
z
z
z
z
T
T
C
T
T
T
C
z
T
C
C
z
"}
(25,1,1) = {"
T
T
T
T
T
T
T
T
T
z
z
z
z
z
z
z
z
z
z
z
z
z
z
z
"}
(26,1,1) = {"
T
T
T
T
T
T
T
T
T
z
C
C
C
C
C
C
C
T
z
T
T
C
C
z
"}
(27,1,1) = {"
T
T
T
T
T
T
T
T
T
z
C
C
C
C
C
C
C
T
z
C
C
C
C
z
"}
(28,1,1) = {"
T
T
T
T
T
T
T
T
T
z
C
C
T
C
T
C
C
T
z
C
C
T
T
z
"}
(29,1,1) = {"
T
T
T
T
T
T
T
T
T
z
C
C
C
T
C
C
C
T
z
z
z
z
z
z
"}
(30,1,1) = {"
T
T
T
T
T
T
T
T
T
z
C
C
T
C
T
C
C
T
z
T
T
T
T
T
"}
(31,1,1) = {"
T
T
T
T
T
T
T
T
T
z
C
C
C
C
C
C
C
T
z
T
T
T
T
T
"}
(32,1,1) = {"
T
T
T
T
T
T
T
T
T
z
C
C
C
C
C
C
C
T
z
T
T
T
T
T
"}
(33,1,1) = {"
T
T
T
T
T
T
T
T
T
z
z
z
z
z
z
z
z
z
z
T
T
T
T
T
"}
(34,1,1) = {"
T
T
T
T
T
T
T
T
T
T
T
T
T
T
T
T
T
T
T
T
T
T
T
T
"}
(35,1,1) = {"
T
T
T
T
T
T
T
T
T
T
T
T
T
T
T
T
T
T
T
T
T
T
T
T
"}
(36,1,1) = {"
T
T
T
T
T
T
T
T
T
T
T
T
T
T
T
T
T
T
T
T
T
T
T
T
"}
(37,1,1) = {"
T
T
T
T
T
T
T
T
T
T
T
T
T
T
T
T
T
T
T
T
T
T
T
T
"}
(38,1,1) = {"
T
T
T
T
T
T
T
T
T
T
T
T
T
T
T
T
T
T
T
T
T
T
T
T
"}
(39,1,1) = {"
T
T
T
T
T
T
T
T
T
T
T
T
T
T
T
T
T
T
T
T
T
T
T
T
"}
(40,1,1) = {"
T
T
T
T
T
T
T
T
T
T
T
T
T
T
T
T
T
T
T
T
T
T
T
T
"}
(41,1,1) = {"
T
T
T
T
T
T
T
T
T
T
T
T
T
T
T
T
T
T
T
T
T
T
T
T
"}
(42,1,1) = {"
T
T
T
T
T
T
T
T
T
T
T
T
T
T
T
T
T
T
T
T
T
T
T
T
"}
(43,1,1) = {"
T
T
T
T
T
T
T
T
T
T
T
T
T
T
T
T
T
T
T
T
T
T
T
T
"}
(44,1,1) = {"
T
T
T
T
T
T
T
T
T
T
T
T
T
T
T
T
T
T
T
T
T
T
T
T
"}
(45,1,1) = {"
T
T
T
T
T
T
T
T
T
T
T
T
T
T
T
T
T
T
T
T
T
T
T
T
"}
(46,1,1) = {"
T
T
T
T
T
T
T
T
T
T
T
T
T
T
T
T
T
T
T
T
T
T
T
T
"}
(47,1,1) = {"
T
T
T
T
T
T
T
T
T
T
T
T
T
T
T
T
T
T
T
T
T
T
T
T
"}
(48,1,1) = {"
T
T
T
T
T
T
T
T
T
T
T
T
T
T
T
T
T
T
T
T
T
T
T
T
"}
