//MAP CONVERTED BY dmm2tgm.py THIS HEADER COMMENT PREVENTS RECONVERSION, DO NOT REMOVE
"aa" = (
/turf/template_noop,
/area/template_noop)
"ab" = (
/obj/machinery/porta_turret/syndicate/shuttle{
	dir = 9
	},
/turf/closed/wall/r_wall/syndicate,
/area/shuttle/syndicate/bridge)
"ac" = (
/turf/closed/wall/r_wall/syndicate,
/area/shuttle/syndicate/bridge)
"ae" = (
/obj/machinery/door/poddoor/shutters{
	id = "syndieshutters";
	name = "blast Shutters"
	},
/obj/effect/spawner/structure/window/reinforced/plasma/plastitanium,
/turf/open/floor/plating,
/area/shuttle/syndicate/bridge)
"af" = (
/turf/closed/wall/r_wall/syndicate,
/area/shuttle/syndicate/hallway)
"ag" = (
/obj/machinery/computer/records/medical/syndie,
/obj/effect/turf_decal/bot_white,
/turf/open/floor/iron/dark,
/area/shuttle/syndicate/bridge)
"ah" = (
/obj/machinery/computer/crew/syndie,
/obj/effect/turf_decal/bot_white,
/turf/open/floor/iron/dark,
/area/shuttle/syndicate/bridge)
"ai" = (
/obj/effect/turf_decal/bot_white,
/turf/open/floor/iron/dark,
/area/shuttle/syndicate/bridge)
"aj" = (
/obj/machinery/computer/shuttle_flight/syndicate,
/obj/effect/turf_decal/bot_white,
/turf/open/floor/iron/dark,
/area/shuttle/syndicate/bridge)
"ak" = (
/obj/structure/table/reinforced,
/turf/open/floor/iron/dark,
/area/shuttle/syndicate/bridge)
"al" = (
/obj/machinery/computer/camera_advanced/syndie,
/obj/effect/turf_decal/bot_white,
/turf/open/floor/iron/dark,
/area/shuttle/syndicate/bridge)
"am" = (
/obj/machinery/computer/records/security/syndie,
/obj/effect/turf_decal/bot_white,
/turf/open/floor/iron/dark,
/area/shuttle/syndicate/bridge)
"ao" = (
/obj/structure/chair/office{
	dir = 8;
	name = "tactical swivel chair"
	},
/turf/open/floor/iron/dark,
/area/shuttle/syndicate/bridge)
"ap" = (
/turf/open/floor/iron/dark,
/area/shuttle/syndicate/bridge)
"aq" = (
/obj/structure/chair/office{
	dir = 1;
	name = "tactical swivel chair"
	},
/obj/machinery/button/door{
	id = "syndieshutters";
	name = "Cockpit View Control";
	pixel_x = 32;
	pixel_y = 32;
	req_access_txt = "150"
	},
/turf/open/floor/iron/dark,
/area/shuttle/syndicate/bridge)
"ar" = (
/obj/structure/chair/office{
	dir = 4;
	name = "tactical swivel chair"
	},
/turf/open/floor/iron/dark,
/area/shuttle/syndicate/bridge)
"au" = (
/obj/machinery/status_display/evac,
/turf/closed/wall/r_wall/syndicate,
/area/shuttle/syndicate/bridge)
"ax" = (
/turf/closed/wall/r_wall/syndicate,
/area/shuttle/syndicate/eva)
"aB" = (
/turf/closed/wall/r_wall/syndicate,
/area/shuttle/syndicate/airlock)
"aD" = (
/turf/open/floor/iron/dark,
/area/shuttle/syndicate/hallway)
"aJ" = (
/turf/closed/wall/r_wall/syndicate,
/area/shuttle/syndicate/medical)
"aK" = (
/turf/closed/wall/r_wall/syndicate/nodiagonal,
/area/shuttle/syndicate/medical)
"aL" = (
/obj/machinery/suit_storage_unit/syndicate,
/obj/effect/turf_decal/stripes/line{
	dir = 5
	},
/turf/open/floor/mineral/plastitanium,
/area/shuttle/syndicate/eva)
"aN" = (
/obj/machinery/portable_atmospherics/canister/oxygen,
/obj/effect/turf_decal/bot_white,
/turf/open/floor/iron/dark,
/area/shuttle/syndicate/eva)
"aO" = (
/obj/structure/chair/fancy/shuttle{
	dir = 4;
	name = "tactical chair"
	},
/obj/effect/turf_decal/bot_white,
/turf/open/floor/iron/dark,
/area/shuttle/syndicate/airlock)
"aQ" = (
/obj/structure/table/reinforced,
/obj/item/storage/toolbox/syndicate,
/obj/item/crowbar/red,
/obj/effect/turf_decal/stripes/line{
	dir = 9
	},
/turf/open/floor/mineral/plastitanium/red,
/area/shuttle/syndicate/airlock)
"aR" = (
/obj/machinery/suit_storage_unit/syndicate,
/obj/effect/turf_decal/stripes/line{
	dir = 4
	},
/turf/open/floor/mineral/plastitanium,
/area/shuttle/syndicate/eva)
"aS" = (
/obj/structure/tank_dispenser/oxygen,
/obj/effect/turf_decal/bot_white,
/turf/open/floor/iron/dark,
/area/shuttle/syndicate/eva)
"aT" = (
/obj/effect/turf_decal/stripes/line{
	dir = 8
	},
/turf/open/floor/mineral/plastitanium/red,
/area/shuttle/syndicate/airlock)
"aU" = (
/obj/machinery/portable_atmospherics/canister/oxygen,
/obj/machinery/light{
	dir = 4
	},
/obj/effect/turf_decal/bot_white,
/turf/open/floor/iron/dark,
/area/shuttle/syndicate/eva)
"aV" = (
/obj/effect/spawner/structure/window/reinforced/plasma/plastitanium,
/turf/open/floor/plating,
/area/shuttle/syndicate/hallway)
"aX" = (
/obj/structure/chair/fancy/shuttle{
	dir = 4;
	name = "tactical chair"
	},
/obj/effect/turf_decal/bot_white,
/obj/machinery/light{
	dir = 8
	},
/turf/open/floor/iron/dark,
/area/shuttle/syndicate/airlock)
"aY" = (
/obj/machinery/door/poddoor{
	id = "smindicate";
	name = "outer Blast Door"
	},
/obj/machinery/button/door{
	id = "smindicate";
	name = "external door control";
	pixel_y = 26;
	req_access_txt = "150"
	},
/obj/docking_port/mobile{
	dheight = 1;
	dir = 8;
	dwidth = 12;
	height = 17;
	hidden = 1;
	id = "syndicate";
	movement_force = list("KNOCKDOWN" = 0, "THROW" = 0);
	name = "syndicate infiltrator";
	port_direction = 4;
	width = 23
	},
/obj/structure/fans/tiny,
/obj/effect/turf_decal/stripes/line{
	dir = 1
	},
/turf/open/floor/plating,
/area/shuttle/syndicate/airlock)
"aZ" = (
/turf/open/floor/iron/dark,
/area/shuttle/syndicate/eva)
"bc" = (
/turf/open/floor/iron/dark,
/area/shuttle/syndicate/airlock)
"bd" = (
/obj/structure/sign/warning/vacuum/external,
/turf/closed/wall/r_wall/syndicate,
/area/shuttle/syndicate/airlock)
"be" = (
/obj/machinery/suit_storage_unit/syndicate,
/obj/effect/turf_decal/stripes/line{
	dir = 6
	},
/turf/open/floor/mineral/plastitanium,
/area/shuttle/syndicate/eva)
"bg" = (
/obj/effect/spawner/structure/window/reinforced/plasma/plastitanium,
/turf/open/floor/plating,
/area/shuttle/syndicate/eva)
"bh" = (
/obj/effect/spawner/structure/window/reinforced/plasma/plastitanium,
/turf/open/floor/plating,
/area/shuttle/syndicate/airlock)
"bi" = (
/obj/structure/rack,
/obj/effect/turf_decal/bot_white,
/obj/effect/turf_decal/stripes/line{
	dir = 10
	},
/obj/item/clothing/suit/space/syndicate,
/obj/item/clothing/head/helmet/space/syndicate,
/turf/open/floor/mineral/plastitanium/red,
/area/shuttle/syndicate/airlock)
"bj" = (
/turf/closed/wall/r_wall/syndicate/nodiagonal,
/area/shuttle/syndicate/armory)
"bk" = (
/obj/machinery/status_display/ai,
/turf/closed/wall/r_wall/syndicate,
/area/shuttle/syndicate/medical)
"bm" = (
/turf/closed/wall/r_wall/syndicate,
/area/shuttle/syndicate/armory)
"bn" = (
/obj/machinery/status_display/evac,
/turf/closed/wall/r_wall/syndicate,
/area/shuttle/syndicate/armory)
"bo" = (
/obj/machinery/nuclearbomb/syndicate{
	anchored = 1
	},
/obj/machinery/door/window{
	dir = 1
	},
/turf/open/floor/circuit/red,
/area/shuttle/syndicate/hallway)
"bq" = (
/obj/machinery/sleeper/syndie{
	dir = 4
	},
/obj/effect/turf_decal/bot_white,
/turf/open/floor/iron/dark,
/area/shuttle/syndicate/medical)
"br" = (
/turf/open/floor/iron/dark,
/area/shuttle/syndicate/medical)
"bs" = (
/obj/machinery/light{
	dir = 1
	},
/turf/open/floor/iron/dark,
/area/shuttle/syndicate/medical)
"bt" = (
/obj/item/reagent_containers/cup/bottle/epinephrine{
	pixel_x = 6
	},
/obj/item/reagent_containers/cup/bottle/charcoal{
	pixel_x = -3
	},
/obj/item/reagent_containers/cup/bottle/epinephrine{
	pixel_x = -3;
	pixel_y = 8
	},
/obj/item/reagent_containers/cup/bottle/charcoal{
	pixel_x = 6;
	pixel_y = 8
	},
/obj/item/reagent_containers/syringe/epinephrine{
	pixel_x = 3;
	pixel_y = -2
	},
/obj/item/reagent_containers/syringe/epinephrine{
	pixel_x = 4;
	pixel_y = 1
	},
/obj/item/reagent_containers/syringe/epinephrine{
	pixel_x = -2;
	pixel_y = 5
	},
/obj/item/reagent_containers/syringe/epinephrine{
	pixel_x = 2;
	pixel_y = 8
	},
/obj/structure/table/reinforced,
/obj/effect/turf_decal/bot_white,
/turf/open/floor/iron/dark,
/area/shuttle/syndicate/medical)
"bu" = (
/obj/structure/table/reinforced,
/obj/item/stack/medical/gauze,
/obj/item/stack/medical/bruise_pack,
/obj/item/stack/medical/ointment,
/obj/effect/turf_decal/bot_white,
/turf/open/floor/iron/dark,
/area/shuttle/syndicate/medical)
"bv" = (
/obj/effect/spawner/structure/window/reinforced/plasma/plastitanium,
/turf/open/floor/plating,
/area/shuttle/syndicate/medical)
"bw" = (
/obj/effect/spawner/structure/window/reinforced/plasma/plastitanium,
/turf/open/floor/plating,
/area/shuttle/syndicate/armory)
"bx" = (
/obj/item/stock_parts/cell/high{
	pixel_x = -3;
	pixel_y = 3
	},
/obj/item/stock_parts/cell/high,
/obj/structure/table/reinforced,
/turf/open/floor/iron/dark,
/area/shuttle/syndicate/armory)
"by" = (
/obj/item/screwdriver{
	pixel_y = 9
	},
/obj/item/assembly/voice{
	pixel_y = 3
	},
/obj/structure/table/reinforced,
/turf/open/floor/iron/dark,
/area/shuttle/syndicate/armory)
"bz" = (
/obj/item/wrench,
/obj/item/assembly/infra,
/obj/structure/table/reinforced,
/obj/machinery/light{
	dir = 1
	},
/turf/open/floor/iron/dark,
/area/shuttle/syndicate/armory)
"bA" = (
/obj/item/assembly/signaler,
/obj/item/assembly/signaler,
/obj/item/assembly/prox_sensor{
	pixel_x = -8;
	pixel_y = 4
	},
/obj/item/assembly/prox_sensor{
	pixel_x = -8;
	pixel_y = 4
	},
/obj/structure/table/reinforced,
/turf/open/floor/iron/dark,
/area/shuttle/syndicate/armory)
"bB" = (
/obj/item/weldingtool/largetank{
	pixel_y = 3
	},
/obj/item/multitool,
/obj/structure/table/reinforced,
/turf/open/floor/iron/dark,
/area/shuttle/syndicate/armory)
"bC" = (
/obj/structure/bed/roller,
/obj/machinery/iv_drip,
/obj/effect/turf_decal/bot_white,
/turf/open/floor/iron/dark,
/area/shuttle/syndicate/medical)
"bI" = (
/obj/effect/turf_decal/stripes/line{
	dir = 9
	},
/mob/living/simple_animal/bot/medbot/nukie,
/turf/open/floor/mineral/plastitanium/red,
/area/shuttle/syndicate/medical)
"bJ" = (
/obj/effect/turf_decal/stripes/line{
	dir = 1
	},
/turf/open/floor/mineral/plastitanium/red,
/area/shuttle/syndicate/medical)
"bK" = (
/obj/machinery/door/airlock/hatch{
	req_access_txt = "150"
	},
/obj/effect/turf_decal/stripes/line{
	dir = 1
	},
/turf/open/floor/mineral/plastitanium/red,
/area/shuttle/syndicate/medical)
"bL" = (
/obj/effect/turf_decal/stripes/line{
	dir = 1
	},
/turf/open/floor/mineral/plastitanium/red,
/area/shuttle/syndicate/hallway)
"bM" = (
/obj/machinery/door/airlock/hatch{
	req_access_txt = "150"
	},
/obj/effect/turf_decal/stripes/line{
	dir = 1
	},
/turf/open/floor/mineral/plastitanium/red,
/area/shuttle/syndicate/armory)
"bN" = (
/obj/effect/turf_decal/stripes/line{
	dir = 1
	},
/turf/open/floor/mineral/plastitanium/red,
/area/shuttle/syndicate/armory)
"bO" = (
/obj/effect/turf_decal/stripes/line{
	dir = 5
	},
/turf/open/floor/mineral/plastitanium/red,
/area/shuttle/syndicate/armory)
"bQ" = (
/obj/structure/closet/syndicate/personal,
/obj/effect/turf_decal/bot_white,
/turf/open/floor/iron/dark,
/area/shuttle/syndicate/armory)
"bS" = (
/obj/effect/turf_decal/stripes/line{
	dir = 10
	},
/turf/open/floor/mineral/plastitanium/red,
/area/shuttle/syndicate/medical)
"bT" = (
/obj/effect/turf_decal/stripes/line,
/turf/open/floor/mineral/plastitanium/red,
/area/shuttle/syndicate/medical)
"bU" = (
/obj/effect/turf_decal/stripes/line,
/turf/open/floor/mineral/plastitanium/red,
/area/shuttle/syndicate/hallway)
"bV" = (
/obj/effect/turf_decal/stripes/line,
/turf/open/floor/mineral/plastitanium/red,
/area/shuttle/syndicate/armory)
"bW" = (
/obj/effect/turf_decal/stripes/line{
	dir = 6
	},
/turf/open/floor/mineral/plastitanium/red,
/area/shuttle/syndicate/armory)
"bX" = (
/obj/structure/closet/syndicate/nuclear,
/obj/effect/turf_decal/bot_white,
/turf/open/floor/iron/dark,
/area/shuttle/syndicate/armory)
"cl" = (
/obj/effect/spawner/structure/window/reinforced,
/turf/open/floor/plating,
/area/shuttle/syndicate/hallway)
"cp" = (
/obj/structure/table/optable,
/obj/item/surgical_drapes,
/obj/effect/turf_decal/bot_white,
/turf/open/floor/iron/dark,
/area/shuttle/syndicate/medical)
"cr" = (
/obj/structure/shuttle/engine/heater,
/obj/structure/window/reinforced/spawner/directional/north,
/obj/effect/turf_decal/stripes/line,
/turf/open/floor/plating/airless,
/area/shuttle/syndicate/hallway)
"cs" = (
/obj/machinery/recharge_station,
/turf/open/floor/circuit/red,
/area/shuttle/syndicate/armory)
"ct" = (
/obj/machinery/telecomms/allinone{
	intercept = 1
	},
/turf/open/floor/circuit/red,
/area/shuttle/syndicate/armory)
"cu" = (
/obj/structure/shuttle/engine/heater,
/obj/structure/window/reinforced/spawner/directional/north,
/obj/effect/turf_decal/stripes/line,
/turf/open/floor/plating/airless,
/area/shuttle/syndicate/medical)
"cv" = (
/obj/structure/shuttle/engine/propulsion/left,
/obj/effect/turf_decal/stripes/line,
/turf/open/floor/plating/airless,
/area/shuttle/syndicate/hallway)
"cw" = (
/obj/structure/shuttle/engine/propulsion,
/obj/effect/turf_decal/stripes/line,
/turf/open/floor/plating/airless,
/area/shuttle/syndicate/hallway)
"cx" = (
/obj/structure/shuttle/engine/propulsion/right,
/obj/effect/turf_decal/stripes/line,
/turf/open/floor/plating/airless,
/area/shuttle/syndicate/hallway)
"cy" = (
/obj/structure/shuttle/engine/heater,
/obj/structure/window/reinforced/spawner/directional/north,
/obj/effect/turf_decal/stripes/line,
/turf/open/floor/plating/airless,
/area/shuttle/syndicate/armory)
"cz" = (
/obj/structure/shuttle/engine/propulsion/left,
/obj/effect/turf_decal/stripes/line,
/turf/open/floor/plating/airless,
/area/shuttle/syndicate/medical)
"cA" = (
/obj/structure/shuttle/engine/propulsion,
/obj/effect/turf_decal/stripes/line,
/turf/open/floor/plating/airless,
/area/shuttle/syndicate/medical)
"cB" = (
/obj/structure/shuttle/engine/propulsion/right,
/obj/effect/turf_decal/stripes/line,
/turf/open/floor/plating/airless,
/area/shuttle/syndicate/medical)
"cE" = (
/obj/structure/shuttle/engine/propulsion/left,
/obj/effect/turf_decal/stripes/line,
/turf/open/floor/plating/airless,
/area/shuttle/syndicate/armory)
"cF" = (
/obj/structure/shuttle/engine/propulsion,
/obj/effect/turf_decal/stripes/line,
/turf/open/floor/plating/airless,
/area/shuttle/syndicate/armory)
"cG" = (
/obj/structure/shuttle/engine/propulsion/right,
/obj/effect/turf_decal/stripes/line,
/turf/open/floor/plating/airless,
/area/shuttle/syndicate/armory)
"dp" = (
/obj/machinery/porta_turret/syndicate/shuttle{
	dir = 10
	},
/turf/closed/wall/r_wall/syndicate,
/area/shuttle/syndicate/bridge)
"he" = (
/obj/structure/table/reinforced,
/obj/machinery/status_display/ai{
	pixel_x = 32
	},
/obj/item/storage/fancy/donut_box,
/obj/machinery/light{
	dir = 4
	},
/obj/effect/turf_decal/tile/neutral/fourcorners/contrasted,
/turf/open/floor/iron/dark,
/area/shuttle/syndicate/bridge)
"hQ" = (
/obj/structure/table/reinforced,
/obj/machinery/status_display/evac{
	pixel_x = -32
	},
/obj/item/clipboard,
/obj/machinery/light{
	dir = 8
	},
/obj/item/folder/red,
/obj/item/toy/figure/syndie,
/obj/effect/turf_decal/tile/neutral/fourcorners/contrasted,
/turf/open/floor/iron/dark,
/area/shuttle/syndicate/bridge)
"iF" = (
/obj/structure/table/reinforced,
/obj/item/stack/cable_coil/white,
/obj/item/stack/cable_coil/white,
/obj/item/crowbar/red,
/obj/effect/turf_decal/tile/neutral/fourcorners/contrasted,
/turf/open/floor/iron/dark,
/area/shuttle/syndicate/hallway)
"jp" = (
/obj/machinery/door/airlock/hatch{
	name = "Cockpit";
	req_access_txt = "150"
	},
/obj/effect/turf_decal/tile/neutral/fourcorners/contrasted,
/turf/open/floor/iron/dark,
/area/shuttle/syndicate/bridge)
"kp" = (
/obj/item/storage/firstaid/regular{
	pixel_x = 3;
	pixel_y = 3
	},
/obj/item/storage/firstaid/fire,
/obj/item/storage/firstaid/regular{
	pixel_x = -3;
	pixel_y = -3
	},
/obj/structure/table/reinforced,
/obj/effect/turf_decal/tile/neutral/half/contrasted{
	dir = 8
	},
/turf/open/floor/iron/dark,
/area/shuttle/syndicate/medical)
"lD" = (
/obj/structure/chair/fancy/shuttle{
	dir = 4;
	name = "tactical chair"
	},
/obj/effect/turf_decal/tile/neutral/fourcorners/contrasted,
/turf/open/floor/iron/dark,
/area/shuttle/syndicate/hallway)
"mt" = (
/obj/structure/window/reinforced/spawner/directional/west,
/obj/item/storage/firstaid/regular{
	pixel_x = 3;
	pixel_y = 3
	},
/obj/item/storage/firstaid/brute,
/obj/item/storage/firstaid/regular{
	pixel_x = -3;
	pixel_y = -3
	},
/obj/structure/table/reinforced,
/obj/effect/turf_decal/tile/neutral/half/contrasted{
	dir = 8
	},
/turf/open/floor/iron/dark,
/area/shuttle/syndicate/medical)
"nc" = (
/obj/machinery/door/window{
	dir = 1;
	name = "Technological Storage";
	req_access_txt = "150"
	},
/obj/effect/turf_decal/tile/neutral/half/contrasted{
	dir = 8
	},
/turf/open/floor/iron/dark,
/area/shuttle/syndicate/armory)
"nS" = (
/obj/machinery/light{
	dir = 4
	},
/obj/effect/turf_decal/tile/neutral/fourcorners/contrasted,
/turf/open/floor/iron/dark,
/area/shuttle/syndicate/armory)
"pd" = (
/obj/machinery/porta_turret/syndicate/shuttle{
	dir = 5
	},
/turf/closed/wall/r_wall/syndicate,
/area/shuttle/syndicate/bridge)
"qa" = (
/obj/item/cautery,
/obj/item/scalpel,
/obj/structure/table/reinforced,
/obj/effect/turf_decal/tile/neutral/fourcorners/contrasted,
/turf/open/floor/iron/dark,
/area/shuttle/syndicate/medical)
"tW" = (
/obj/effect/turf_decal/tile/neutral/fourcorners/contrasted,
/turf/open/floor/iron/dark,
/area/shuttle/syndicate/medical)
"uc" = (
/obj/structure/table/reinforced,
/obj/item/storage/box/handcuffs{
	pixel_x = 3;
	pixel_y = 3
	},
/obj/item/storage/box/zipties,
/obj/effect/turf_decal/tile/neutral/fourcorners/contrasted,
/turf/open/floor/iron/dark,
/area/shuttle/syndicate/hallway)
"vo" = (
/obj/machinery/light{
	dir = 8
	},
/obj/effect/turf_decal/tile/neutral/fourcorners/contrasted,
/turf/open/floor/iron/dark,
/area/shuttle/syndicate/hallway)
"vv" = (
/obj/structure/reagent_dispensers/fueltank,
/obj/effect/turf_decal/bot_white,
/turf/open/floor/iron/dark,
/area/shuttle/syndicate/eva)
"wJ" = (
/obj/structure/window/reinforced/spawner/directional/north,
/obj/structure/table/reinforced,
/obj/item/aicard,
/obj/effect/turf_decal/tile/neutral/half/contrasted{
	dir = 8
	},
/turf/open/floor/iron/dark,
/area/shuttle/syndicate/armory)
"wK" = (
/obj/machinery/door/window{
	dir = 1;
	name = "Surgery";
	req_access_txt = "150"
	},
/obj/effect/turf_decal/tile/neutral/half/contrasted{
	dir = 8
	},
/turf/open/floor/iron/dark,
/area/shuttle/syndicate/medical)
"yk" = (
/obj/structure/window/reinforced/spawner/directional/north,
/obj/effect/turf_decal/tile/neutral/half/contrasted{
	dir = 8
	},
/turf/open/floor/iron/dark,
/area/shuttle/syndicate/medical)
"yv" = (
/obj/structure/chair/fancy/shuttle{
	dir = 4;
	name = "tactical chair"
	},
/obj/machinery/light{
	dir = 8
	},
/obj/effect/turf_decal/tile/neutral/fourcorners/contrasted,
/turf/open/floor/iron/dark,
/area/shuttle/syndicate/hallway)
"Af" = (
/obj/effect/turf_decal/tile/neutral/half/contrasted{
	dir = 8
	},
/turf/open/floor/iron/dark,
/area/shuttle/syndicate/bridge)
"Cf" = (
/obj/effect/turf_decal/tile/neutral/half/contrasted{
	dir = 8
	},
/turf/open/floor/iron/dark,
/area/shuttle/syndicate/armory)
"Cs" = (
/obj/structure/sink{
	dir = 4;
	pixel_x = 11
	},
/obj/structure/mirror{
	pixel_x = 30
	},
/obj/effect/turf_decal/tile/neutral/fourcorners/contrasted,
/turf/open/floor/iron/dark,
/area/shuttle/syndicate/medical)
"Do" = (
/obj/structure/chair/fancy/shuttle{
	dir = 8;
	name = "tactical chair"
	},
/obj/machinery/light{
	dir = 4
	},
/obj/effect/turf_decal/tile/neutral/fourcorners/contrasted,
/turf/open/floor/iron/dark,
/area/shuttle/syndicate/hallway)
"El" = (
/obj/structure/window/reinforced/spawner/directional/north,
/obj/item/bodypart/arm/right/robot,
/obj/item/bodypart/arm/left/robot,
/obj/structure/table/reinforced,
/obj/item/toy/plush/nukeplushie,
/obj/effect/turf_decal/tile/neutral/half/contrasted{
	dir = 8
	},
/turf/open/floor/iron/dark,
/area/shuttle/syndicate/medical)
"Fn" = (
/obj/item/sbeacondrop/bomb{
	pixel_y = 5
	},
/obj/item/sbeacondrop/bomb,
/obj/structure/table/reinforced,
/obj/effect/turf_decal/tile/neutral/half/contrasted{
	dir = 8
	},
/turf/open/floor/iron/dark,
/area/shuttle/syndicate/armory)
"Ft" = (
/obj/machinery/turretid{
	ailock = 1;
	desc = "Used to control the shuttle's automated defenses.";
	icon_state = "control_kill";
	lethal = 1;
	name = "infiltrator turret controls";
	pixel_y = -30;
	req_access = null;
	req_access_txt = "150"
	},
/obj/effect/turf_decal/tile/neutral/half/contrasted{
	dir = 8
	},
/turf/open/floor/iron/dark,
/area/shuttle/syndicate/bridge)
"FN" = (
/obj/effect/turf_decal/tile/neutral/half/contrasted{
	dir = 8
	},
/turf/open/floor/iron/dark,
/area/shuttle/syndicate/medical)
"Ga" = (
/obj/machinery/door/airlock/external{
	req_access_txt = "150"
	},
/obj/effect/turf_decal/tile/neutral/fourcorners/contrasted,
/turf/open/floor/iron/dark,
/area/shuttle/syndicate/airlock)
"Hf" = (
/obj/item/surgicaldrill,
/obj/item/circular_saw,
/obj/structure/table/reinforced,
/obj/machinery/light{
	dir = 8
	},
/obj/effect/turf_decal/tile/neutral/fourcorners/contrasted,
/turf/open/floor/iron/dark,
/area/shuttle/syndicate/medical)
"Hs" = (
/obj/structure/table/reinforced,
/obj/item/reagent_containers/cup/beaker/large,
/obj/item/reagent_containers/cup/beaker,
/obj/item/reagent_containers/dropper,
/obj/effect/turf_decal/tile/neutral/half/contrasted{
	dir = 8
	},
/turf/open/floor/iron/dark,
/area/shuttle/syndicate/medical)
"Mn" = (
/obj/machinery/door/airlock/external{
	name = "E.V.A. Gear Storage";
	req_access_txt = "150"
	},
/obj/effect/turf_decal/tile/neutral/fourcorners/contrasted,
/turf/open/floor/iron/dark,
/area/shuttle/syndicate/eva)
"MJ" = (
/obj/machinery/porta_turret/syndicate/shuttle{
	dir = 6
	},
/turf/closed/wall/r_wall/syndicate,
/area/shuttle/syndicate/bridge)
"NF" = (
/obj/effect/turf_decal/tile/neutral/fourcorners/contrasted,
/turf/open/floor/iron/dark,
/area/shuttle/syndicate/eva)
"Ok" = (
/obj/structure/window/reinforced/spawner/directional/north,
/obj/effect/turf_decal/tile/neutral/half/contrasted{
	dir = 8
	},
/turf/open/floor/iron/dark,
/area/shuttle/syndicate/armory)
"Qz" = (
/obj/item/grenade/syndieminibomb{
	pixel_x = 4;
	pixel_y = 2
	},
/obj/item/grenade/syndieminibomb{
	pixel_x = -1
	},
/obj/structure/table/reinforced,
/obj/structure/window/reinforced/spawner/directional/east,
/obj/item/grenade/plastic/c4,
/obj/item/grenade/plastic/c4,
/obj/item/grenade/plastic/c4,
/obj/item/grenade/plastic/c4,
/obj/item/grenade/plastic/c4,
/obj/effect/turf_decal/tile/neutral/half/contrasted{
	dir = 8
	},
/turf/open/floor/iron/dark,
/area/shuttle/syndicate/armory)
"QY" = (
/obj/item/retractor,
/obj/item/hemostat,
/obj/structure/table/reinforced,
/obj/effect/turf_decal/tile/neutral/fourcorners/contrasted,
/turf/open/floor/iron/dark,
/area/shuttle/syndicate/medical)
"RL" = (
/obj/machinery/light{
	dir = 4
	},
/obj/effect/turf_decal/tile/neutral/fourcorners/contrasted,
/turf/open/floor/iron/dark,
/area/shuttle/syndicate/hallway)
"Sc" = (
/obj/effect/turf_decal/tile/neutral/fourcorners/contrasted,
/turf/open/floor/iron/dark,
/area/shuttle/syndicate/armory)
"Ub" = (
/obj/machinery/door/airlock/external{
	name = "Ready Room";
	req_access_txt = "150"
	},
/obj/effect/turf_decal/tile/neutral/fourcorners/contrasted,
/turf/open/floor/iron/dark,
/area/shuttle/syndicate/hallway)
"Xt" = (
/obj/effect/turf_decal/tile/neutral/fourcorners/contrasted,
/turf/open/floor/iron/dark,
/area/shuttle/syndicate/airlock)
"Yv" = (
/obj/effect/turf_decal/tile/neutral/fourcorners/contrasted,
/turf/open/floor/iron/dark,
/area/shuttle/syndicate/hallway)
"ZM" = (
/obj/structure/chair/fancy/shuttle{
	dir = 8;
	name = "tactical chair"
	},
/obj/effect/turf_decal/tile/neutral/fourcorners/contrasted,
/turf/open/floor/iron/dark,
/area/shuttle/syndicate/hallway)

(1,1,1) = {"
aa
aa
aa
aa
aa
aa
aa
aa
aa
aa
aa
aa
aa
ab
aJ
aJ
aJ
aJ
aJ
aJ
aJ
aJ
aJ
"}
(2,1,1) = {"
aa
aa
aa
aa
aa
aa
aa
ab
ax
ax
ax
ax
ax
aJ
bq
bC
bq
Hs
El
Hf
qa
cu
cz
"}
(3,1,1) = {"
aa
aa
aa
aa
aa
aa
aa
ax
aL
aR
aR
aR
be
aJ
br
FN
tW
tW
wK
tW
cp
cu
cA
"}
(4,1,1) = {"
aa
aa
aa
aa
aa
aa
aa
ax
NF
NF
NF
NF
NF
bk
bs
FN
bI
bS
yk
Cs
QY
cu
cB
"}
(5,1,1) = {"
ab
ac
ac
ac
ac
aa
aa
ax
NF
NF
NF
NF
NF
aJ
bt
FN
bJ
bT
mt
aK
aJ
aJ
MJ
"}
(6,1,1) = {"
ac
ag
hQ
Af
ac
dp
aa
ax
aN
aS
aU
aZ
vv
aJ
bu
FN
bJ
bT
kp
aJ
aa
aa
aa
"}
(7,1,1) = {"
ae
ah
ao
Af
ac
af
af
ax
ax
ax
ax
Mn
bg
aK
bv
bv
bK
bv
aJ
aJ
af
af
aa
"}
(8,1,1) = {"
ae
ai
ap
Af
au
iF
lD
yv
lD
lD
aV
Yv
Yv
Yv
Yv
vo
bL
bU
Yv
cl
cr
cv
aa
"}
(9,1,1) = {"
ae
aj
aq
Af
jp
Yv
aD
aD
aD
Yv
Ub
Yv
aD
aD
aD
aD
bL
bU
Yv
bo
cr
cw
aa
"}
(10,1,1) = {"
ae
ak
ap
Ft
ac
uc
ZM
Do
ZM
ZM
aV
Yv
Yv
Yv
Yv
RL
bL
bU
Yv
cl
cr
cx
aa
"}
(11,1,1) = {"
ae
al
ar
Af
ac
af
af
af
af
aB
aB
Ga
bh
bj
bw
bw
bM
bw
bm
bm
af
af
aa
"}
(12,1,1) = {"
ac
am
he
Af
ac
MJ
aa
aB
aO
aO
aX
bc
aO
bm
bx
Cf
bN
bV
Fn
bm
aa
aa
aa
"}
(13,1,1) = {"
pd
ac
ac
ac
ac
aa
aa
aB
Xt
Xt
Xt
Xt
Xt
bm
by
Cf
bN
bV
Qz
bj
bm
bm
dp
"}
(14,1,1) = {"
aa
aa
aa
aa
aa
aa
aa
aB
Xt
Xt
Xt
Xt
Xt
bn
bz
Cf
bO
bW
Ok
Sc
cs
cy
cE
"}
(15,1,1) = {"
aa
aa
aa
aa
aa
aa
aa
aB
aQ
aT
aT
aT
bi
bm
bA
Cf
Sc
Sc
nc
Sc
ct
cy
cF
"}
(16,1,1) = {"
aa
aa
aa
aa
aa
aa
aa
pd
aB
aB
aY
bd
aB
bm
bB
Cf
bQ
bX
wJ
nS
cs
cy
cG
"}
(17,1,1) = {"
aa
aa
aa
aa
aa
aa
aa
aa
aa
aa
aa
aa
aa
pd
bm
bm
bm
bm
bm
bm
bm
bm
bm
"}
