//MAP CONVERTED BY dmm2tgm.py THIS HEADER COMMENT PREVENTS RECONVERSION, DO NOT REMOVE
"a" = (
/turf/template_noop,
/area/template_noop)
"b" = (
/turf/closed/wall/mineral/titanium,
/area/shuttle/arrival)
"c" = (
/obj/machinery/door/airlock/titanium{
	name = "Arrivals Shuttle Airlock";
	dir = 1
	},
/obj/structure/fans/tiny{
	dir = 1
	},
/turf/open/floor/plating,
/area/shuttle/arrival)
"d" = (
/obj/effect/spawner/structure/window/shuttle{
	dir = 1
	},
/turf/open/floor/plating,
/area/shuttle/arrival)
"e" = (
/obj/structure/table{
	dir = 1
	},
/obj/item/storage/firstaid/regular{
	pixel_y = -4;
	dir = 1
	},
/obj/item/storage/toolbox/emergency{
	dir = 1
	},
/turf/open/floor/mineral/titanium/blue,
/area/shuttle/arrival)
"f" = (
/turf/open/floor/mineral/titanium/blue,
/area/shuttle/arrival)
"g" = (
/obj/machinery/light{
	dir = 2
	},
/obj/structure/sign/poster/official/enlist{
	pixel_y = -32;
	dir = 1
	},
/turf/open/floor/mineral/titanium/blue,
/area/shuttle/arrival)
"h" = (
/obj/structure/closet/wardrobe/black{
	dir = 1
	},
/turf/open/floor/mineral/titanium/blue,
/area/shuttle/arrival)
"i" = (
/obj/structure/closet/wardrobe/mixed{
	dir = 1
	},
/turf/open/floor/mineral/titanium/blue,
/area/shuttle/arrival)
"j" = (
/obj/machinery/requests_console{
	department = "Arrival shuttle";
	name = "Arrivals Shuttle console";
	pixel_y = -30;
	dir = 1
	},
/obj/machinery/light{
	dir = 2
	},
/turf/open/floor/mineral/titanium/blue,
/area/shuttle/arrival)
"k" = (
/obj/structure/shuttle/engine/heater{
	dir = 4
	},
/obj/structure/window/reinforced{
	dir = 8
	},
/turf/open/floor/plating/airless,
/area/shuttle/arrival)
"l" = (
/obj/structure/shuttle/engine/propulsion/burst/right{
	dir = 4
	},
/turf/open/floor/plating/airless,
/area/shuttle/arrival)
"m" = (
/obj/structure/grille{
	dir = 1
	},
/obj/structure/window/shuttle{
	dir = 1
	},
/obj/machinery/door/poddoor/shutters/preopen{
	id = "arrivy";
	name = "ship shutters";
	dir = 1
	},
/turf/open/floor/plating,
/area/shuttle/arrival)
"n" = (
/obj/machinery/door/airlock/titanium{
	name = "Arrivals Shuttle Airlock";
	dir = 1
	},
/turf/open/floor/mineral/titanium/blue,
/area/shuttle/arrival)
"o" = (
/obj/structure/chair/comfy/shuttle{
	dir = 8
	},
/turf/open/floor/mineral/titanium,
/area/shuttle/arrival)
"p" = (
/obj/structure/shuttle/engine/propulsion{
	dir = 4
	},
/obj/docking_port/mobile/arrivals{
	height = 13;
	name = "pubby arrivals shuttle";
	width = 6;
	dir = 8;
	dwidth = 2
	},
/turf/open/floor/plating/airless,
/area/shuttle/arrival)
"q" = (
/obj/machinery/light/small{
	dir = 1
	},
/turf/open/floor/mineral/titanium/blue,
/area/shuttle/arrival)
"r" = (
/obj/structure/shuttle/engine/propulsion{
	dir = 4
	},
/turf/open/floor/plating/airless,
/area/shuttle/arrival)
"s" = (
/obj/structure/closet/emcloset{
	dir = 1
	},
/obj/item/storage/firstaid/o2{
	dir = 1
	},
/obj/item/tank/internals/emergency_oxygen{
	dir = 1
	},
/obj/item/clothing/mask/breath{
	dir = 1
	},
/turf/open/floor/mineral/titanium/blue,
/area/shuttle/arrival)
"t" = (
/obj/structure/extinguisher_cabinet{
	pixel_y = 29;
	dir = 1
	},
/obj/machinery/light{
	dir = 1
	},
/turf/open/floor/mineral/titanium/blue,
/area/shuttle/arrival)
"u" = (
/obj/item/radio/intercom{
	name = "Station Intercom (General)";
	pixel_y = 29;
	dir = 1
	},
/obj/machinery/light{
	dir = 1
	},
/turf/open/floor/mineral/titanium/blue,
/area/shuttle/arrival)
"v" = (
/obj/structure/shuttle/engine/propulsion/burst/left{
	dir = 4
	},
/turf/open/floor/plating/airless,
/area/shuttle/arrival)
"C" = (
/turf/open/floor/mineral/titanium,
/area/shuttle/arrival)

(1,1,1) = {"
a
b
m
m
b
a"}(2,1,1) = {"
a
b
q
f
b
a"}(3,1,1) = {"
b
b
n
n
b
b"}(4,1,1) = {"
b
s
C
C
e
b"}(5,1,1) = {"
c
f
o
o
f
c"}(6,1,1) = {"
b
t
C
C
g
b"}(7,1,1) = {"
d
f
o
o
h
d"}(8,1,1) = {"
d
f
C
C
i
d"}(9,1,1) = {"
d
f
o
o
f
d"}(10,1,1) = {"
b
u
o
o
j
b"}(11,1,1) = {"
c
f
C
C
f
c"}(12,1,1) = {"
b
k
k
k
k
b"}(13,1,1) = {"
b
v
r
p
l
b"}