//MAP CONVERTED BY dmm2tgm.py THIS HEADER COMMENT PREVENTS RECONVERSION, DO NOT REMOVE
"a" = (
/obj/effect/turf_decal/bot{
	dir = 4
	},
/turf/open/floor/mineral/plastitanium,
/area/shuttle/pod_shuttle)
"b" = (
/obj/effect/turf_decal/bot{
	dir = 4
	},
/obj/structure/closet/crate{
	dir = 1
	},
/obj/effect/spawner/lootdrop/maintenance/three{
	dir = 1
	},
/obj/structure/cable/yellow{
	icon_state = "1-2"
	},
/obj/item/pickaxe/emergency{
	dir = 4
	},
/turf/open/floor/mineral/plastitanium,
/area/shuttle/pod_shuttle)
"c" = (
/obj/structure/fans/tiny{
	dir = 1
	},
/obj/effect/turf_decal/stripes/line{
	dir = 4
	},
/obj/effect/turf_decal/stripes/line{
	dir = 8
	},
/obj/machinery/door/airlock/centcom{
	name = "Shuttle Airlock";
	opacity = 1;
	req_access_txt = "";
	dir = 1
	},
/turf/open/floor/mineral/plastitanium/red,
/area/shuttle/pod_shuttle)
"e" = (
/obj/structure/cable/yellow{
	icon_state = "4-8"
	},
/turf/open/floor/mineral/plastitanium,
/area/shuttle/pod_shuttle)
"f" = (
/obj/effect/turf_decal/bot{
	dir = 4
	},
/obj/machinery/modular_fabricator/autolathe/hacked{
	dir = 1
	},
/turf/open/floor/mineral/plastitanium,
/area/shuttle/pod_shuttle)
"h" = (
/turf/open/floor/mineral/plastitanium,
/area/shuttle/pod_shuttle)
"i" = (
/obj/structure/chair/comfy/shuttle{
	dir = 4
	},
/obj/effect/turf_decal/stripes/line{
	dir = 5
	},
/obj/machinery/power/apc/auto_name/west{
	pixel_x = -24
	},
/obj/structure/cable/yellow{
	icon_state = "0-4"
	},
/turf/open/floor/mineral/plastitanium/red,
/area/shuttle/pod_shuttle)
"j" = (
/turf/closed/wall/mineral/plastitanium,
/area/shuttle/pod_shuttle)
"k" = (
/obj/effect/turf_decal/stripes/corner{
	dir = 2
	},
/obj/structure/table/reinforced{
	dir = 1
	},
/obj/item/toy/nuke{
	dir = 1
	},
/obj/item/toy/cards/deck/syndicate{
	dir = 1
	},
/turf/open/floor/mineral/plastitanium,
/area/shuttle/pod_shuttle)
"m" = (
/turf/closed/wall/mineral/plastitanium/nodiagonal,
/area/shuttle/pod_shuttle)
"n" = (
/obj/effect/turf_decal/bot{
	dir = 4
	},
/obj/structure/closet/crate{
	dir = 1
	},
/obj/effect/spawner/lootdrop/maintenance/two{
	dir = 1
	},
/obj/item/clothing/glasses/sunglasses/advanced{
	dir = 1
	},
/obj/structure/cable/yellow{
	icon_state = "1-8"
	},
/turf/open/floor/mineral/plastitanium,
/area/shuttle/pod_shuttle)
"o" = (
/obj/structure/chair/comfy/shuttle{
	dir = 8
	},
/obj/effect/turf_decal/stripes/line{
	dir = 10
	},
/obj/machinery/light/small{
	dir = 4
	},
/turf/open/floor/mineral/plastitanium/red,
/area/shuttle/pod_shuttle)
"p" = (
/obj/structure/cable/yellow{
	icon_state = "1-2"
	},
/obj/structure/cable/yellow{
	icon_state = "2-8"
	},
/obj/structure/cable/yellow{
	icon_state = "2-4"
	},
/turf/open/floor/mineral/plastitanium,
/area/shuttle/pod_shuttle)
"q" = (
/obj/effect/turf_decal/stripes/line{
	dir = 2
	},
/obj/machinery/portable_atmospherics/canister/toxins{
	dir = 1
	},
/obj/machinery/atmospherics/components/unary/portables_connector/visible{
	dir = 8
	},
/obj/machinery/light/small{
	dir = 4
	},
/turf/open/floor/plating,
/area/shuttle/pod_shuttle)
"s" = (
/obj/structure/chair/comfy/shuttle{
	dir = 4
	},
/obj/effect/turf_decal/stripes/line{
	dir = 6
	},
/obj/machinery/light/small{
	dir = 8
	},
/turf/open/floor/mineral/plastitanium/red,
/area/shuttle/pod_shuttle)
"t" = (
/obj/structure/chair/comfy/shuttle{
	dir = 2
	},
/obj/effect/turf_decal/stripes/line{
	dir = 2
	},
/turf/open/floor/mineral/plastitanium,
/area/shuttle/pod_shuttle)
"x" = (
/obj/machinery/atmospherics/components/unary/shuttle/heater{
	dir = 2
	},
/obj/effect/spawner/structure/window/plastitanium{
	dir = 1
	},
/turf/open/floor/plating,
/area/shuttle/pod_shuttle)
"z" = (
/obj/machinery/computer/shuttle_flight/custom_shuttle/bluespace_pod/traitor{
	dir = 1
	},
/turf/open/floor/mineral/plastitanium/red,
/area/shuttle/pod_shuttle)
"A" = (
/obj/machinery/shuttle/engine/plasma{
	dir = 2
	},
/turf/open/floor/plating,
/area/shuttle/pod_shuttle)
"B" = (
/obj/effect/turf_decal/bot{
	dir = 4
	},
/obj/structure/closet/crate{
	dir = 1
	},
/obj/effect/spawner/lootdrop/maintenance{
	dir = 1
	},
/obj/structure/cable/yellow{
	icon_state = "1-2"
	},
/obj/item/stack/sheet/mineral/plasma/five{
	dir = 1
	},
/turf/open/floor/mineral/plastitanium,
/area/shuttle/pod_shuttle)
"C" = (
/obj/effect/turf_decal/stripes/line{
	dir = 2
	},
/obj/machinery/atmospherics/pipe/manifold/purple/visible{
	dir = 2
	},
/obj/structure/cable/yellow{
	icon_state = "0-2"
	},
/turf/open/floor/plating,
/area/shuttle/pod_shuttle)
"D" = (
/obj/machinery/computer/crew/syndie{
	dir = 1
	},
/turf/open/floor/mineral/plastitanium/red,
/area/shuttle/pod_shuttle)
"K" = (
/obj/structure/cable/yellow{
	icon_state = "1-8"
	},
/turf/open/floor/mineral/plastitanium,
/area/shuttle/pod_shuttle)
"M" = (
/obj/effect/turf_decal/stripes/line{
	dir = 2
	},
/turf/open/floor/mineral/plastitanium,
/area/shuttle/pod_shuttle)
"N" = (
/obj/structure/fans/tiny{
	dir = 1
	},
/obj/effect/turf_decal/stripes/line{
	dir = 8
	},
/obj/effect/turf_decal/stripes/line{
	dir = 4
	},
/obj/machinery/door/airlock/centcom{
	name = "Shuttle Airlock";
	opacity = 1;
	req_access_txt = "";
	dir = 1
	},
/obj/docking_port/mobile{
	dir = 8;
	dwidth = 5;
	height = 6;
	shuttle_object_type = /datum/orbital_object/shuttle/custom_shuttle;
	width = 10
	},
/turf/open/floor/mineral/plastitanium/red,
/area/shuttle/pod_shuttle)
"P" = (
/obj/effect/turf_decal/stripes/line{
	dir = 2
	},
/obj/machinery/light/small{
	dir = 8
	},
/obj/machinery/atmospherics/components/unary/plasma_refiner{
	dir = 4
	},
/turf/open/floor/plating,
/area/shuttle/pod_shuttle)
"Q" = (
/obj/effect/turf_decal/stripes/line{
	dir = 2
	},
/obj/machinery/atmospherics/pipe/manifold/purple/visible{
	dir = 2
	},
/obj/structure/cable/yellow{
	icon_state = "0-2"
	},
/mob/living/simple_animal/hostile/carp/cayenne,
/turf/open/floor/plating,
/area/shuttle/pod_shuttle)
"S" = (
/turf/template_noop,
/area/template_noop)
"T" = (
/obj/effect/spawner/structure/window/plastitanium{
	dir = 1
	},
/turf/open/floor/plating,
/area/shuttle/pod_shuttle)
"V" = (
/obj/machinery/computer/camera_advanced/syndie{
	dir = 1
	},
/turf/open/floor/mineral/plastitanium/red,
/area/shuttle/pod_shuttle)
"W" = (
/obj/effect/turf_decal/stripes/line{
	dir = 2
	},
/obj/machinery/atmospherics/pipe/manifold/purple/visible{
	dir = 2
	},
/obj/machinery/power/port_gen/pacman{
	dir = 1
	},
/obj/structure/cable/yellow{
	icon_state = "0-2"
	},
/turf/open/floor/plating,
/area/shuttle/pod_shuttle)
"X" = (
/obj/structure/chair/comfy/shuttle{
	dir = 8
	},
/obj/effect/turf_decal/stripes/line{
	dir = 9
	},
/turf/open/floor/mineral/plastitanium/red,
/area/shuttle/pod_shuttle)
"Y" = (
/obj/effect/turf_decal/stripes/corner{
	dir = 8
	},
/obj/structure/table/reinforced{
	dir = 1
	},
/obj/item/storage/toolbox/syndicate{
	dir = 1
	},
/turf/open/floor/mineral/plastitanium,
/area/shuttle/pod_shuttle)
"Z" = (
/obj/structure/cable/yellow{
	icon_state = "1-4"
	},
/turf/open/floor/mineral/plastitanium,
/area/shuttle/pod_shuttle)

(1,1,1) = {"
S
j
j
j
c
T
j
j
T
j
S"}(2,1,1) = {"
m
m
P
a
a
f
i
s
k
T
T"}(3,1,1) = {"
A
x
Q
Z
h
h
e
h
M
V
T"}(4,1,1) = {"
A
x
W
p
b
B
n
h
t
z
T"}(5,1,1) = {"
A
x
C
K
h
h
h
h
M
D
T"}(6,1,1) = {"
m
m
q
a
a
a
X
o
Y
T
T"}(7,1,1) = {"
S
j
j
j
N
T
j
j
T
j
S"}