//MAP CONVERTED BY dmm2tgm.py THIS HEADER COMMENT PREVENTS RECONVERSION, DO NOT REMOVE
"a" = (
/turf/closed/wall/mineral/titanium,
/area/shuttle/supply)
"b" = (
/obj/effect/turf_decal/tile/brown{
	dir = 4
	},
/obj/effect/turf_decal/tile/brown{
	dir = 8
	},
/obj/effect/turf_decal/stripes/line{
	dir = 10
	},
/turf/open/floor/mineral/titanium/yellow,
/area/shuttle/supply)
"c" = (
/obj/effect/turf_decal/tile/brown{
	dir = 4
	},
/obj/effect/turf_decal/tile/brown{
	dir = 8
	},
/obj/effect/turf_decal/stripes/line{
	dir = 2
	},
/turf/open/floor/mineral/titanium/yellow,
/area/shuttle/supply)
"d" = (
/obj/effect/turf_decal/tile/brown{
	dir = 4
	},
/obj/effect/turf_decal/tile/brown{
	dir = 8
	},
/obj/effect/turf_decal/stripes/line{
	dir = 6
	},
/turf/open/floor/mineral/titanium/yellow,
/area/shuttle/supply)
"e" = (
/obj/effect/turf_decal/tile/brown{
	dir = 4
	},
/obj/effect/turf_decal/tile/brown{
	dir = 8
	},
/obj/effect/turf_decal/stripes/line{
	dir = 9
	},
/turf/open/floor/mineral/titanium/yellow,
/area/shuttle/supply)
"f" = (
/obj/effect/turf_decal/tile/brown{
	dir = 4
	},
/obj/effect/turf_decal/tile/brown{
	dir = 8
	},
/obj/effect/turf_decal/stripes/corner{
	dir = 1
	},
/turf/open/floor/mineral/titanium/yellow,
/area/shuttle/supply)
"g" = (
/obj/effect/turf_decal/tile/brown{
	dir = 4
	},
/obj/effect/turf_decal/tile/brown{
	dir = 8
	},
/turf/open/floor/mineral/titanium/yellow,
/area/shuttle/supply)
"h" = (
/obj/effect/turf_decal/tile/brown{
	dir = 4
	},
/obj/effect/turf_decal/tile/brown{
	dir = 8
	},
/obj/effect/turf_decal/stripes/line{
	dir = 4
	},
/turf/open/floor/mineral/titanium/yellow,
/area/shuttle/supply)
"i" = (
/obj/machinery/door/poddoor{
	id = "QMLoaddoor";
	name = "Supply Dock Loading Door";
	dir = 1
	},
/obj/machinery/conveyor{
	dir = 8;
	id = "QMLoad";
	name = "off ramp"
	},
/obj/structure/fans/tiny{
	dir = 1
	},
/turf/open/floor/plating,
/area/shuttle/supply)
"j" = (
/obj/effect/turf_decal/loading_area{
	dir = 1
	},
/turf/open/floor/mineral/plastitanium,
/area/shuttle/supply)
"k" = (
/obj/effect/turf_decal/tile/brown{
	dir = 4
	},
/obj/effect/turf_decal/tile/brown{
	dir = 8
	},
/obj/effect/turf_decal/stripes/corner{
	dir = 8
	},
/obj/effect/turf_decal/stripes/corner{
	dir = 1
	},
/turf/open/floor/mineral/titanium/yellow,
/area/shuttle/supply)
"l" = (
/obj/effect/turf_decal/tile/brown{
	dir = 4
	},
/obj/effect/turf_decal/tile/brown{
	dir = 8
	},
/obj/effect/turf_decal/stripes/line{
	dir = 4
	},
/obj/machinery/light{
	dir = 4
	},
/turf/open/floor/mineral/titanium/yellow,
/area/shuttle/supply)
"m" = (
/obj/machinery/door/airlock/shuttle{
	name = "Supply Shuttle Airlock";
	req_access_txt = "31";
	dir = 1
	},
/obj/effect/decal/cleanable/dirt{
	dir = 4
	},
/obj/docking_port/mobile/supply{
	dir = 4;
	dwidth = 7
	},
/obj/structure/fans/tiny{
	dir = 1
	},
/turf/open/floor/mineral/plastitanium,
/area/shuttle/supply)
"n" = (
/obj/effect/turf_decal/tile/brown{
	dir = 4
	},
/obj/effect/turf_decal/tile/brown{
	dir = 8
	},
/obj/effect/turf_decal/stripes/line{
	dir = 2
	},
/obj/effect/turf_decal/stripes/corner{
	dir = 1
	},
/turf/open/floor/mineral/titanium/yellow,
/area/shuttle/supply)
"o" = (
/obj/effect/turf_decal/tile/brown{
	dir = 4
	},
/obj/effect/turf_decal/tile/brown{
	dir = 8
	},
/obj/effect/turf_decal/stripes/corner{
	dir = 8
	},
/turf/open/floor/mineral/titanium/yellow,
/area/shuttle/supply)
"p" = (
/obj/effect/turf_decal/tile/brown{
	dir = 4
	},
/obj/effect/turf_decal/tile/brown{
	dir = 8
	},
/obj/effect/turf_decal/stripes/line{
	dir = 8
	},
/obj/machinery/button/door{
	id = "QMLoaddoor";
	layer = 4;
	name = "Off Ramp Toggle";
	pixel_x = -24;
	pixel_y = -6;
	req_access_txt = "31";
	dir = 1
	},
/obj/machinery/button/door{
	id = "QMLoaddoor2";
	layer = 4;
	name = "On Ramp Toggle";
	pixel_x = -24;
	pixel_y = 6;
	req_access_txt = "31";
	dir = 1
	},
/turf/open/floor/mineral/titanium/yellow,
/area/shuttle/supply)
"q" = (
/obj/effect/turf_decal/tile/brown{
	dir = 4
	},
/obj/effect/turf_decal/tile/brown{
	dir = 8
	},
/obj/effect/turf_decal/stripes/line{
	dir = 4
	},
/obj/structure/sign/departments/cargo{
	pixel_x = 32;
	dir = 1
	},
/turf/open/floor/mineral/titanium/yellow,
/area/shuttle/supply)
"r" = (
/obj/machinery/door/airlock/shuttle{
	name = "Supply Shuttle Airlock";
	req_access_txt = "31";
	dir = 1
	},
/obj/effect/decal/cleanable/dirt{
	dir = 4
	},
/obj/structure/fans/tiny{
	dir = 1
	},
/turf/open/floor/mineral/plastitanium,
/area/shuttle/supply)
"s" = (
/obj/effect/turf_decal/tile/brown{
	dir = 4
	},
/obj/effect/turf_decal/tile/brown{
	dir = 8
	},
/obj/effect/turf_decal/stripes/line{
	dir = 1
	},
/obj/effect/turf_decal/stripes/corner{
	dir = 8
	},
/turf/open/floor/mineral/titanium/yellow,
/area/shuttle/supply)
"t" = (
/obj/machinery/door/poddoor{
	id = "QMLoaddoor2";
	name = "Supply Dock Loading Door";
	dir = 1
	},
/obj/machinery/conveyor{
	dir = 4;
	id = "QMLoad2";
	name = "on ramp"
	},
/obj/structure/fans/tiny{
	dir = 1
	},
/turf/open/floor/plating,
/area/shuttle/supply)
"u" = (
/obj/effect/turf_decal/loading_area{
	dir = 2
	},
/turf/open/floor/mineral/plastitanium,
/area/shuttle/supply)
"v" = (
/obj/effect/turf_decal/tile/brown{
	dir = 4
	},
/obj/effect/turf_decal/tile/brown{
	dir = 8
	},
/obj/effect/turf_decal/stripes/end{
	dir = 1
	},
/turf/open/floor/mineral/titanium/yellow,
/area/shuttle/supply)
"w" = (
/obj/effect/turf_decal/tile/brown{
	dir = 4
	},
/obj/effect/turf_decal/tile/brown{
	dir = 8
	},
/obj/effect/turf_decal/stripes/corner{
	dir = 4
	},
/turf/open/floor/mineral/titanium/yellow,
/area/shuttle/supply)
"x" = (
/obj/effect/turf_decal/tile/brown{
	dir = 4
	},
/obj/effect/turf_decal/tile/brown{
	dir = 8
	},
/obj/effect/turf_decal/stripes/line{
	dir = 5
	},
/turf/open/floor/mineral/titanium/yellow,
/area/shuttle/supply)
"y" = (
/obj/structure/sign/warning/fire{
	dir = 1
	},
/turf/closed/wall/mineral/titanium/nodiagonal,
/area/shuttle/supply)
"z" = (
/obj/effect/turf_decal/tile/brown{
	dir = 4
	},
/obj/effect/turf_decal/tile/brown{
	dir = 8
	},
/obj/effect/turf_decal/stripes/line{
	dir = 1
	},
/turf/open/floor/mineral/titanium/yellow,
/area/shuttle/supply)
"A" = (
/obj/effect/spawner/structure/window/shuttle{
	dir = 1
	},
/obj/structure/shuttle/engine/heater{
	dir = 1
	},
/turf/open/floor/plating,
/area/shuttle/supply)
"B" = (
/turf/template_noop,
/area/template_noop)
"C" = (
/obj/structure/shuttle/engine/propulsion/burst/left{
	dir = 1
	},
/obj/effect/turf_decal/stripes/line{
	dir = 1
	},
/turf/open/floor/plating/airless,
/area/shuttle/supply)
"D" = (
/obj/structure/shuttle/engine/propulsion{
	dir = 1
	},
/obj/effect/turf_decal/stripes/line{
	dir = 1
	},
/turf/open/floor/plating/airless,
/area/shuttle/supply)
"E" = (
/obj/structure/shuttle/engine/propulsion/burst/right{
	dir = 1
	},
/obj/effect/turf_decal/stripes/line{
	dir = 1
	},
/turf/open/floor/plating/airless,
/area/shuttle/supply)

(1,1,1) = {"
B
a
a
a
t
r
a
m
i
a
a
a"}(2,1,1) = {"
C
a
y
v
u
s
p
n
j
e
b
a"}(3,1,1) = {"
D
A
e
k
k
f
g
o
k
f
c
a"}(4,1,1) = {"
D
A
z
g
g
g
g
g
g
g
c
a"}(5,1,1) = {"
D
A
x
w
g
g
g
g
g
g
c
a"}(6,1,1) = {"
E
a
y
x
l
h
q
h
l
h
d
a"}(7,1,1) = {"
B
a
a
a
a
a
a
a
a
a
a
a"}