//MAP CONVERTED BY dmm2tgm.py THIS HEADER COMMENT PREVENTS RECONVERSION, DO NOT REMOVE
"a" = (
/turf/closed/wall/mineral/titanium/nodiagonal,
/area/shuttle/supply)
"b" = (
/turf/closed/wall/mineral/titanium,
/area/shuttle/supply)
"c" = (
/obj/effect/turf_decal/bot,
/turf/open/floor/mineral/plastitanium,
/area/shuttle/supply)
"d" = (
/obj/machinery/computer/cargo,
/turf/open/floor/mineral/plastitanium,
/area/shuttle/supply)
"e" = (
/turf/open/floor/mineral/titanium/blue,
/area/shuttle/supply)
"f" = (
/obj/machinery/conveyor{
	dir = 4;
	id = "QMLoad2"
	},
/obj/machinery/door/poddoor{
	id = "QMLoaddoor2";
	name = "supply dock loading door"
	},
/obj/structure/fans/tiny,
/turf/open/floor/plating,
/area/shuttle/supply)
"g" = (
/obj/machinery/door/airlock/titanium{
	name = "Supply Shuttle Airlock";
	req_access_txt = "31"
	},
/obj/structure/fans/tiny,
/turf/open/floor/plating,
/area/shuttle/supply)
"h" = (
/obj/structure/chair/comfy/shuttle{
	dir = 1
	},
/turf/open/floor/mineral/plastitanium,
/area/shuttle/supply)
"i" = (
/obj/machinery/door/airlock/titanium{
	name = "Supply Shuttle Airlock";
	req_access_txt = "31"
	},
/obj/docking_port/mobile/supply,
/obj/structure/fans/tiny,
/turf/open/floor/plating,
/area/shuttle/supply)
"j" = (
/obj/machinery/conveyor{
	dir = 8;
	id = "QMLoad"
	},
/obj/machinery/door/poddoor{
	id = "QMLoaddoor";
	name = "supply dock loading door"
	},
/obj/structure/fans/tiny,
/turf/open/floor/plating,
/area/shuttle/supply)
"l" = (
/turf/closed/wall/mineral/titanium/interior,
/area/shuttle/supply)
"m" = (
/obj/effect/turf_decal/stripes/corner{
	dir = 8
	},
/turf/open/floor/mineral/titanium/blue,
/area/shuttle/supply)
"n" = (
/obj/structure/table,
/obj/item/export_scanner,
/turf/open/floor/mineral/plastitanium,
/area/shuttle/supply)
"o" = (
/obj/effect/turf_decal/stripes/corner,
/turf/open/floor/mineral/plastitanium,
/area/shuttle/supply)
"p" = (
/obj/machinery/button/door{
	id = "QMLoaddoor2";
	name = "Loading Doors";
	pixel_x = 24;
	pixel_y = 8
	},
/obj/machinery/button/door{
	id = "QMLoaddoor";
	name = "Loading Doors";
	pixel_x = 24;
	pixel_y = -8
	},
/obj/machinery/light{
	dir = 4
	},
/obj/effect/turf_decal/stripes{
	dir = 8
	},
/turf/open/floor/mineral/titanium/blue,
/area/shuttle/supply)
"q" = (
/obj/structure/window/reinforced{
	dir = 1
	},
/obj/structure/shuttle/engine/heater,
/turf/open/floor/plating/airless,
/area/shuttle/supply)
"r" = (
/obj/effect/spawner/structure/window/shuttle,
/turf/open/floor/plating,
/area/shuttle/supply)
"s" = (
/turf/template_noop,
/area/template_noop)
"t" = (
/obj/structure/shuttle/engine/propulsion/burst/left,
/turf/open/floor/plating/airless,
/area/shuttle/supply)
"u" = (
/obj/structure/shuttle/engine/propulsion,
/turf/open/floor/plating/airless,
/area/shuttle/supply)
"v" = (
/obj/structure/shuttle/engine/propulsion/burst/right,
/turf/open/floor/plating/airless,
/area/shuttle/supply)
"x" = (
/obj/effect/turf_decal/stripes{
	dir = 1
	},
/obj/effect/turf_decal/stripes/corner{
	dir = 8
	},
/turf/open/floor/mineral/titanium/blue,
/area/shuttle/supply)
"A" = (
/obj/effect/turf_decal/stripes{
	dir = 8
	},
/turf/open/floor/mineral/titanium/blue,
/area/shuttle/supply)
"B" = (
/obj/effect/turf_decal/stripes{
	dir = 4
	},
/turf/open/floor/mineral/plastitanium,
/area/shuttle/supply)
"D" = (
/obj/machinery/holopad,
/turf/open/floor/mineral/plastitanium,
/area/shuttle/supply)
"H" = (
/obj/effect/turf_decal/delivery,
/turf/open/floor/mineral/plastitanium,
/area/shuttle/supply)
"J" = (
/obj/effect/turf_decal/stripes{
	dir = 1
	},
/turf/open/floor/mineral/titanium/blue,
/area/shuttle/supply)
"L" = (
/obj/effect/turf_decal/stripes{
	dir = 8
	},
/turf/open/floor/mineral/plastitanium,
/area/shuttle/supply)
"M" = (
/obj/effect/turf_decal/stripes/corner{
	dir = 4
	},
/turf/open/floor/mineral/titanium/blue,
/area/shuttle/supply)
"N" = (
/obj/effect/turf_decal/stripes/corner{
	dir = 8
	},
/turf/open/floor/mineral/plastitanium,
/area/shuttle/supply)
"O" = (
/obj/machinery/light{
	dir = 8
	},
/obj/effect/turf_decal/stripes{
	dir = 4
	},
/turf/open/floor/mineral/titanium/blue,
/area/shuttle/supply)
"P" = (
/obj/effect/turf_decal/stripes{
	dir = 1
	},
/obj/effect/turf_decal/stripes/corner,
/turf/open/floor/mineral/titanium/blue,
/area/shuttle/supply)
"R" = (
/obj/effect/turf_decal/stripes{
	dir = 4
	},
/turf/open/floor/mineral/titanium/blue,
/area/shuttle/supply)
"U" = (
/obj/effect/turf_decal/stripes,
/turf/open/floor/mineral/plastitanium,
/area/shuttle/supply)
"W" = (
/obj/machinery/computer/shuttle_flight/cargo,
/turf/open/floor/mineral/plastitanium,
/area/shuttle/supply)
"Y" = (
/obj/effect/turf_decal/stripes/corner,
/turf/open/floor/mineral/titanium/blue,
/area/shuttle/supply)
"Z" = (
/obj/effect/turf_decal/stripes/corner{
	dir = 1
	},
/turf/open/floor/mineral/titanium/blue,
/area/shuttle/supply)

(1,1,1) = {"
s
b
b
b
b
b
b
b
b
b
b
s
"}
(2,1,1) = {"
b
a
U
e
Y
O
R
R
M
l
b
t
"}
(3,1,1) = {"
r
n
N
L
x
H
H
H
Z
e
q
u
"}
(4,1,1) = {"
r
W
h
D
J
c
c
c
e
e
q
u
"}
(5,1,1) = {"
r
d
o
B
P
H
H
H
M
e
q
u
"}
(6,1,1) = {"
b
a
U
e
m
p
A
A
Z
l
b
v
"}
(7,1,1) = {"
s
b
b
f
g
b
i
j
b
b
b
s
"}
