//MAP CONVERTED BY dmm2tgm.py THIS HEADER COMMENT PREVENTS RECONVERSION, DO NOT REMOVE
"a" = (
/obj/machinery/computer/emergency_shuttle{
	dir = 8
	},
/turf/open/floor/mineral/titanium,
/area/shuttle/escape/backup)
"f" = (
/obj/structure/table/wood{
	dir = 1
	},
/obj/item/book/manual/random{
	dir = 1
	},
/turf/open/floor/mineral/titanium,
/area/shuttle/escape/backup)
"g" = (
/turf/open/floor/mineral/titanium,
/area/shuttle/escape/backup)
"i" = (
/obj/machinery/door/airlock/titanium{
	dir = 1
	},
/obj/docking_port/mobile/emergency/backup{
	dir = 4
	},
/obj/structure/fans/tiny{
	dir = 1
	},
/turf/open/floor/plating,
/area/shuttle/escape/backup)
"m" = (
/turf/closed/wall/mineral/titanium,
/area/shuttle/escape/backup)
"p" = (
/turf/open/floor/mineral/plastitanium/red,
/area/shuttle/escape/backup)
"q" = (
/obj/machinery/status_display/evac{
	dir = 1
	},
/turf/closed/wall/mineral/titanium,
/area/shuttle/escape/backup)
"u" = (
/obj/structure/chair/office/light{
	dir = 4
	},
/turf/open/floor/mineral/titanium,
/area/shuttle/escape/backup)
"x" = (
/obj/machinery/light{
	dir = 8
	},
/turf/open/floor/mineral/titanium,
/area/shuttle/escape/backup)
"F" = (
/obj/structure/table/wood{
	dir = 1
	},
/obj/item/paper/fluff/stations/centcom/broken_evac{
	dir = 1
	},
/turf/open/floor/mineral/titanium,
/area/shuttle/escape/backup)
"P" = (
/obj/machinery/light{
	dir = 4
	},
/turf/open/floor/mineral/titanium,
/area/shuttle/escape/backup)

(1,1,1) = {"
m
m
m
m
m
i
m
m"}(2,1,1) = {"
q
g
g
x
g
g
g
q"}(3,1,1) = {"
m
g
g
g
g
g
g
m"}(4,1,1) = {"
m
p
g
p
p
p
p
m"}(5,1,1) = {"
m
p
g
p
p
p
p
m"}(6,1,1) = {"
m
g
g
g
g
u
g
m"}(7,1,1) = {"
q
g
g
P
f
F
a
q"}(8,1,1) = {"
m
m
m
m
m
m
m
m"}