//MAP CONVERTED BY dmm2tgm.py THIS HEADER COMMENT PREVENTS RECONVERSION, DO NOT REMOVE
"am" = (
/obj/effect/turf_decal/tile/purple{
	dir = 4
	},
/obj/effect/turf_decal/tile/purple{
	dir = 1
	},
/obj/effect/turf_decal/tile/purple,
/turf/open/floor/mineral/titanium,
/area/shuttle/escape)
"aG" = (
/obj/structure/chair/comfy/shuttle{
	dir = 4
	},
/obj/structure/window/reinforced{
	dir = 8
	},
/obj/effect/turf_decal/stripes/line{
	dir = 6
	},
/turf/open/floor/mineral/titanium/yellow,
/area/shuttle/escape)
"bQ" = (
/obj/machinery/vending/medical,
/turf/open/floor/mineral/titanium/blue,
/area/shuttle/escape)
"cH" = (
/obj/effect/turf_decal/tile/purple,
/obj/effect/turf_decal/tile/purple{
	dir = 8
	},
/obj/effect/turf_decal/tile/purple{
	dir = 4
	},
/turf/open/floor/mineral/titanium,
/area/shuttle/escape)
"dh" = (
/obj/structure/window/reinforced{
	dir = 1
	},
/obj/structure/shuttle/engine/heater,
/turf/open/floor/plating/airless,
/area/shuttle/escape)
"dl" = (
/obj/structure/window/reinforced,
/obj/structure/chair/comfy/shuttle{
	dir = 4
	},
/turf/open/floor/mineral/plastitanium/red/brig,
/area/shuttle/escape)
"ds" = (
/turf/closed/wall/mineral/plastitanium,
/area/shuttle/escape)
"dx" = (
/obj/effect/turf_decal/tile/purple{
	dir = 1
	},
/obj/effect/turf_decal/tile/purple{
	dir = 8
	},
/turf/open/floor/mineral/titanium,
/area/shuttle/escape)
"fG" = (
/obj/effect/spawner/structure/window/shuttle,
/obj/machinery/door/poddoor/shutters/preopen{
	id = "corgshuttle";
	name = "Corgstation Shutters"
	},
/obj/machinery/door/firedoor/window,
/turf/open/floor/plating,
/area/shuttle/escape)
"fT" = (
/obj/machinery/door/airlock/titanium{
	name = "Emergency Shuttle Airlock"
	},
/obj/structure/fans/tiny,
/turf/open/floor/mineral/titanium,
/area/shuttle/escape)
"gg" = (
/obj/effect/turf_decal/stripes/line,
/obj/structure/table/reinforced,
/obj/machinery/cell_charger,
/obj/item/stock_parts/cell/high/plus{
	pixel_x = 1;
	pixel_y = 6
	},
/turf/open/floor/mineral/titanium/blue,
/area/shuttle/escape)
"gk" = (
/obj/structure/chair/comfy/shuttle{
	dir = 8
	},
/obj/structure/window/reinforced{
	dir = 4
	},
/obj/effect/turf_decal/stripes/line{
	dir = 8
	},
/turf/open/floor/mineral/titanium/yellow,
/area/shuttle/escape)
"gw" = (
/obj/machinery/door/airlock/public/glass{
	name = "Emergency Shuttle Cockpit";
	req_access_txt = "19"
	},
/obj/machinery/door/firedoor/border_only,
/obj/machinery/door/firedoor/border_only{
	dir = 1
	},
/obj/effect/turf_decal/stripes/line,
/obj/effect/turf_decal/stripes/line{
	dir = 1
	},
/turf/open/floor/mineral/titanium/white,
/area/shuttle/escape)
"hj" = (
/obj/effect/turf_decal/stripes/asteroid/full,
/obj/effect/turf_decal/stripes/line{
	dir = 8
	},
/turf/open/floor/mineral/titanium,
/area/shuttle/escape)
"hr" = (
/obj/structure/table/reinforced,
/obj/item/storage/box/flashes,
/obj/item/restraints/handcuffs,
/obj/item/restraints/handcuffs,
/obj/machinery/light/small{
	dir = 4
	},
/turf/open/floor/mineral/plastitanium/red/brig,
/area/shuttle/escape)
"iL" = (
/obj/structure/chair/comfy/shuttle{
	dir = 8
	},
/obj/effect/turf_decal/stripes/line{
	dir = 10
	},
/turf/open/floor/mineral/titanium/yellow,
/area/shuttle/escape)
"jk" = (
/obj/effect/turf_decal/tile/purple,
/obj/effect/turf_decal/tile/purple{
	dir = 1
	},
/obj/effect/turf_decal/tile/purple{
	dir = 8
	},
/turf/open/floor/mineral/titanium,
/area/shuttle/escape)
"jB" = (
/obj/structure/chair/comfy/shuttle{
	dir = 4
	},
/turf/open/floor/mineral/plastitanium/red/brig,
/area/shuttle/escape)
"jV" = (
/obj/machinery/rnd/production/techfab/department/medical,
/turf/open/floor/mineral/titanium/blue,
/area/shuttle/escape)
"kn" = (
/obj/machinery/computer/emergency_shuttle,
/turf/open/floor/mineral/titanium/blue,
/area/shuttle/escape)
"kx" = (
/turf/closed/wall/mineral/titanium,
/area/shuttle/escape)
"kS" = (
/turf/open/floor/mineral/plastitanium/red/brig,
/area/shuttle/escape)
"lW" = (
/obj/effect/turf_decal/stripes/asteroid/full,
/obj/machinery/light/small{
	dir = 4
	},
/obj/structure/closet/crate,
/turf/open/floor/mineral/titanium,
/area/shuttle/escape)
"mA" = (
/obj/structure/table/reinforced,
/obj/item/storage/firstaid{
	pixel_x = 3;
	pixel_y = 3
	},
/obj/item/storage/firstaid/fire,
/turf/open/floor/mineral/titanium/white,
/area/shuttle/escape)
"mX" = (
/obj/effect/turf_decal/tile/purple{
	dir = 4
	},
/obj/effect/turf_decal/tile/purple{
	dir = 1
	},
/obj/effect/turf_decal/tile/purple{
	dir = 8
	},
/turf/open/floor/mineral/titanium,
/area/shuttle/escape)
"nd" = (
/obj/effect/turf_decal/tile/purple{
	dir = 1
	},
/obj/effect/turf_decal/tile/purple{
	dir = 4
	},
/turf/open/floor/mineral/titanium,
/area/shuttle/escape)
"nw" = (
/obj/structure/table/glass,
/obj/item/reagent_containers/glass/bottle/epinephrine,
/obj/item/reagent_containers/syringe/epinephrine,
/turf/open/floor/mineral/titanium/blue,
/area/shuttle/escape)
"oE" = (
/obj/machinery/stasis,
/turf/open/floor/mineral/titanium/blue,
/area/shuttle/escape)
"pD" = (
/obj/structure/chair/comfy/shuttle{
	dir = 4
	},
/obj/structure/window/reinforced{
	dir = 8
	},
/obj/effect/turf_decal/stripes/line{
	dir = 5
	},
/turf/open/floor/mineral/titanium/yellow,
/area/shuttle/escape)
"qa" = (
/turf/template_noop,
/area/template_noop)
"qc" = (
/obj/machinery/light/small{
	dir = 4
	},
/obj/machinery/stasis,
/turf/open/floor/mineral/titanium/blue,
/area/shuttle/escape)
"qg" = (
/obj/effect/turf_decal/stripes/asteroid/full,
/obj/effect/turf_decal/stripes/corner{
	dir = 4
	},
/turf/open/floor/mineral/titanium,
/area/shuttle/escape)
"qP" = (
/obj/structure/table/reinforced,
/obj/item/storage/backpack/duffelbag/med/surgery,
/turf/open/floor/mineral/titanium/white,
/area/shuttle/escape)
"rD" = (
/obj/machinery/door/airlock/public/glass{
	name = "Emergency Shuttle Infirmary"
	},
/obj/machinery/door/firedoor/border_only{
	dir = 8
	},
/obj/machinery/door/firedoor/border_only{
	dir = 4
	},
/obj/effect/turf_decal/stripes/line{
	dir = 8
	},
/obj/effect/turf_decal/stripes/line{
	dir = 4
	},
/turf/open/floor/mineral/titanium/white,
/area/shuttle/escape)
"rP" = (
/obj/effect/turf_decal/stripes/asteroid/full,
/obj/effect/turf_decal/stripes/corner{
	dir = 1
	},
/obj/structure/closet/crate,
/turf/open/floor/mineral/titanium,
/area/shuttle/escape)
"sb" = (
/obj/effect/turf_decal/stripes/line{
	dir = 10
	},
/obj/structure/table/reinforced,
/obj/machinery/button/door{
	desc = "A remote control switch.";
	id = "corgshuttle";
	name = "Corgstation Shuttle Emergency Shutters";
	normaldoorcontrol = 0;
	pixel_y = 4
	},
/turf/open/floor/mineral/titanium/blue,
/area/shuttle/escape)
"sE" = (
/obj/effect/turf_decal/tile/purple,
/turf/open/floor/mineral/titanium,
/area/shuttle/escape)
"sN" = (
/obj/machinery/vending/wallmed{
	name = "Emergency NanoMed";
	use_power = 0
	},
/turf/closed/wall/mineral/titanium/nodiagonal,
/area/shuttle/escape)
"tn" = (
/obj/effect/turf_decal/stripes/line{
	dir = 6
	},
/obj/structure/table/reinforced,
/turf/open/floor/mineral/titanium/blue,
/area/shuttle/escape)
"uz" = (
/obj/machinery/door/airlock/public/glass{
	name = "Emergency Shuttle Brig";
	req_access_txt = "2"
	},
/obj/machinery/door/firedoor/border_only,
/obj/machinery/door/firedoor/border_only{
	dir = 1
	},
/obj/effect/turf_decal/stripes/line,
/obj/effect/turf_decal/stripes/line{
	dir = 1
	},
/turf/open/floor/mineral/plastitanium/red/brig,
/area/shuttle/escape)
"uY" = (
/obj/structure/closet/crate/internals,
/obj/effect/turf_decal/stripes/line{
	dir = 8
	},
/turf/open/floor/mineral/titanium/yellow,
/area/shuttle/escape)
"vc" = (
/turf/open/floor/mineral/titanium/white,
/area/shuttle/escape)
"wk" = (
/obj/structure/chair/comfy/shuttle{
	dir = 8
	},
/obj/machinery/light/small,
/obj/effect/turf_decal/tile/purple,
/obj/effect/turf_decal/tile/purple{
	dir = 4
	},
/obj/effect/turf_decal/tile/purple{
	dir = 8
	},
/turf/open/floor/mineral/titanium,
/area/shuttle/escape)
"wQ" = (
/obj/effect/turf_decal/stripes/corner{
	dir = 8
	},
/obj/structure/table/reinforced,
/obj/machinery/recharger,
/turf/open/floor/mineral/titanium/blue,
/area/shuttle/escape)
"xq" = (
/obj/effect/turf_decal/stripes/asteroid/full,
/obj/effect/turf_decal/stripes/corner{
	dir = 1
	},
/obj/machinery/light/small{
	dir = 8
	},
/obj/structure/closet,
/obj/item/clothing/gloves/fingerless,
/obj/item/clothing/gloves/fingerless,
/obj/item/clothing/under/rank/cargo/tech,
/obj/item/clothing/under/rank/cargo/tech,
/obj/item/radio/headset/headset_cargo,
/turf/open/floor/mineral/titanium,
/area/shuttle/escape)
"yQ" = (
/obj/structure/window/reinforced,
/obj/structure/chair/comfy/shuttle{
	dir = 8
	},
/turf/open/floor/mineral/plastitanium/red/brig,
/area/shuttle/escape)
"zp" = (
/obj/effect/turf_decal/tile/purple{
	dir = 1
	},
/obj/effect/turf_decal/tile/purple{
	dir = 4
	},
/obj/effect/turf_decal/tile/purple{
	dir = 8
	},
/turf/open/floor/mineral/titanium,
/area/shuttle/escape)
"Ad" = (
/turf/open/floor/mineral/titanium,
/area/shuttle/escape)
"AI" = (
/obj/structure/chair/comfy/shuttle{
	dir = 4
	},
/obj/structure/window/reinforced{
	dir = 8
	},
/obj/effect/turf_decal/stripes/line{
	dir = 4
	},
/turf/open/floor/mineral/titanium/yellow,
/area/shuttle/escape)
"AK" = (
/turf/open/floor/mineral/titanium/blue,
/area/shuttle/escape)
"AO" = (
/obj/structure/chair/comfy/shuttle{
	dir = 1
	},
/obj/effect/turf_decal/stripes/line,
/turf/open/floor/mineral/titanium/blue,
/area/shuttle/escape)
"Cc" = (
/obj/effect/turf_decal/stripes/asteroid/full,
/turf/open/floor/mineral/titanium,
/area/shuttle/escape)
"DO" = (
/obj/structure/shuttle/engine/propulsion,
/turf/open/floor/plating/airless,
/area/shuttle/escape)
"Ee" = (
/obj/effect/spawner/structure/window/shuttle,
/obj/machinery/door/firedoor/window,
/turf/open/floor/plating,
/area/shuttle/escape)
"EK" = (
/turf/closed/wall/mineral/titanium/nodiagonal,
/area/shuttle/escape)
"EQ" = (
/obj/machinery/light/small{
	dir = 8
	},
/obj/effect/turf_decal/stripes/line{
	dir = 1
	},
/turf/open/floor/mineral/titanium/white,
/area/shuttle/escape)
"Fh" = (
/obj/structure/table/glass,
/obj/item/storage/belt/medical,
/obj/item/storage/belt/medical,
/obj/item/reagent_containers/spray/cleaner{
	pixel_x = -3;
	pixel_y = 2
	},
/obj/item/clothing/neck/stethoscope,
/obj/item/clothing/neck/stethoscope,
/obj/item/clothing/glasses/hud/health,
/obj/item/clothing/glasses/hud/health,
/turf/open/floor/mineral/titanium/blue,
/area/shuttle/escape)
"Fr" = (
/obj/machinery/light/small,
/turf/open/floor/mineral/titanium/white,
/area/shuttle/escape)
"FS" = (
/obj/structure/chair/comfy/shuttle{
	dir = 8
	},
/obj/machinery/light/small{
	dir = 4
	},
/obj/effect/turf_decal/stripes/line{
	dir = 8
	},
/turf/open/floor/mineral/titanium/yellow,
/area/shuttle/escape)
"HU" = (
/obj/effect/turf_decal/tile/purple,
/obj/effect/turf_decal/tile/purple{
	dir = 1
	},
/obj/effect/turf_decal/tile/purple{
	dir = 4
	},
/turf/open/floor/mineral/titanium,
/area/shuttle/escape)
"IE" = (
/obj/effect/turf_decal/stripes/asteroid/full,
/obj/effect/turf_decal/stripes/line{
	dir = 1
	},
/turf/open/floor/mineral/titanium,
/area/shuttle/escape)
"Kf" = (
/obj/effect/turf_decal/tile/purple,
/obj/effect/turf_decal/tile/purple{
	dir = 4
	},
/obj/effect/turf_decal/tile/purple{
	dir = 8
	},
/turf/open/floor/mineral/titanium,
/area/shuttle/escape)
"KD" = (
/obj/effect/turf_decal/stripes/asteroid/full,
/obj/effect/turf_decal/stripes/line,
/obj/machinery/vending/wardrobe/cargo_wardrobe,
/turf/open/floor/mineral/titanium,
/area/shuttle/escape)
"KQ" = (
/obj/effect/turf_decal/stripes/asteroid/full,
/obj/effect/turf_decal/stripes/corner,
/obj/structure/closet,
/obj/item/clothing/gloves/fingerless,
/obj/item/clothing/gloves/fingerless,
/obj/item/clothing/under/rank/cargo/tech,
/obj/item/clothing/under/rank/cargo/tech,
/obj/item/radio/headset/headset_cargo,
/turf/open/floor/mineral/titanium,
/area/shuttle/escape)
"KV" = (
/obj/machinery/door/window/brigdoor/security/cell{
	id = "Cell 2";
	name = "Cell 2"
	},
/turf/open/floor/mineral/plastitanium/red/brig,
/area/shuttle/escape)
"Ls" = (
/obj/effect/turf_decal/tile/purple,
/obj/effect/turf_decal/tile/purple{
	dir = 8
	},
/turf/open/floor/mineral/titanium,
/area/shuttle/escape)
"LA" = (
/obj/effect/spawner/structure/window/shuttle,
/turf/open/floor/plating,
/area/shuttle/escape)
"LX" = (
/obj/structure/chair/comfy/shuttle{
	dir = 8
	},
/obj/structure/window/reinforced{
	dir = 4
	},
/obj/effect/turf_decal/stripes/line{
	dir = 9
	},
/turf/open/floor/mineral/titanium/yellow,
/area/shuttle/escape)
"Mh" = (
/obj/structure/chair/comfy/shuttle{
	dir = 8
	},
/obj/effect/turf_decal/tile/purple,
/obj/effect/turf_decal/tile/purple{
	dir = 4
	},
/obj/effect/turf_decal/tile/purple{
	dir = 1
	},
/turf/open/floor/mineral/titanium,
/area/shuttle/escape)
"MJ" = (
/obj/effect/turf_decal/stripes/line,
/obj/structure/table/reinforced,
/obj/item/paper_bin,
/obj/item/pen/blue{
	pixel_x = 1;
	pixel_y = 3
	},
/obj/item/holosign_creator/atmos{
	pixel_x = -3;
	pixel_y = -1
	},
/turf/open/floor/mineral/titanium/blue,
/area/shuttle/escape)
"Ow" = (
/obj/effect/turf_decal/stripes/line{
	dir = 8
	},
/obj/structure/chair/comfy/shuttle{
	dir = 8
	},
/turf/open/floor/mineral/titanium/blue,
/area/shuttle/escape)
"OF" = (
/obj/effect/turf_decal/stripes/line{
	dir = 1
	},
/obj/structure/table/reinforced,
/obj/item/book/manual/wiki/surgery,
/turf/open/floor/mineral/titanium/white,
/area/shuttle/escape)
"OG" = (
/obj/effect/turf_decal/tile/purple{
	dir = 4
	},
/turf/open/floor/mineral/titanium,
/area/shuttle/escape)
"PV" = (
/obj/structure/chair/comfy/shuttle{
	dir = 8
	},
/obj/structure/window/reinforced{
	dir = 4
	},
/obj/effect/turf_decal/stripes/line{
	dir = 10
	},
/turf/open/floor/mineral/titanium/yellow,
/area/shuttle/escape)
"Qy" = (
/obj/machinery/light/small{
	dir = 1
	},
/turf/open/floor/mineral/plastitanium/red/brig,
/area/shuttle/escape)
"Ss" = (
/obj/effect/turf_decal/stripes/asteroid/full,
/obj/effect/turf_decal/stripes/line,
/turf/open/floor/mineral/titanium,
/area/shuttle/escape)
"SU" = (
/obj/effect/turf_decal/stripes/line{
	dir = 4
	},
/obj/structure/chair/comfy/shuttle{
	dir = 4
	},
/turf/open/floor/mineral/titanium/blue,
/area/shuttle/escape)
"Uv" = (
/obj/docking_port/mobile/emergency{
	name = "Corg emergency shuttle"
	},
/obj/machinery/door/airlock/titanium{
	name = "Emergency Shuttle Airlock"
	},
/obj/structure/fans/tiny,
/turf/open/floor/mineral/titanium,
/area/shuttle/escape)
"Ux" = (
/obj/effect/turf_decal/stripes/corner,
/obj/structure/table/reinforced,
/obj/item/storage/firstaid/regular{
	pixel_x = 2;
	pixel_y = 3
	},
/obj/item/storage/firstaid/fire,
/obj/item/crowbar,
/turf/open/floor/mineral/titanium/blue,
/area/shuttle/escape)
"UH" = (
/obj/structure/chair/comfy/shuttle{
	dir = 8
	},
/turf/open/floor/mineral/plastitanium/red/brig,
/area/shuttle/escape)
"Vd" = (
/obj/structure/table/reinforced,
/obj/item/storage/firstaid{
	pixel_x = 3;
	pixel_y = 2
	},
/obj/item/storage/firstaid/brute,
/turf/open/floor/mineral/titanium/white,
/area/shuttle/escape)
"VA" = (
/obj/effect/turf_decal/tile/purple,
/obj/effect/turf_decal/tile/purple{
	dir = 8
	},
/obj/effect/turf_decal/tile/purple{
	dir = 1
	},
/turf/open/floor/mineral/titanium,
/area/shuttle/escape)
"Wb" = (
/obj/effect/turf_decal/tile/purple,
/obj/effect/turf_decal/tile/purple{
	dir = 4
	},
/turf/open/floor/mineral/titanium,
/area/shuttle/escape)
"WN" = (
/obj/effect/turf_decal/stripes/line{
	dir = 1
	},
/turf/open/floor/mineral/titanium/white,
/area/shuttle/escape)
"Xq" = (
/obj/structure/table/optable,
/turf/open/floor/mineral/titanium/white,
/area/shuttle/escape)
"XC" = (
/obj/machinery/light/small{
	dir = 8
	},
/obj/effect/turf_decal/tile/purple{
	dir = 1
	},
/obj/effect/turf_decal/tile/purple{
	dir = 8
	},
/turf/open/floor/mineral/titanium,
/area/shuttle/escape)
"XH" = (
/obj/machinery/door/airlock/titanium{
	name = "Emergency Shuttle Cargo"
	},
/obj/machinery/door/firedoor/border_only,
/obj/machinery/door/firedoor/border_only{
	dir = 1
	},
/obj/effect/turf_decal/stripes/line,
/obj/effect/turf_decal/stripes/line{
	dir = 1
	},
/turf/open/floor/mineral/titanium,
/area/shuttle/escape)
"Yl" = (
/obj/machinery/door/firedoor/border_only{
	dir = 8
	},
/obj/machinery/door/firedoor/border_only{
	dir = 4
	},
/obj/effect/turf_decal/stripes/line{
	dir = 8
	},
/obj/effect/turf_decal/stripes/line{
	dir = 4
	},
/turf/open/floor/mineral/titanium,
/area/shuttle/escape)
"Yq" = (
/obj/effect/turf_decal/tile/purple{
	dir = 4
	},
/obj/effect/turf_decal/tile/purple{
	dir = 1
	},
/turf/open/floor/mineral/titanium,
/area/shuttle/escape)
"Yw" = (
/obj/structure/table/glass,
/obj/item/book/manual/wiki/medicine,
/obj/item/stack/medical/gauze,
/turf/open/floor/mineral/titanium/blue,
/area/shuttle/escape)
"Zl" = (
/obj/machinery/light/small{
	dir = 4
	},
/obj/effect/turf_decal/tile/purple,
/obj/effect/turf_decal/tile/purple{
	dir = 4
	},
/turf/open/floor/mineral/titanium,
/area/shuttle/escape)
"ZY" = (
/obj/structure/chair/comfy/shuttle{
	dir = 8
	},
/obj/effect/turf_decal/stripes/line{
	dir = 8
	},
/turf/open/floor/mineral/titanium/yellow,
/area/shuttle/escape)

(1,1,1) = {"
qa
qa
qa
qa
kx
kx
kx
fT
kx
Uv
kx
Ee
Ee
Ee
kx
fT
kx
fT
kx
kx
ds
qa
"}
(2,1,1) = {"
qa
fG
fG
kx
kx
zp
dx
dx
XC
dx
dx
dx
dx
dx
XC
jk
kx
hj
xq
KQ
ds
ds
"}
(3,1,1) = {"
fG
fG
SU
SU
kx
nd
LX
LX
gk
PV
Ad
LX
gk
PV
Ad
Ls
kx
qg
Cc
Ss
dh
DO
"}
(4,1,1) = {"
fG
MJ
vc
Fr
kx
nd
pD
AI
AI
aG
Ad
pD
AI
aG
Ad
Ls
XH
IE
Cc
Ss
dh
DO
"}
(5,1,1) = {"
fG
wQ
sb
vc
gw
HU
Wb
Wb
Wb
Wb
Wb
OG
sE
Wb
Zl
Kf
kx
rP
lW
KD
dh
DO
"}
(6,1,1) = {"
fG
kn
AO
vc
kx
uY
FS
ZY
ZY
FS
iL
am
cH
sN
kx
rD
EK
kx
kx
kx
ds
ds
"}
(7,1,1) = {"
fG
Ux
tn
vc
kx
kx
kx
kx
LA
kx
EK
Yl
Yl
kx
bQ
AK
AK
AK
EQ
Vd
dh
DO
"}
(8,1,1) = {"
fG
gg
vc
Fr
kx
jB
dl
jB
jB
jB
LA
mX
VA
LA
jV
AK
AK
AK
WN
mA
dh
DO
"}
(9,1,1) = {"
fG
fG
Ow
Ow
kx
Qy
KV
kS
kS
kS
uz
Yq
Ls
LA
Fh
AK
AK
AK
WN
Xq
dh
DO
"}
(10,1,1) = {"
qa
fG
fG
kx
kx
UH
yQ
UH
hr
UH
LA
Mh
wk
kx
Yw
qc
nw
oE
OF
qP
ds
ds
"}
(11,1,1) = {"
qa
qa
qa
qa
kx
kx
kx
kx
Ee
kx
kx
Ee
Ee
kx
kx
kx
kx
kx
kx
kx
ds
qa
"}
