//MAP CONVERTED BY dmm2tgm.py THIS HEADER COMMENT PREVENTS RECONVERSION, DO NOT REMOVE
"aa" = (
/turf/template_noop,
/area/template_noop)
"ac" = (
/obj/effect/spawner/structure/window/shuttle,
/turf/open/floor/plating,
/area/shuttle/escape)
"ad" = (
/turf/closed/wall/mineral/titanium,
/area/shuttle/escape)
"ag" = (
/obj/structure/sign/warning/nosmoking,
/turf/closed/wall/mineral/titanium,
/area/shuttle/escape)
"al" = (
/obj/structure/table,
/obj/item/phone{
	pixel_x = -3;
	pixel_y = 3
	},
/obj/item/cigbutt/cigarbutt{
	pixel_x = 5;
	pixel_y = -1
	},
/turf/open/floor/mineral/titanium/blue,
/area/shuttle/escape)
"am" = (
/obj/machinery/computer/crew,
/turf/open/floor/mineral/titanium/blue,
/area/shuttle/escape)
"an" = (
/obj/machinery/computer/security,
/turf/open/floor/mineral/titanium/blue,
/area/shuttle/escape)
"ao" = (
/obj/structure/table,
/obj/item/storage/firstaid/regular,
/turf/open/floor/mineral/titanium/blue,
/area/shuttle/escape)
"ap" = (
/obj/structure/chair/comfy/shuttle{
	dir = 4
	},
/turf/open/floor/mineral/plastitanium/red/brig,
/area/shuttle/escape)
"aq" = (
/turf/open/floor/mineral/titanium/blue,
/area/shuttle/escape)
"ar" = (
/obj/structure/chair/comfy/shuttle,
/turf/open/floor/mineral/titanium/blue,
/area/shuttle/escape)
"as" = (
/obj/item/radio/intercom{
	dir = 4;
	name = "Station Intercom (General)";
	pixel_y = 27
	},
/obj/structure/chair/comfy/shuttle,
/obj/machinery/light{
	dir = 1
	},
/turf/open/floor/mineral/titanium/blue,
/area/shuttle/escape)
"at" = (
/obj/machinery/shower{
	dir = 8
	},
/turf/open/floor/mineral/titanium/blue,
/area/shuttle/escape)
"au" = (
/obj/structure/shuttle/engine/propulsion{
	dir = 8
	},
/turf/open/floor/plating/airless,
/area/shuttle/escape)
"av" = (
/obj/structure/shuttle/engine/heater{
	dir = 8
	},
/obj/structure/window/reinforced{
	dir = 4
	},
/turf/open/floor/plating/airless,
/area/shuttle/escape)
"aw" = (
/obj/structure/table,
/obj/item/storage/fancy/donut_box,
/turf/open/floor/mineral/titanium/blue,
/area/shuttle/escape)
"ax" = (
/obj/structure/chair/office{
	dir = 1
	},
/turf/open/floor/mineral/titanium/blue,
/area/shuttle/escape)
"ay" = (
/obj/structure/table,
/obj/item/restraints/handcuffs{
	pixel_y = 3
	},
/obj/machinery/light{
	dir = 4
	},
/turf/open/floor/mineral/titanium,
/area/shuttle/escape)
"az" = (
/obj/machinery/status_display/evac,
/turf/closed/wall/mineral/titanium,
/area/shuttle/escape)
"aB" = (
/obj/machinery/computer/communications{
	dir = 4
	},
/turf/open/floor/mineral/titanium/blue,
/area/shuttle/escape)
"aC" = (
/obj/structure/chair/office,
/turf/open/floor/mineral/titanium/blue,
/area/shuttle/escape)
"aE" = (
/obj/structure/chair/comfy/shuttle{
	dir = 1
	},
/turf/open/floor/mineral/titanium/blue,
/area/shuttle/escape)
"aF" = (
/obj/machinery/computer/emergency_shuttle{
	dir = 4
	},
/turf/open/floor/mineral/titanium/blue,
/area/shuttle/escape)
"aG" = (
/obj/structure/chair/office{
	dir = 8
	},
/turf/open/floor/mineral/titanium/blue,
/area/shuttle/escape)
"aI" = (
/turf/open/floor/mineral/plastitanium/red/brig,
/area/shuttle/escape)
"aJ" = (
/obj/structure/extinguisher_cabinet,
/turf/closed/wall/mineral/titanium,
/area/shuttle/escape)
"aL" = (
/obj/machinery/computer/station_alert{
	dir = 4
	},
/turf/open/floor/mineral/titanium/blue,
/area/shuttle/escape)
"aN" = (
/obj/structure/table,
/obj/item/storage/firstaid/toxin,
/obj/item/storage/firstaid/o2{
	pixel_x = 3;
	pixel_y = 3
	},
/turf/open/floor/mineral/titanium,
/area/shuttle/escape)
"aO" = (
/obj/structure/table,
/obj/item/storage/toolbox/emergency{
	pixel_y = 3
	},
/turf/open/floor/mineral/titanium/blue,
/area/shuttle/escape)
"aP" = (
/obj/structure/table,
/obj/machinery/recharger{
	active_power_usage = 0;
	idle_power_usage = 0;
	pixel_y = 4;
	use_power = 0
	},
/turf/open/floor/mineral/titanium/blue,
/area/shuttle/escape)
"aQ" = (
/obj/structure/table,
/obj/item/paper_bin{
	pixel_x = -2;
	pixel_y = 8
	},
/obj/item/radio/intercom{
	dir = 2;
	name = "Station Intercom (General)";
	pixel_y = -31
	},
/turf/open/floor/mineral/titanium/blue,
/area/shuttle/escape)
"aR" = (
/obj/structure/table,
/obj/item/folder/blue,
/obj/structure/extinguisher_cabinet{
	dir = 4;
	pixel_y = -27
	},
/turf/open/floor/mineral/titanium/blue,
/area/shuttle/escape)
"aS" = (
/obj/structure/fans/tiny,
/obj/machinery/door/airlock/titanium{
	name = "Emergency Shuttle Airlock";
	req_access_txt = "2"
	},
/turf/open/floor/mineral/titanium/blue,
/area/shuttle/escape)
"aT" = (
/obj/structure/chair/comfy/shuttle{
	dir = 8
	},
/turf/open/floor/mineral/titanium/blue,
/area/shuttle/escape)
"ba" = (
/obj/structure/fans/tiny,
/obj/machinery/door/airlock/titanium{
	name = "Emergency Shuttle Airlock";
	req_access_txt = "5"
	},
/turf/open/floor/mineral/titanium/blue,
/area/shuttle/escape)
"bd" = (
/obj/structure/chair/comfy/shuttle{
	dir = 4
	},
/obj/effect/decal/cleanable/dirt,
/turf/open/floor/plasteel,
/area/shuttle/escape)
"be" = (
/obj/effect/decal/cleanable/dirt,
/turf/open/floor/plasteel,
/area/shuttle/escape)
"bf" = (
/obj/machinery/door/airlock/external{
	name = "Emergency Recovery Airlock"
	},
/obj/effect/decal/cleanable/dirt,
/turf/open/floor/plasteel,
/area/shuttle/escape)
"bh" = (
/obj/item/clothing/suit/hazardvest{
	desc = "A high-visibility lifejacket complete with whistle and slot for oxygen tanks.";
	name = "emergency lifejacket"
	},
/obj/item/clothing/suit/hazardvest{
	desc = "A high-visibility lifejacket complete with whistle and slot for oxygen tanks.";
	name = "emergency lifejacket"
	},
/obj/item/clothing/suit/hazardvest{
	desc = "A high-visibility lifejacket complete with whistle and slot for oxygen tanks.";
	name = "emergency lifejacket"
	},
/obj/item/clothing/suit/hazardvest{
	desc = "A high-visibility lifejacket complete with whistle and slot for oxygen tanks.";
	name = "emergency lifejacket"
	},
/obj/item/clothing/suit/hazardvest{
	desc = "A high-visibility lifejacket complete with whistle and slot for oxygen tanks.";
	name = "emergency lifejacket"
	},
/obj/item/tank/internals/emergency_oxygen{
	pixel_x = 3
	},
/obj/item/tank/internals/emergency_oxygen{
	pixel_x = 3
	},
/obj/item/tank/internals/emergency_oxygen{
	pixel_x = 3
	},
/obj/item/tank/internals/emergency_oxygen{
	pixel_x = 3
	},
/obj/item/tank/internals/emergency_oxygen{
	pixel_x = 3
	},
/obj/item/clothing/mask/breath{
	pixel_x = -3;
	pixel_y = -3
	},
/obj/item/clothing/mask/breath{
	pixel_x = -3;
	pixel_y = -3
	},
/obj/item/clothing/mask/breath{
	pixel_x = -3;
	pixel_y = -3
	},
/obj/item/clothing/mask/breath{
	pixel_x = -3;
	pixel_y = -3
	},
/obj/item/clothing/mask/breath{
	pixel_x = -3;
	pixel_y = -3
	},
/obj/item/clothing/head/hardhat/orange{
	name = "protective hat";
	pixel_y = 9
	},
/obj/item/clothing/head/hardhat/orange{
	name = "protective hat";
	pixel_y = 9
	},
/obj/item/clothing/head/hardhat/orange{
	name = "protective hat";
	pixel_y = 9
	},
/obj/item/clothing/head/hardhat/orange{
	name = "protective hat";
	pixel_y = 9
	},
/obj/item/clothing/head/hardhat/orange{
	name = "protective hat";
	pixel_y = 9
	},
/obj/structure/closet/crate{
	name = "lifejackets"
	},
/obj/machinery/light{
	dir = 1
	},
/turf/open/floor/mineral/titanium/blue,
/area/shuttle/escape)
"bi" = (
/obj/machinery/status_display/evac{
	pixel_y = -32
	},
/turf/open/floor/mineral/titanium,
/area/shuttle/escape)
"bj" = (
/obj/structure/chair/comfy/shuttle,
/turf/open/floor/mineral/plastitanium/red/brig,
/area/shuttle/escape)
"bk" = (
/obj/machinery/button/flasher{
	id = "shuttle_flasher";
	pixel_x = -6;
	pixel_y = 24
	},
/obj/machinery/flasher{
	id = "shuttle_flasher";
	pixel_x = 6;
	pixel_y = 28
	},
/obj/structure/chair/comfy/shuttle,
/turf/open/floor/mineral/plastitanium/red/brig,
/area/shuttle/escape)
"bl" = (
/obj/structure/table,
/obj/item/stack/medical/gauze,
/obj/item/stack/medical/bruise_pack,
/obj/item/stack/medical/ointment,
/obj/machinery/light{
	dir = 4
	},
/obj/machinery/status_display/evac{
	pixel_y = -32
	},
/turf/open/floor/mineral/titanium/blue,
/area/shuttle/escape)
"bm" = (
/obj/structure/chair/office{
	dir = 1
	},
/turf/open/floor/mineral/titanium,
/area/shuttle/escape)
"bn" = (
/obj/structure/reagent_dispensers/peppertank{
	pixel_x = 30
	},
/obj/machinery/light{
	dir = 4
	},
/turf/open/floor/mineral/plastitanium/red/brig,
/area/shuttle/escape)
"bo" = (
/obj/structure/table,
/obj/item/reagent_containers/glass/bottle/epinephrine{
	pixel_x = 6
	},
/obj/item/reagent_containers/glass/bottle/charcoal{
	pixel_x = -3
	},
/obj/item/reagent_containers/glass/bottle/epinephrine{
	pixel_x = -3;
	pixel_y = 8
	},
/obj/item/reagent_containers/glass/bottle/charcoal{
	pixel_x = 6;
	pixel_y = 8
	},
/obj/item/reagent_containers/syringe/epinephrine{
	pixel_x = 3;
	pixel_y = -2
	},
/obj/item/reagent_containers/syringe/epinephrine{
	pixel_x = 4;
	pixel_y = 1
	},
/obj/item/reagent_containers/syringe/epinephrine{
	pixel_x = -2;
	pixel_y = 5
	},
/obj/item/reagent_containers/syringe/epinephrine{
	pixel_x = 2;
	pixel_y = 8
	},
/turf/open/floor/mineral/titanium,
/area/shuttle/escape)
"bp" = (
/obj/effect/turf_decal/delivery,
/turf/open/floor/plasteel,
/area/shuttle/escape)
"bq" = (
/obj/structure/chair/comfy/shuttle{
	dir = 1
	},
/obj/machinery/status_display/evac{
	dir = 8;
	pixel_x = 32
	},
/turf/open/floor/mineral/titanium/blue,
/area/shuttle/escape)
"bs" = (
/obj/structure/table/optable,
/obj/item/surgical_drapes,
/obj/machinery/light{
	dir = 8
	},
/turf/open/floor/mineral/titanium/blue,
/area/shuttle/escape)
"bt" = (
/obj/machinery/light{
	dir = 4
	},
/turf/open/floor/mineral/titanium,
/area/shuttle/escape)
"bu" = (
/obj/structure/table,
/obj/item/radio/intercom{
	dir = 2;
	name = "Station Intercom (General)";
	pixel_y = -31
	},
/obj/item/restraints/handcuffs{
	pixel_y = 3
	},
/turf/open/floor/mineral/plastitanium/red/brig,
/area/shuttle/escape)
"bv" = (
/obj/structure/rack,
/obj/item/crowbar,
/obj/item/wrench,
/obj/item/weldingtool,
/obj/item/wirecutters,
/obj/item/stack/cable_coil,
/obj/effect/turf_decal/stripes/line{
	dir = 4
	},
/turf/open/floor/plasteel,
/area/shuttle/escape)
"bw" = (
/obj/item/cigbutt,
/obj/effect/decal/cleanable/dirt,
/turf/open/floor/plasteel,
/area/shuttle/escape)
"by" = (
/obj/machinery/suit_storage_unit/standard_unit,
/obj/effect/decal/cleanable/dirt,
/turf/open/floor/plasteel,
/area/shuttle/escape)
"bz" = (
/obj/structure/table,
/obj/machinery/recharger{
	active_power_usage = 0;
	idle_power_usage = 0;
	use_power = 0
	},
/turf/open/floor/mineral/plastitanium/red/brig,
/area/shuttle/escape)
"bA" = (
/obj/effect/turf_decal/stripes/line{
	dir = 4
	},
/turf/open/floor/plasteel,
/area/shuttle/escape)
"bD" = (
/obj/item/clothing/suit/hazardvest{
	desc = "A high-visibility lifejacket complete with whistle and slot for oxygen tanks.";
	name = "emergency lifejacket"
	},
/obj/item/clothing/suit/hazardvest{
	desc = "A high-visibility lifejacket complete with whistle and slot for oxygen tanks.";
	name = "emergency lifejacket"
	},
/obj/item/clothing/suit/hazardvest{
	desc = "A high-visibility lifejacket complete with whistle and slot for oxygen tanks.";
	name = "emergency lifejacket"
	},
/obj/item/clothing/suit/hazardvest{
	desc = "A high-visibility lifejacket complete with whistle and slot for oxygen tanks.";
	name = "emergency lifejacket"
	},
/obj/item/clothing/suit/hazardvest{
	desc = "A high-visibility lifejacket complete with whistle and slot for oxygen tanks.";
	name = "emergency lifejacket"
	},
/obj/item/tank/internals/emergency_oxygen{
	pixel_x = 3
	},
/obj/item/tank/internals/emergency_oxygen{
	pixel_x = 3
	},
/obj/item/tank/internals/emergency_oxygen{
	pixel_x = 3
	},
/obj/item/tank/internals/emergency_oxygen{
	pixel_x = 3
	},
/obj/item/tank/internals/emergency_oxygen{
	pixel_x = 3
	},
/obj/item/clothing/mask/breath{
	pixel_x = -3;
	pixel_y = -3
	},
/obj/item/clothing/mask/breath{
	pixel_x = -3;
	pixel_y = -3
	},
/obj/item/clothing/mask/breath{
	pixel_x = -3;
	pixel_y = -3
	},
/obj/item/clothing/mask/breath{
	pixel_x = -3;
	pixel_y = -3
	},
/obj/item/clothing/mask/breath{
	pixel_x = -3;
	pixel_y = -3
	},
/obj/item/clothing/head/hardhat/orange{
	name = "protective hat";
	pixel_y = 9
	},
/obj/item/clothing/head/hardhat/orange{
	name = "protective hat";
	pixel_y = 9
	},
/obj/item/clothing/head/hardhat/orange{
	name = "protective hat";
	pixel_y = 9
	},
/obj/item/clothing/head/hardhat/orange{
	name = "protective hat";
	pixel_y = 9
	},
/obj/item/clothing/head/hardhat/orange{
	name = "protective hat";
	pixel_y = 9
	},
/obj/structure/closet/crate{
	name = "lifejackets"
	},
/turf/open/floor/mineral/titanium/blue,
/area/shuttle/escape)
"bE" = (
/obj/structure/table,
/obj/item/storage/box/handcuffs{
	pixel_x = 2;
	pixel_y = 2
	},
/turf/open/floor/mineral/plastitanium/red/brig,
/area/shuttle/escape)
"bF" = (
/obj/structure/table,
/obj/item/scalpel{
	pixel_y = 12
	},
/obj/item/circular_saw,
/obj/item/retractor{
	pixel_x = 4
	},
/obj/item/hemostat{
	pixel_x = -4
	},
/obj/item/clothing/gloves/color/latex,
/obj/item/clothing/mask/surgical,
/obj/item/radio/intercom{
	dir = 2;
	name = "Station Intercom (General)";
	pixel_x = -27
	},
/obj/item/surgicaldrill,
/obj/item/cautery,
/turf/open/floor/mineral/titanium,
/area/shuttle/escape)
"bG" = (
/obj/structure/chair/comfy/shuttle{
	dir = 1
	},
/obj/item/radio/intercom{
	dir = 2;
	name = "Station Intercom (General)";
	pixel_y = -31
	},
/turf/open/floor/mineral/titanium/blue,
/area/shuttle/escape)
"bH" = (
/obj/structure/tank_dispenser/oxygen{
	layer = 2.7;
	pixel_x = -1;
	pixel_y = 2
	},
/turf/open/floor/mineral/titanium/blue,
/area/shuttle/escape)
"bI" = (
/obj/structure/table,
/obj/item/defibrillator/loaded,
/turf/open/floor/mineral/titanium,
/area/shuttle/escape)
"bJ" = (
/obj/machinery/door/airlock/security/glass{
	name = "Brig";
	req_access_txt = "2"
	},
/obj/machinery/door/firedoor/border_only,
/obj/machinery/door/firedoor/border_only{
	dir = 1
	},
/turf/open/floor/mineral/plastitanium/red/brig,
/area/shuttle/escape)
"bK" = (
/obj/structure/table,
/obj/item/storage/firstaid/fire,
/obj/item/storage/firstaid/regular{
	pixel_x = 2;
	pixel_y = 3
	},
/turf/open/floor/mineral/titanium,
/area/shuttle/escape)
"bL" = (
/obj/structure/extinguisher_cabinet,
/turf/closed/wall/mineral/titanium/nodiagonal,
/area/shuttle/escape)
"bM" = (
/obj/structure/rack,
/obj/item/tank/internals/oxygen/red,
/obj/item/clothing/suit/fire/firefighter,
/obj/item/clothing/mask/gas,
/obj/item/clothing/head/hardhat/red,
/obj/effect/turf_decal/stripes/line{
	dir = 4
	},
/turf/open/floor/plasteel,
/area/shuttle/escape)
"bN" = (
/obj/machinery/space_heater,
/obj/structure/extinguisher_cabinet{
	dir = 4;
	pixel_y = -27
	},
/obj/effect/turf_decal/bot,
/turf/open/floor/plasteel,
/area/shuttle/escape)
"bO" = (
/obj/structure/closet/crate{
	name = "emergency supplies crate"
	},
/obj/item/storage/toolbox/emergency,
/obj/item/storage/toolbox/emergency,
/obj/item/flashlight/flare{
	pixel_x = 3;
	pixel_y = 3
	},
/obj/item/flashlight/flare{
	pixel_x = -6;
	pixel_y = -2
	},
/obj/item/crowbar,
/obj/item/wrench,
/obj/item/radio,
/obj/effect/turf_decal/bot,
/turf/open/floor/plasteel,
/area/shuttle/escape)
"bP" = (
/obj/structure/closet/crate/medical{
	name = "medical crate"
	},
/obj/item/storage/firstaid/regular,
/obj/item/storage/firstaid/o2{
	pixel_x = 3;
	pixel_y = 3
	},
/obj/item/storage/firstaid/toxin{
	pixel_x = -4;
	pixel_y = 3
	},
/obj/item/healthanalyzer{
	pixel_x = 3;
	pixel_y = 3
	},
/obj/item/lazarus_injector,
/obj/effect/turf_decal/bot,
/mob/living/simple_animal/bot/medbot{
	name = "\improper emergency medibot";
	pixel_x = -3;
	pixel_y = 2
	},
/turf/open/floor/plasteel,
/area/shuttle/escape)
"bQ" = (
/obj/item/radio/intercom{
	dir = 2;
	name = "Station Intercom (General)";
	pixel_y = -31
	},
/obj/machinery/portable_atmospherics/canister/oxygen,
/obj/effect/turf_decal/bot,
/turf/open/floor/plasteel,
/area/shuttle/escape)
"bR" = (
/obj/structure/table,
/obj/item/clipboard,
/obj/item/folder/yellow,
/obj/item/pen,
/obj/item/hand_labeler_refill,
/obj/effect/turf_decal/bot,
/turf/open/floor/plasteel,
/area/shuttle/escape)
"bS" = (
/obj/machinery/vending/wallmed{
	name = "Emergency NanoMed";
	use_power = 0
	},
/turf/closed/wall/mineral/titanium/nodiagonal,
/area/shuttle/escape)
"bU" = (
/obj/structure/chair/office,
/turf/open/floor/mineral/titanium,
/area/shuttle/escape)
"bV" = (
/obj/machinery/door/airlock/command/glass{
	name = "Cockpit";
	req_access_txt = "19"
	},
/obj/machinery/door/firedoor/border_only{
	dir = 8
	},
/obj/machinery/door/firedoor/border_only{
	dir = 4
	},
/turf/open/floor/mineral/titanium,
/area/shuttle/escape)
"bW" = (
/obj/machinery/stasis,
/turf/open/floor/mineral/titanium,
/area/shuttle/escape)
"bX" = (
/obj/structure/chair/comfy/shuttle{
	dir = 4
	},
/obj/machinery/light{
	dir = 8
	},
/turf/open/floor/mineral/plastitanium/red/brig,
/area/shuttle/escape)
"bY" = (
/obj/machinery/holopad,
/turf/open/floor/mineral/titanium,
/area/shuttle/escape)
"ca" = (
/obj/structure/sign/departments/medbay/alt,
/turf/closed/wall/mineral/titanium,
/area/shuttle/escape)
"cb" = (
/obj/machinery/light/small{
	dir = 4
	},
/obj/effect/decal/cleanable/dirt,
/turf/open/floor/plasteel,
/area/shuttle/escape)
"cd" = (
/obj/machinery/door/firedoor/border_only,
/obj/machinery/door/firedoor/border_only{
	dir = 1
	},
/obj/machinery/door/airlock/medical/glass{
	name = "Escape Shuttle Infirmary"
	},
/turf/open/floor/mineral/titanium,
/area/shuttle/escape)
"cO" = (
/obj/machinery/door/airlock/titanium{
	name = "Emergency Shuttle Airlock"
	},
/obj/structure/fans/tiny,
/turf/open/floor/mineral/titanium/blue,
/area/shuttle/escape)
"ef" = (
/obj/structure/closet/emcloset,
/obj/machinery/light{
	dir = 8
	},
/turf/open/floor/mineral/titanium/blue,
/area/shuttle/escape)
"fr" = (
/obj/effect/decal/cleanable/dirt,
/obj/machinery/atmospherics/pipe/simple/orange/hidden{
	dir = 9
	},
/turf/open/floor/plasteel,
/area/shuttle/escape)
"hJ" = (
/obj/machinery/light{
	dir = 4
	},
/obj/effect/decal/cleanable/dirt,
/obj/machinery/atmospherics/pipe/simple/orange/hidden{
	dir = 6
	},
/turf/open/floor/plasteel,
/area/shuttle/escape)
"pq" = (
/obj/machinery/door/airlock/command{
	name = "Emergency Recovery Airlock";
	req_access_txt = "19"
	},
/obj/effect/decal/cleanable/dirt,
/obj/machinery/door/firedoor/border_only,
/obj/machinery/door/firedoor/border_only{
	dir = 1
	},
/turf/open/floor/plasteel,
/area/shuttle/escape)
"sl" = (
/obj/machinery/light{
	dir = 8
	},
/turf/open/floor/mineral/titanium,
/area/shuttle/escape)
"BN" = (
/obj/effect/decal/cleanable/dirt,
/obj/machinery/atmospherics/components/binary/dp_vent_pump,
/turf/open/floor/plasteel,
/area/shuttle/escape)
"Ce" = (
/obj/machinery/atmospherics/pipe/simple/orange/hidden{
	dir = 10
	},
/turf/closed/wall/mineral/titanium/nodiagonal,
/area/shuttle/escape)
"CQ" = (
/obj/effect/decal/cleanable/dirt,
/obj/machinery/atmospherics/pipe/simple/orange/hidden,
/obj/machinery/advanced_airlock_controller{
	pixel_y = 24
	},
/turf/open/floor/plasteel,
/area/shuttle/escape)
"DK" = (
/obj/effect/decal/cleanable/dirt,
/obj/machinery/atmospherics/components/unary/tank/air,
/turf/open/floor/plasteel,
/area/shuttle/escape)
"Ek" = (
/obj/structure/reagent_dispensers/fueltank,
/obj/effect/turf_decal/delivery,
/obj/machinery/light{
	dir = 1
	},
/turf/open/floor/plasteel,
/area/shuttle/escape)
"FX" = (
/obj/machinery/recharge_station,
/obj/effect/turf_decal/delivery,
/turf/open/floor/plasteel,
/area/shuttle/escape)
"Gk" = (
/obj/structure/closet/firecloset,
/turf/open/floor/mineral/titanium/blue,
/area/shuttle/escape)
"GG" = (
/obj/machinery/door/airlock/titanium{
	name = "Emergency Shuttle Cargo Bay Airlock"
	},
/turf/open/floor/mineral/titanium/white,
/area/shuttle/escape)
"Li" = (
/obj/effect/spawner/structure/window/shuttle,
/obj/machinery/door/firedoor/window,
/turf/open/floor/plating,
/area/shuttle/escape)
"LY" = (
/turf/open/floor/mineral/titanium,
/area/shuttle/escape)
"Ml" = (
/obj/machinery/door/airlock/titanium{
	name = "Emergency Shuttle Airlock"
	},
/obj/docking_port/mobile/emergency{
	dir = 2;
	dwidth = 5;
	height = 14;
	name = "Endo emergency shuttle";
	width = 25
	},
/obj/structure/fans/tiny,
/turf/open/floor/mineral/titanium/blue,
/area/shuttle/escape)
"PE" = (
/obj/structure/chair/comfy/shuttle{
	dir = 1
	},
/obj/machinery/light,
/turf/open/floor/mineral/titanium/blue,
/area/shuttle/escape)
"Vs" = (
/obj/machinery/door/airlock/titanium{
	name = "Emergency Shuttle Cargo Bay Airlock"
	},
/obj/effect/turf_decal/delivery,
/obj/machinery/door/firedoor/border_only,
/obj/machinery/door/firedoor/border_only{
	dir = 1
	},
/turf/open/floor/plasteel,
/area/shuttle/escape)
"Xm" = (
/obj/structure/reagent_dispensers/watertank,
/obj/effect/turf_decal/delivery,
/turf/open/floor/plasteel,
/area/shuttle/escape)
"Yo" = (
/obj/effect/decal/cleanable/dirt,
/obj/machinery/atmospherics/pipe/manifold/orange/hidden,
/turf/open/floor/plasteel,
/area/shuttle/escape)

(1,1,1) = {"
aa
aa
au
au
au
ad
au
au
ad
au
au
au
aa
aa
"}
(2,1,1) = {"
aa
ad
av
av
av
ad
av
av
ad
av
av
av
ad
aa
"}
(3,1,1) = {"
ad
ad
ad
ad
ad
ad
ad
ad
ad
ad
ad
ad
ad
ad
"}
(4,1,1) = {"
Li
al
aw
aB
aF
aL
aO
aP
aJ
bd
bd
bd
DK
Li
"}
(5,1,1) = {"
Li
am
aq
aC
aG
ax
aq
aQ
ad
be
hJ
BN
Yo
bf
"}
(6,1,1) = {"
Li
an
bm
LY
LY
LY
bU
aR
ad
bf
Ce
CQ
fr
bf
"}
(7,1,1) = {"
Li
ao
ay
LY
bt
LY
LY
aq
pq
cb
ad
by
by
Li
"}
(8,1,1) = {"
ad
ad
az
ad
ad
ad
bV
az
ad
ad
ad
az
ad
ad
"}
(9,1,1) = {"
ad
ap
bX
ap
bu
ad
LY
ef
Gk
LY
ad
bh
bD
ad
"}
(10,1,1) = {"
Li
bj
aI
aI
bz
ad
LY
aE
ar
LY
ad
LY
aE
Li
"}
(11,1,1) = {"
ad
bk
aI
aI
bE
ac
LY
aE
ar
LY
ac
LY
aE
Li
"}
(12,1,1) = {"
aS
aI
bn
aI
aI
bJ
LY
aE
ar
bi
ad
LY
bG
ad
"}
(13,1,1) = {"
ad
ad
ad
az
ad
ad
LY
aE
ar
LY
bS
LY
aE
ad
"}
(14,1,1) = {"
cO
LY
LY
aE
aJ
ar
LY
LY
LY
LY
sl
LY
bH
ad
"}
(15,1,1) = {"
ag
ar
LY
aE
ac
ar
LY
LY
LY
LY
bt
LY
aE
Li
"}
(16,1,1) = {"
Li
ar
LY
LY
LY
LY
LY
LY
LY
aE
bL
LY
aE
Li
"}
(17,1,1) = {"
Li
ar
LY
LY
LY
LY
bY
LY
aE
bl
ad
LY
aE
ad
"}
(18,1,1) = {"
Li
ar
LY
aE
bL
ar
LY
LY
aE
ad
ac
GG
ad
ad
"}
(19,1,1) = {"
ad
as
LY
aE
ac
ar
LY
LY
PE
ad
bv
bA
bM
ad
"}
(20,1,1) = {"
Ml
LY
LY
bq
bS
ar
LY
LY
aE
ac
Xm
be
bN
ad
"}
(21,1,1) = {"
ad
ad
ad
ad
ad
ad
ca
LY
aE
aJ
Ek
be
bO
Li
"}
(22,1,1) = {"
ba
LY
bo
bs
bF
bK
ad
LY
LY
Vs
bp
bw
bP
Li
"}
(23,1,1) = {"
ad
aq
aq
aq
aq
aq
cd
LY
LY
Vs
bp
be
bQ
ad
"}
(24,1,1) = {"
ad
bW
bW
at
bI
aN
ad
aT
aT
ag
FX
bp
bR
ad
"}
(25,1,1) = {"
ad
ad
Li
ad
Li
ad
ad
ad
ad
ad
Li
Li
ad
ad
"}
