"ab" = (/obj/effect/turf_decal/delivery,/obj/effect/turf_decal/stripes/line,/turf/open/floor/mineral/titanium,/area/shuttle/escape)
"aM" = (/obj/effect/turf_decal/tile/neutral,/obj/effect/turf_decal/tile/neutral{dir = 1},/obj/effect/turf_decal/stripes/line{dir = 1},/turf/open/floor/mineral/titanium,/area/shuttle/escape)
"aP" = (/obj/effect/turf_decal/delivery,/obj/machinery/door/airlock/security/glass{name = "Holding Area"; req_access_txt = "2"},/obj/machinery/door/firedoor/border_only,/obj/machinery/door/firedoor/border_only{dir = 1},/turf/open/floor/pod/dark,/area/shuttle/escape)
"aU" = (/obj/effect/turf_decal/caution/stand_clear,/turf/open/floor/pod/dark,/area/shuttle/escape)
"aW" = (/obj/structure/chair/comfy/shuttle{dir = 1},/turf/open/floor/mineral/titanium/purple,/area/shuttle/escape)
"bS" = (/obj/effect/turf_decal/stripes/line{dir = 1},/obj/structure/shuttle/engine/propulsion/left,/turf/open/floor/plating/airless,/area/shuttle/escape)
"cg" = (/obj/effect/turf_decal/tile/brown,/obj/effect/turf_decal/tile/brown{dir = 8},/turf/open/floor/mineral/titanium/yellow,/area/shuttle/escape)
"cF" = (/obj/machinery/door/airlock/security/glass{name = "Holding Area"; req_access_txt = "2"},/obj/effect/turf_decal/delivery,/obj/effect/turf_decal/stripes/line{dir = 8},/turf/open/floor/pod/dark,/area/shuttle/escape)
"cM" = (/obj/structure/chair/comfy/shuttle,/obj/effect/turf_decal/bot,/turf/open/floor/mineral/plastitanium,/area/shuttle/escape)
"cT" = (/obj/effect/turf_decal/stripes/line,/obj/machinery/vending/wallmed{name = "Emergency NanoMed"; pixel_y = -27; use_power = 0},/turf/open/floor/mineral/titanium,/area/shuttle/escape)
"dV" = (/obj/effect/turf_decal/tile/brown,/obj/effect/turf_decal/tile/brown{dir = 8},/obj/effect/turf_decal/delivery,/obj/machinery/light{dir = 8},/obj/structure/reagent_dispensers/fueltank,/obj/effect/turf_decal/stripes/line{dir = 6},/turf/open/floor/mineral/titanium,/area/shuttle/escape)
"fC" = (/obj/item/clothing/suit/hazardvest{desc = "A high-visibility lifejacket complete with whistle and slot for oxygen tanks."; name = "emergency lifejacket"},/obj/item/clothing/suit/hazardvest{desc = "A high-visibility lifejacket complete with whistle and slot for oxygen tanks."; name = "emergency lifejacket"},/obj/item/clothing/suit/hazardvest{desc = "A high-visibility lifejacket complete with whistle and slot for oxygen tanks."; name = "emergency lifejacket"},/obj/item/clothing/suit/hazardvest{desc = "A high-visibility lifejacket complete with whistle and slot for oxygen tanks."; name = "emergency lifejacket"},/obj/item/clothing/suit/hazardvest{desc = "A high-visibility lifejacket complete with whistle and slot for oxygen tanks."; name = "emergency lifejacket"},/obj/item/tank/internals/emergency_oxygen{pixel_x = 3},/obj/item/tank/internals/emergency_oxygen{pixel_x = 3},/obj/item/tank/internals/emergency_oxygen{pixel_x = 3},/obj/item/tank/internals/emergency_oxygen{pixel_x = 3},/obj/item/tank/internals/emergency_oxygen{pixel_x = 3},/obj/item/clothing/mask/breath{pixel_x = -3; pixel_y = -3},/obj/item/clothing/mask/breath{pixel_x = -3; pixel_y = -3},/obj/item/clothing/mask/breath{pixel_x = -3; pixel_y = -3},/obj/item/clothing/mask/breath{pixel_x = -3; pixel_y = -3},/obj/item/clothing/mask/breath{pixel_x = -3; pixel_y = -3},/obj/item/clothing/head/hardhat/orange{name = "protective hat"; pixel_y = 9},/obj/item/clothing/head/hardhat/orange{name = "protective hat"; pixel_y = 9},/obj/item/clothing/head/hardhat/orange{name = "protective hat"; pixel_y = 9},/obj/item/clothing/head/hardhat/orange{name = "protective hat"; pixel_y = 9},/obj/item/clothing/head/hardhat/orange{name = "protective hat"; pixel_y = 9},/obj/structure/closet/crate/internals,/obj/effect/turf_decal/bot,/turf/open/floor/mineral/plastitanium,/area/shuttle/escape)
"gh" = (/obj/machinery/door/airlock/medical/glass{name = "Escape Shuttle Infirmary"},/obj/machinery/door/firedoor/border_only,/obj/machinery/door/firedoor/border_only{dir = 1},/turf/open/floor/pod/dark,/area/shuttle/escape)
"gs" = (/obj/effect/turf_decal/arrows{dir = 4},/obj/effect/turf_decal/stripes/line{dir = 8},/obj/effect/turf_decal/stripes/corner{dir = 4},/turf/open/floor/mineral/titanium,/area/shuttle/escape)
"hn" = (/obj/effect/turf_decal/stripes/line{dir = 1},/obj/machinery/vending/wallmed{name = "Emergency NanoMed"; pixel_y = 26; use_power = 0},/turf/open/floor/mineral/titanium,/area/shuttle/escape)
"in" = (/turf/open/floor/mineral/titanium/purple,/area/shuttle/escape)
"iI" = (/obj/structure/table,/obj/item/paper_bin{pixel_x = -2; pixel_y = 8},/obj/item/folder/blue,/obj/item/folder/red{pixel_x = 4; pixel_y = 4},/obj/item/gun/energy/e_gun/mini,/obj/effect/turf_decal/tile/neutral,/obj/effect/turf_decal/tile/neutral{dir = 1},/turf/open/floor/mineral/titanium,/area/shuttle/escape)
"iL" = (/obj/machinery/light{dir = 8},/turf/open/floor/mineral/titanium/purple,/area/shuttle/escape)
"jd" = (/obj/machinery/computer/security{dir = 8},/obj/effect/turf_decal/bot,/obj/machinery/light{dir = 4},/turf/open/floor/mineral/plastitanium/red/brig,/area/shuttle/escape)
"js" = (/obj/machinery/door/airlock/external/glass{name = "Emergency Recovery Airlock"},/obj/structure/fans/tiny,/turf/open/floor/pod/dark,/area/shuttle/escape)
"jt" = (/obj/item/stack/marker_beacon{anchored = 1; icon_state = "markerburgundy-on"; light_color = "#FA644B"; light_power = 3; light_range = 2; name = "landing marker"; picked_color = "Burgundy"},/turf/closed/wall/mineral/titanium/nodiagonal,/area/shuttle/escape)
"jz" = (/obj/structure/table/reinforced,/obj/item/clipboard,/obj/item/restraints/handcuffs,/obj/item/tank/internals/emergency_oxygen/engi,/obj/item/tank/internals/emergency_oxygen/engi,/obj/item/assembly/flash/handheld,/obj/effect/turf_decal/tile/neutral,/obj/effect/turf_decal/tile/neutral{dir = 1},/turf/open/floor/mineral/titanium,/area/shuttle/escape)
"ke" = (/obj/machinery/door/airlock/public/glass{name = "Emergency Shuttle Cockpit"; req_access_txt = "19"},/turf/open/floor/pod/dark,/area/shuttle/escape)
"lc" = (/turf/closed/wall/mineral/plastitanium,/area/shuttle/escape)
"lu" = (/obj/structure/chair/comfy/shuttle{dir = 4},/obj/effect/turf_decal/stripes/line{dir = 9},/turf/open/floor/mineral/plastitanium/red/brig,/area/shuttle/escape)
"lw" = (/obj/item/kirbyplants/random,/turf/open/floor/mineral/titanium,/area/shuttle/escape)
"lM" = (/obj/structure/rack,/obj/item/crowbar,/obj/item/wrench,/obj/item/weldingtool,/obj/item/wirecutters,/obj/item/stack/cable_coil,/obj/effect/turf_decal/tile/brown{dir = 8},/obj/effect/turf_decal/tile/brown,/obj/effect/decal/cleanable/dirt,/obj/effect/turf_decal/delivery,/obj/effect/turf_decal/stripes/corner{dir = 1},/turf/open/floor/mineral/titanium,/area/shuttle/escape)
"mr" = (/obj/structure/extinguisher_cabinet{pixel_y = 30},/turf/open/floor/mineral/titanium,/area/shuttle/escape)
"mW" = (/obj/effect/turf_decal/delivery,/obj/effect/turf_decal/stripes/line{dir = 1},/turf/open/floor/mineral/titanium,/area/shuttle/escape)
"nw" = (/obj/effect/turf_decal/stripes/corner,/turf/open/floor/mineral/titanium,/area/shuttle/escape)
"nA" = (/obj/machinery/door/airlock/external/glass{name = "Emergency Recovery Airlock"},/turf/open/floor/pod/dark,/area/shuttle/escape)
"nO" = (/obj/machinery/stasis,/turf/open/floor/mineral/titanium/blue,/area/shuttle/escape)
"oa" = (/obj/structure/table,/obj/item/storage/firstaid/o2{pixel_x = 4; pixel_y = 4},/obj/item/storage/firstaid/regular,/obj/item/crowbar/large,/obj/effect/turf_decal/tile/neutral,/obj/effect/turf_decal/tile/neutral{dir = 1},/obj/machinery/keycard_auth{pixel_x = 24},/turf/open/floor/mineral/titanium,/area/shuttle/escape)
"pd" = (/obj/structure/table,/obj/item/storage/fancy/donut_box,/obj/effect/turf_decal/tile/neutral,/obj/effect/turf_decal/tile/neutral{dir = 1},/turf/open/floor/mineral/titanium,/area/shuttle/escape)
"rF" = (/turf/closed/wall/mineral/titanium/nodiagonal,/area/shuttle/escape)
"rX" = (/obj/effect/turf_decal/arrows{dir = 4},/obj/effect/turf_decal/stripes/corner{dir = 1},/obj/effect/turf_decal/stripes/corner,/turf/open/floor/mineral/titanium,/area/shuttle/escape)
"sz" = (/obj/structure/table,/obj/item/defibrillator/loaded,/obj/item/radio/intercom{dir = 4; name = "Station Intercom (General)"; pixel_y = 27},/turf/open/floor/mineral/titanium/blue,/area/shuttle/escape)
"sQ" = (/obj/effect/turf_decal/stripes/line{dir = 1},/obj/structure/extinguisher_cabinet{pixel_y = 30},/turf/open/floor/mineral/titanium,/area/shuttle/escape)
"tc" = (/obj/structure/chair/comfy/shuttle{dir = 4},/turf/open/floor/mineral/plastitanium/red/brig,/area/shuttle/escape)
"tr" = (/obj/machinery/computer/communications,/obj/effect/turf_decal/bot,/obj/effect/turf_decal/stripes/line,/turf/open/floor/pod/dark,/area/shuttle/escape)
"ty" = (/obj/effect/turf_decal/tile/brown,/obj/effect/turf_decal/tile/brown{dir = 8},/obj/effect/turf_decal/delivery,/obj/structure/rack,/obj/item/storage/toolbox/emergency{pixel_x = 3; pixel_y = -5},/obj/item/storage/toolbox/mechanical{pixel_y = -1},/obj/item/storage/toolbox/electrical{pixel_x = -3; pixel_y = 1},/obj/item/multitool,/obj/effect/decal/cleanable/dirt,/obj/effect/turf_decal/stripes/line{dir = 4},/turf/open/floor/mineral/titanium,/area/shuttle/escape)
"tC" = (/obj/structure/table,/obj/item/storage/firstaid/toxin,/obj/item/storage/firstaid/o2{pixel_x = 3; pixel_y = 3},/obj/machinery/light{dir = 8},/obj/item/storage/firstaid/regular{pixel_x = 2; pixel_y = 3},/obj/item/storage/firstaid/fire,/turf/open/floor/mineral/titanium/blue,/area/shuttle/escape)
"tF" = (/obj/effect/turf_decal/bot,/obj/machinery/newscaster/security_unit{pixel_y = 32},/obj/structure/table/reinforced,/obj/item/paper_bin,/obj/item/pen,/turf/open/floor/mineral/plastitanium/red/brig,/area/shuttle/escape)
"tL" = (/obj/machinery/door/airlock/shuttle{name = "Emergency Shuttle Airlock"},/obj/structure/fans/tiny,/obj/effect/turf_decal/stripes/line{dir = 4},/turf/open/floor/pod/dark,/area/shuttle/escape)
"ut" = (/obj/machinery/door/airlock/shuttle{name = "Emergency Shuttle Airlock"},/obj/structure/fans/tiny,/obj/effect/turf_decal/stripes/line{dir = 8},/turf/open/floor/pod/dark,/area/shuttle/escape)
"ux" = (/obj/effect/turf_decal/tile/brown,/obj/effect/turf_decal/tile/brown{dir = 8},/obj/effect/turf_decal/delivery,/obj/machinery/light{dir = 4},/obj/structure/reagent_dispensers/watertank,/obj/effect/turf_decal/stripes/line{dir = 10},/turf/open/floor/mineral/titanium,/area/shuttle/escape)
"uQ" = (/obj/effect/spawner/structure/window/shuttle,/obj/machinery/door/firedoor/window,/turf/open/floor/plating,/area/shuttle/escape)
"vt" = (/turf/closed/wall/mineral/plastitanium/nodiagonal,/area/shuttle/escape)
"vM" = (/obj/machinery/door/airlock/command/glass{name = "Cockpit"; req_access_txt = "19"},/turf/open/floor/pod/dark,/area/shuttle/escape)
"vT" = (/obj/structure/flora/ausbushes/grassybush,/obj/structure/flora/ausbushes/lavendergrass,/obj/structure/flora/ausbushes/brflowers,/obj/structure/flora/ausbushes/leafybush,/obj/structure/window/shuttle,/turf/open/floor/grass,/area/shuttle/escape)
"wb" = (/obj/effect/turf_decal/delivery,/obj/effect/turf_decal/stripes/line{dir = 4},/obj/machinery/door/airlock/shuttle/glass,/turf/open/floor/pod/dark,/area/shuttle/escape)
"xT" = (/obj/machinery/light{dir = 8},/obj/effect/turf_decal/stripes/line{dir = 8},/turf/open/floor/mineral/titanium,/area/shuttle/escape)
"ye" = (/obj/machinery/computer/emergency_shuttle,/obj/effect/turf_decal/bot,/obj/effect/turf_decal/stripes/line,/turf/open/floor/pod/dark,/area/shuttle/escape)
"yi" = (/obj/structure/table,/obj/item/storage/toolbox/emergency{pixel_y = 3},/obj/item/radio,/obj/item/flashlight/seclite{pixel_y = 11},/obj/effect/turf_decal/stripes/line,/turf/open/floor/pod/dark,/area/shuttle/escape)
"yq" = (/obj/effect/turf_decal/tile/neutral,/obj/effect/turf_decal/tile/neutral{dir = 1},/turf/open/floor/mineral/titanium,/area/shuttle/escape)
"yT" = (/obj/machinery/computer/med_data{dir = 8},/turf/open/floor/mineral/titanium/blue,/area/shuttle/escape)
"zw" = (/obj/structure/chair/comfy/shuttle{dir = 4},/obj/effect/turf_decal/bot,/turf/open/floor/mineral/plastitanium,/area/shuttle/escape)
"zA" = (/obj/machinery/light{dir = 4},/turf/open/floor/mineral/titanium/white,/area/shuttle/escape)
"zB" = (/obj/structure/table,/obj/item/reagent_containers/glass/bottle/epinephrine{pixel_x = 6},/obj/item/reagent_containers/glass/bottle/charcoal{pixel_x = -3},/obj/item/reagent_containers/glass/bottle/epinephrine{pixel_x = -3; pixel_y = 8},/obj/item/reagent_containers/glass/bottle/charcoal{pixel_x = 6; pixel_y = 8},/obj/item/reagent_containers/syringe/epinephrine{pixel_x = 3; pixel_y = -2},/obj/item/reagent_containers/syringe/epinephrine{pixel_x = 4; pixel_y = 1},/obj/item/reagent_containers/syringe/epinephrine{pixel_x = -2; pixel_y = 5},/obj/item/reagent_containers/syringe/epinephrine{pixel_x = 2; pixel_y = 8},/turf/open/floor/mineral/titanium/blue,/area/shuttle/escape)
"zM" = (/obj/structure/chair/comfy/shuttle{dir = 1},/obj/effect/turf_decal/bot,/turf/open/floor/mineral/plastitanium,/area/shuttle/escape)
"zS" = (/obj/effect/turf_decal/stripes/corner{dir = 4},/turf/open/floor/mineral/titanium,/area/shuttle/escape)
"Ae" = (/obj/machinery/computer/station_alert,/obj/effect/turf_decal/bot,/obj/effect/turf_decal/stripes/line,/obj/machinery/status_display/evac{pixel_y = 32},/turf/open/floor/pod/dark,/area/shuttle/escape)
"Au" = (/obj/structure/chair/comfy/shuttle{dir = 1},/obj/effect/turf_decal/stripes/line{dir = 1},/turf/open/floor/mineral/titanium/white,/area/shuttle/escape)
"AS" = (/turf/open/floor/mineral/titanium,/area/shuttle/escape)
"BI" = (/obj/effect/turf_decal/stripes/line{dir = 1},/obj/structure/shuttle/engine/propulsion/right,/turf/open/floor/plating/airless,/area/shuttle/escape)
"Cj" = (/obj/effect/spawner/structure/window/shuttle,/turf/open/floor/plating,/area/shuttle/escape)
"Cn" = (/obj/machinery/shower{dir = 8; name = "emergency shower"},/turf/open/floor/noslip/darkblue,/area/shuttle/escape)
"CX" = (/obj/machinery/light{dir = 8},/turf/open/floor/mineral/titanium/white,/area/shuttle/escape)
"Dg" = (/obj/structure/closet/crate/medical,/obj/item/storage/firstaid/regular,/obj/item/storage/firstaid/o2{pixel_x = 3; pixel_y = 3},/obj/item/storage/firstaid/toxin{pixel_x = -4; pixel_y = 3},/obj/item/healthanalyzer{pixel_x = 3; pixel_y = 3},/obj/item/lazarus_injector{desc = "An injector with a cocktail of nanomachines and chemicals, this device can seemingly raise animals from the dead, making them become friendly to the user. Unfortunately, the process is useless on higher forms of life and incredibly costly, so these were hidden in storage until an executive thought they'd be great motivation for some of their employees. soley exists to ressurect ian."},/obj/effect/decal/cleanable/dirt,/mob/living/simple_animal/bot/medbot{name = "\improper emergency medibot"; pixel_x = -3; pixel_y = 2},/turf/open/floor/mineral/titanium/blue,/area/shuttle/escape)
"EC" = (/obj/machinery/holopad,/obj/effect/turf_decal/bot,/turf/open/floor/mineral/plastitanium,/area/shuttle/escape)
"EX" = (/obj/effect/turf_decal/tile/neutral{dir = 1},/obj/effect/turf_decal/tile/neutral,/obj/item/storage/box/zipties{pixel_y = 4},/obj/item/restraints/handcuffs,/obj/item/restraints/handcuffs,/obj/effect/turf_decal/stripes/line{dir = 10},/obj/structure/table/reinforced,/turf/open/floor/mineral/plastitanium/red/brig,/area/shuttle/escape)
"Fm" = (/obj/structure/sign/departments/medbay/alt,/turf/closed/wall/mineral/titanium,/area/shuttle/escape)
"Gl" = (/obj/machinery/door/airlock/shuttle{name = "Emergency Shuttle Airlock"; req_one_access_txt = "63"},/obj/structure/fans/tiny,/obj/effect/turf_decal/stripes/line{dir = 4},/turf/open/floor/pod/dark,/area/shuttle/escape)
"Gr" = (/obj/machinery/light{dir = 8},/turf/open/floor/mineral/titanium,/area/shuttle/escape)
"GP" = (/turf/open/floor/pod/dark,/area/shuttle/escape)
"GV" = (/obj/effect/turf_decal/arrows{dir = 4},/obj/effect/turf_decal/stripes/corner,/turf/open/floor/mineral/titanium,/area/shuttle/escape)
"Hc" = (/obj/machinery/door/airlock/shuttle{name = "Emergency Shuttle Airlock"},/obj/structure/fans/tiny,/obj/effect/turf_decal/stripes/line{dir = 4},/obj/docking_port/mobile/emergency{dir = 8; dwidth = 4; height = 30; name = "Fland emergency shuttle"; port_direction = 4; preferred_direction = 2; width = 18},/turf/open/floor/pod/dark,/area/shuttle/escape)
"Hg" = (/obj/structure/bed/roller,/obj/machinery/iv_drip,/turf/open/floor/mineral/titanium/blue,/area/shuttle/escape)
"HC" = (/obj/structure/table/optable,/obj/effect/turf_decal/tile/blue{dir = 4},/obj/effect/turf_decal/tile/blue{dir = 8},/turf/open/floor/mineral/titanium/blue,/area/shuttle/escape)
"HX" = (/obj/machinery/computer/operating{dir = 8},/turf/open/floor/mineral/titanium/blue,/area/shuttle/escape)
"Ie" = (/obj/machinery/suit_storage_unit/standard_unit,/obj/effect/turf_decal/bot,/obj/effect/turf_decal/stripes/line{dir = 10},/turf/open/floor/pod/dark,/area/shuttle/escape)
"Ij" = (/obj/effect/turf_decal/stripes/line{dir = 4},/obj/effect/turf_decal/stripes/corner{dir = 8},/turf/open/floor/mineral/titanium,/area/shuttle/escape)
"Ix" = (/obj/machinery/door/airlock/titanium{name = "Emergency Shuttle Cargo Bay Airlock"},/obj/effect/turf_decal/delivery,/obj/machinery/door/firedoor/border_only,/obj/machinery/door/firedoor/border_only{dir = 1},/turf/open/floor/pod/dark,/area/shuttle/escape)
"Iz" = (/obj/effect/turf_decal/stripes/line{dir = 1},/turf/open/floor/mineral/titanium,/area/shuttle/escape)
"IB" = (/obj/effect/turf_decal/arrows{dir = 8},/obj/effect/turf_decal/stripes/line{dir = 4},/obj/effect/turf_decal/stripes/corner{dir = 1},/turf/open/floor/mineral/titanium,/area/shuttle/escape)
"IP" = (/obj/machinery/computer/crew,/obj/effect/turf_decal/bot,/obj/effect/turf_decal/stripes/line,/obj/machinery/status_display/evac{pixel_y = 32},/turf/open/floor/pod/dark,/area/shuttle/escape)
"IZ" = (/obj/structure/chair/comfy/shuttle{dir = 8},/obj/effect/turf_decal/stripes/line{dir = 5},/obj/machinery/light{dir = 4},/turf/open/floor/mineral/plastitanium/red/brig,/area/shuttle/escape)
"JO" = (/obj/machinery/light{dir = 4},/turf/open/floor/mineral/titanium,/area/shuttle/escape)
"KV" = (/obj/structure/sink{dir = 8; pixel_x = -12},/turf/open/floor/mineral/titanium/blue,/area/shuttle/escape)
"KX" = (/obj/effect/turf_decal/tile/brown,/obj/effect/turf_decal/tile/brown{dir = 8},/obj/effect/turf_decal/stripes/line{dir = 5},/obj/effect/turf_decal/delivery,/obj/machinery/portable_atmospherics/canister/oxygen,/turf/open/floor/mineral/titanium,/area/shuttle/escape)
"Lb" = (/obj/structure/chair/comfy/shuttle{dir = 4},/obj/effect/turf_decal/box/corners{dir = 4},/turf/open/floor/mineral/plastitanium/red/brig,/area/shuttle/escape)
"Lc" = (/turf/closed/wall/mineral/titanium,/area/shuttle/escape)
"LR" = (/obj/effect/turf_decal/tile/brown,/obj/effect/turf_decal/tile/brown{dir = 8},/obj/effect/turf_decal/delivery,/obj/effect/turf_decal/stripes/line{dir = 4},/obj/structure/tank_dispenser/oxygen{layer = 2.7; pixel_x = -1; pixel_y = 2},/obj/effect/decal/cleanable/dirt,/turf/open/floor/mineral/titanium,/area/shuttle/escape)
"LT" = (/obj/effect/turf_decal/arrows{dir = 8},/obj/effect/turf_decal/stripes/corner{dir = 8},/turf/open/floor/mineral/titanium,/area/shuttle/escape)
"Mh" = (/obj/structure/closet/crate{name = "emergency supplies crate"},/obj/item/storage/toolbox/emergency,/obj/item/storage/toolbox/emergency,/obj/item/flashlight/flare{pixel_x = 3; pixel_y = 3},/obj/item/flashlight/flare{pixel_x = -6; pixel_y = -2},/obj/item/crowbar,/obj/item/wrench,/obj/item/radio,/obj/effect/turf_decal/bot,/obj/effect/turf_decal/tile/brown{dir = 8},/obj/effect/turf_decal/tile/brown,/obj/effect/turf_decal/stripes/line{dir = 9},/turf/open/floor/plasteel,/area/shuttle/escape)
"MJ" = (/obj/effect/turf_decal/stripes/line{dir = 6},/turf/open/floor/mineral/plastitanium/red/brig,/area/shuttle/escape)
"MM" = (/obj/structure/table,/obj/item/scalpel{pixel_y = 12},/obj/item/circular_saw,/obj/item/retractor{pixel_x = 4},/obj/item/hemostat{pixel_x = -4},/obj/item/clothing/gloves/color/latex,/obj/item/clothing/mask/surgical,/obj/item/surgicaldrill,/obj/item/cautery,/obj/machinery/light{dir = 4},/turf/open/floor/mineral/titanium/blue,/area/shuttle/escape)
"NF" = (/obj/effect/turf_decal/delivery,/obj/machinery/door/airlock/security/glass{name = "Holding Area"; req_one_access_txt = "19"},/obj/machinery/door/firedoor/border_only{dir = 8},/obj/machinery/door/firedoor/border_only{dir = 4},/turf/open/floor/pod/dark,/area/shuttle/escape)
"NG" = (/obj/effect/turf_decal/stripes/line{dir = 8},/obj/effect/turf_decal/stripes/corner,/turf/open/floor/mineral/titanium,/area/shuttle/escape)
"NK" = (/obj/structure/tank_dispenser/oxygen{layer = 2.7; pixel_x = -1; pixel_y = 2},/obj/machinery/light/small{dir = 4},/turf/open/floor/pod/dark,/area/shuttle/escape)
"OA" = (/obj/effect/turf_decal/tile/neutral,/obj/effect/turf_decal/tile/neutral{dir = 1},/obj/item/radio/intercom{name = "Station Intercom (General)"; pixel_y = -31},/turf/open/floor/mineral/titanium,/area/shuttle/escape)
"OF" = (/obj/structure/chair/comfy/shuttle{dir = 4},/obj/machinery/light{dir = 8},/turf/open/floor/mineral/plastitanium/red/brig,/area/shuttle/escape)
"Px" = (/obj/effect/turf_decal/stripes/corner{dir = 8},/turf/open/floor/mineral/titanium,/area/shuttle/escape)
"PQ" = (/obj/effect/turf_decal/stripes/line{dir = 4},/obj/effect/turf_decal/stripes/line{dir = 8},/turf/open/floor/mineral/titanium,/area/shuttle/escape)
"PU" = (/obj/machinery/status_display/evac,/turf/closed/wall/mineral/titanium,/area/shuttle/escape)
"Qm" = (/obj/effect/turf_decal/bot,/obj/machinery/recharger,/obj/structure/table/reinforced,/turf/open/floor/mineral/plastitanium/red/brig,/area/shuttle/escape)
"Qo" = (/turf/template_noop,/area/template_noop)
"QA" = (/obj/machinery/vending/sustenance,/turf/open/floor/mineral/titanium,/area/shuttle/escape)
"QL" = (/obj/item/kirbyplants/random,/turf/open/floor/mineral/plastitanium,/area/shuttle/escape)
"Rl" = (/obj/structure/chair/comfy/shuttle{dir = 8},/obj/effect/turf_decal/bot,/turf/open/floor/mineral/plastitanium,/area/shuttle/escape)
"Rz" = (/obj/effect/turf_decal/stripes/line,/turf/open/floor/mineral/titanium,/area/shuttle/escape)
"RG" = (/obj/structure/bed/roller,/obj/machinery/iv_drip,/obj/effect/turf_decal/tile/blue,/obj/effect/turf_decal/tile/blue{dir = 8},/turf/open/floor/mineral/titanium/blue,/area/shuttle/escape)
"RL" = (/obj/effect/turf_decal/arrows{dir = 8},/obj/effect/turf_decal/stripes/corner{dir = 4},/obj/effect/turf_decal/stripes/corner{dir = 8},/turf/open/floor/mineral/titanium,/area/shuttle/escape)
"RX" = (/turf/open/floor/mineral/titanium/white,/area/shuttle/escape)
"SH" = (/obj/structure/chair/comfy/shuttle{dir = 8},/turf/open/floor/mineral/plastitanium/red/brig,/area/shuttle/escape)
"SQ" = (/obj/machinery/light{dir = 4},/obj/effect/turf_decal/stripes/line{dir = 4},/turf/open/floor/mineral/titanium,/area/shuttle/escape)
"Ti" = (/obj/item/stack/marker_beacon{anchored = 1; icon_state = "markerburgundy-on"; light_color = "#FA644B"; light_power = 3; light_range = 2; name = "landing marker"; picked_color = "Burgundy"},/turf/closed/wall/mineral/plastitanium/nodiagonal,/area/shuttle/escape)
"Tr" = (/obj/effect/turf_decal/tile/brown,/obj/effect/turf_decal/tile/brown{dir = 8},/obj/structure/sign/warning/nosmoking/circle{pixel_x = -32},/turf/open/floor/mineral/titanium/yellow,/area/shuttle/escape)
"TI" = (/obj/effect/turf_decal/stripes/corner{dir = 1},/turf/open/floor/mineral/titanium,/area/shuttle/escape)
"TN" = (/obj/effect/turf_decal/stripes/line{dir = 4},/turf/open/floor/mineral/titanium,/area/shuttle/escape)
"Ua" = (/obj/effect/turf_decal/stripes/line{dir = 8},/turf/open/floor/mineral/titanium,/area/shuttle/escape)
"Uh" = (/turf/open/floor/mineral/plastitanium/red/brig,/area/shuttle/escape)
"UV" = (/obj/machinery/door/firedoor/border_only{dir = 8},/obj/machinery/door/firedoor/border_only{dir = 4},/obj/machinery/door/airlock/medical/glass{name = "Escape Shuttle Infirmary"},/turf/open/floor/pod/dark,/area/shuttle/escape)
"UY" = (/obj/machinery/door/airlock/command{name = "Emergency Recovery Airlock"; req_access_txt = "19"},/obj/effect/decal/cleanable/dirt,/obj/machinery/door/firedoor/border_only{dir = 8},/obj/machinery/door/firedoor/border_only{dir = 4},/obj/effect/turf_decal/stripes/box,/turf/open/floor/pod/dark,/area/shuttle/escape)
"Vh" = (/obj/structure/shuttle/engine/propulsion,/obj/effect/turf_decal/stripes/line,/turf/open/floor/plating/airless,/area/shuttle/escape)
"VN" = (/obj/effect/turf_decal/tile/brown,/obj/effect/turf_decal/tile/brown{dir = 8},/obj/machinery/recharge_station,/obj/effect/turf_decal/delivery,/obj/effect/decal/cleanable/dirt,/obj/effect/turf_decal/stripes/line{dir = 8},/turf/open/floor/mineral/titanium,/area/shuttle/escape)
"VT" = (/obj/structure/shuttle/engine/heater,/obj/effect/spawner/structure/window/plastitanium,/turf/open/floor/plating,/area/shuttle/escape)
"Wa" = (/obj/structure/chair/comfy/shuttle{dir = 1},/obj/machinery/light{dir = 8},/obj/effect/turf_decal/tile/neutral,/obj/effect/turf_decal/tile/neutral{dir = 1},/obj/effect/turf_decal/stripes/line{dir = 1},/obj/machinery/keycard_auth{pixel_x = -24},/turf/open/floor/mineral/titanium,/area/shuttle/escape)
"WB" = (/obj/structure/reagent_dispensers/peppertank{pixel_x = -29},/obj/effect/turf_decal/bot,/obj/machinery/vending/wardrobe/sec_wardrobe,/turf/open/floor/mineral/plastitanium/red/brig,/area/shuttle/escape)
"WP" = (/obj/structure/chair/comfy/shuttle{dir = 1},/obj/machinery/light{dir = 4},/obj/effect/turf_decal/tile/neutral,/obj/effect/turf_decal/tile/neutral{dir = 1},/obj/effect/turf_decal/stripes/line{dir = 1},/turf/open/floor/mineral/titanium,/area/shuttle/escape)
"Xf" = (/obj/structure/table,/obj/machinery/recharger{pixel_x = 7},/obj/machinery/recharger{pixel_x = -7},/obj/effect/turf_decal/bot,/obj/effect/turf_decal/stripes/line,/turf/open/floor/pod/dark,/area/shuttle/escape)
"XS" = (/obj/structure/sign/warning/fire,/turf/closed/wall/mineral/plastitanium/nodiagonal,/area/shuttle/escape)
"Yj" = (/obj/effect/turf_decal/tile/brown,/obj/effect/turf_decal/tile/brown{dir = 8},/obj/effect/turf_decal/stripes/line{dir = 1},/obj/structure/extinguisher_cabinet{dir = 4; pixel_y = -27},/obj/effect/turf_decal/bot,/turf/open/floor/mineral/titanium,/area/shuttle/escape)
"Yp" = (/obj/structure/chair/comfy/shuttle{dir = 8},/obj/effect/turf_decal/bot,/obj/machinery/light{dir = 4},/turf/open/floor/mineral/plastitanium,/area/shuttle/escape)
"YC" = (/obj/structure/rack,/obj/item/tank/internals/oxygen/red,/obj/item/clothing/suit/fire/firefighter,/obj/item/clothing/mask/gas,/obj/item/clothing/head/hardhat/red,/obj/effect/turf_decal/tile/brown{dir = 8},/obj/effect/turf_decal/tile/brown,/obj/effect/decal/cleanable/dirt,/obj/effect/turf_decal/delivery,/obj/effect/turf_decal/stripes/corner{dir = 4},/turf/open/floor/mineral/titanium,/area/shuttle/escape)
"YW" = (/obj/effect/turf_decal/tile/brown,/obj/effect/turf_decal/tile/brown{dir = 8},/obj/machinery/recharge_station,/obj/effect/turf_decal/delivery,/obj/effect/turf_decal/stripes/line{dir = 8},/obj/effect/decal/cleanable/dirt,/turf/open/floor/mineral/titanium,/area/shuttle/escape)
"Zn" = (/obj/structure/chair/comfy/shuttle{dir = 1},/turf/open/floor/mineral/titanium/white,/area/shuttle/escape)
"Zt" = (/obj/structure/chair/comfy/shuttle{dir = 4},/obj/effect/turf_decal/bot,/obj/machinery/light{dir = 8},/turf/open/floor/mineral/plastitanium,/area/shuttle/escape)

(1,1,1) = {"
QoQojtCjLcrFLcLcCjCjCjLcLcQoQoQoQoQoQo
QoQojsGPNKrFyiAeyeXftrIPrFjtQoQoQoQoQo
QoQoLcnALcLcWaAuAuaMAuAuWPLcQoQoQoQoQo
QoQoLciLIeuQyqRXyqyqyqRXjzCjQoQoQoQoQo
QoQoCjininUYRXRXyqyqyqRXiICjQoQoQoQoQo
QoQoLcaWaWPUpdZnRXOARXZnoaLcQoQoQoQoQo
QoQojtLcLcrFLcrFvMLcvMrFrFLcLcCjjtQoQo
QoQoCjnOzBsznOFmRXlwRXLcWBUhtFQmCjQoQo
QoQoCjKVRXRXRXUVRXRXRXNFUhUhLbjdCjQoQo
QoQoLcDgRXRXyTFmCXlwzALcCjaPaPCjLcQoQo
QoQoLctCRXRXHXLckeLckeLcluUhUhIZLcQoQo
QoQoLcHgRXRXHCCjASQAASCjtcUhUhSHCjQoQo
jtCjrFRGRXRXMMPUASASASPUOFUhUhSHrFCjjt
utaUwbRXRXRXCnLcGrECJOLcEXUhUhMJcFaUGl
rFCjrFFmghghFmrFASASASrFCjaPaPCjrFCjrF
utabLTASASASASmrASASASmrASASASASGVabtL
LcQLNGRzcTRzPxnwRzRzRzPxnwRzcTRzIjQLLc
LcZtPQYprFZtUaTNzMzMzMUaTNYprFZtPQYpLc
CjzwPQRlvTzwUaSQrFvTrFxTTNRlvTzwPQRlCj
CjzwPQRlvTzwUaTNcMcMcMUaTNRlvTzwPQRlCj
LczwPQRlvTzwUazSIzhnIzTITNRlvTzwPQRlLc
LcZtPQRlvTzwUaLcLcCjLcLcTNRlvTzwPQYpLc
utmWIBRlvTzwUaLcLRcgYWLcTNRlvTzwgsmWtL
LcfCTNYprFZtUaCjtycgVNCjTNYprFZtUafCLc
utabRLIzsQIzTILcdVcguxLczSIzsQIzrXabHc
vtQLUaASASASASIxTrcgcgIxASASASASTNQLvt
vtVTvtzMzMzMzMvtKXcgMhvtzMzMzMzMvtVTvt
TiVhXSVTVTVTVTlcYCYjlMlcVTVTVTVTXSVhTi
QoQoTibSBIbSBITivtlcvtTibSBIbSBITiQoQo
"}
