//MAP CONVERTED BY dmm2tgm.py THIS HEADER COMMENT PREVENTS RECONVERSION, DO NOT REMOVE
"aa" = (
/turf/template_noop,
/area/template_noop)
"ab" = (
/turf/closed/wall/mineral/titanium,
/area/shuttle/escape)
"ac" = (
/obj/effect/spawner/structure/window/shuttle{
	dir = 1
	},
/turf/open/floor/plating,
/area/shuttle/escape)
"ad" = (
/turf/closed/wall/mineral/titanium/nodiagonal,
/area/shuttle/escape)
"ae" = (
/obj/structure/table/wood{
	dir = 1
	},
/turf/open/floor/carpet,
/area/shuttle/escape)
"af" = (
/obj/structure/chair/comfy/brown{
	dir = 2
	},
/turf/open/floor/carpet,
/area/shuttle/escape)
"ag" = (
/obj/machinery/computer/emergency_shuttle{
	dir = 4
	},
/turf/open/floor/carpet,
/area/shuttle/escape)
"ah" = (
/obj/structure/table/wood{
	dir = 1
	},
/obj/structure/window/reinforced{
	dir = 4
	},
/turf/open/floor/carpet,
/area/shuttle/escape)
"ai" = (
/obj/machinery/computer/atmos_alert{
	dir = 4
	},
/turf/open/floor/carpet,
/area/shuttle/escape)
"aj" = (
/obj/structure/chair/comfy/brown{
	dir = 8
	},
/turf/open/floor/carpet,
/area/shuttle/escape)
"ak" = (
/turf/open/floor/carpet,
/area/shuttle/escape)
"al" = (
/obj/structure/chair/comfy/brown{
	dir = 4
	},
/obj/structure/window/reinforced{
	dir = 4
	},
/obj/structure/window/reinforced{
	dir = 1
	},
/turf/open/floor/carpet,
/area/shuttle/escape)
"am" = (
/obj/machinery/computer/crew{
	dir = 4
	},
/turf/open/floor/carpet,
/area/shuttle/escape)
"an" = (
/obj/item/radio/intercom{
	name = "Station Intercom (General)";
	pixel_y = 29;
	dir = 1
	},
/turf/open/floor/carpet,
/area/shuttle/escape)
"ao" = (
/obj/machinery/button/flasher{
	id = "cockpit_flasher";
	pixel_x = 6;
	pixel_y = 24;
	dir = 1
	},
/obj/structure/table/wood/poker{
	dir = 1
	},
/obj/machinery/light{
	dir = 1
	},
/turf/open/floor/carpet,
/area/shuttle/escape)
"ap" = (
/obj/structure/window/reinforced{
	dir = 4
	},
/turf/open/floor/carpet,
/area/shuttle/escape)
"as" = (
/obj/machinery/door/airlock/titanium{
	name = "Emergency Shuttle Airlock";
	req_access_txt = "2";
	dir = 1
	},
/turf/open/floor/mineral/titanium,
/area/shuttle/escape)
"at" = (
/obj/structure/chair/comfy/shuttle{
	dir = 1
	},
/turf/open/floor/mineral/plastitanium/red/brig,
/area/shuttle/escape)
"au" = (
/obj/machinery/flasher{
	id = "cockpit_flasher";
	pixel_x = 6;
	pixel_y = -24;
	dir = 1
	},
/obj/effect/turf_decal/tile/bar{
	dir = 4
	},
/obj/effect/turf_decal/tile/bar{
	dir = 8
	},
/turf/open/floor/plasteel,
/area/shuttle/escape)
"av" = (
/obj/effect/turf_decal/tile/bar{
	dir = 4
	},
/obj/effect/turf_decal/tile/bar{
	dir = 8
	},
/turf/open/floor/plasteel,
/area/shuttle/escape)
"aw" = (
/turf/open/floor/mineral/titanium,
/area/shuttle/escape)
"ax" = (
/obj/machinery/flasher{
	id = "shuttle_flasher";
	pixel_x = -24;
	pixel_y = -6;
	dir = 1
	},
/obj/machinery/button/flasher{
	id = "shuttle_flasher";
	pixel_x = -24;
	pixel_y = 6;
	dir = 1
	},
/obj/machinery/light/small{
	brightness = 3;
	dir = 8
	},
/turf/open/floor/mineral/plastitanium/red/brig,
/area/shuttle/escape)
"ay" = (
/turf/open/floor/mineral/plastitanium/red/brig,
/area/shuttle/escape)
"az" = (
/obj/structure/grille{
	dir = 1
	},
/obj/machinery/door/airlock/public/glass{
	name = "Emergency Shuttle Brig";
	req_access_txt = "2";
	dir = 1
	},
/turf/open/floor/plating,
/area/shuttle/escape)
"aA" = (
/obj/structure/grille/broken{
	dir = 1
	},
/turf/open/floor/plasteel,
/area/shuttle/escape)
"aB" = (
/turf/closed/wall/mineral/titanium/interior,
/area/shuttle/escape)
"aD" = (
/obj/structure/extinguisher_cabinet{
	pixel_y = 30;
	dir = 1
	},
/obj/structure/table{
	dir = 1
	},
/obj/item/extinguisher{
	dir = 1
	},
/obj/item/crowbar{
	dir = 1
	},
/turf/open/floor/mineral/plastitanium/red/brig,
/area/shuttle/escape)
"aE" = (
/obj/structure/chair/comfy/shuttle{
	dir = 2
	},
/turf/open/floor/mineral/plastitanium/red/brig,
/area/shuttle/escape)
"aF" = (
/obj/item/kirbyplants/random{
	dir = 1
	},
/turf/open/floor/mineral/titanium/blue,
/area/shuttle/escape)
"aG" = (
/obj/structure/chair/comfy/shuttle{
	dir = 1
	},
/turf/open/floor/mineral/titanium/blue,
/area/shuttle/escape)
"aH" = (
/obj/structure/table{
	dir = 1
	},
/obj/item/storage/firstaid/regular{
	dir = 1
	},
/turf/open/floor/mineral/titanium/blue,
/area/shuttle/escape)
"aI" = (
/obj/structure/window/reinforced{
	dir = 4
	},
/obj/item/radio/intercom{
	name = "Station Intercom (General)";
	pixel_y = -23;
	dir = 1
	},
/turf/open/floor/mineral/titanium/blue,
/area/shuttle/escape)
"aJ" = (
/obj/structure/window/reinforced{
	dir = 4
	},
/turf/open/floor/mineral/titanium,
/area/shuttle/escape)
"aL" = (
/obj/structure/chair/comfy/shuttle{
	dir = 2
	},
/turf/open/floor/mineral/titanium/blue,
/area/shuttle/escape)
"aM" = (
/obj/structure/window/reinforced{
	dir = 4
	},
/obj/structure/chair/comfy/shuttle{
	dir = 4
	},
/turf/open/floor/mineral/titanium/blue,
/area/shuttle/escape)
"aN" = (
/obj/structure/table/wood{
	dir = 1
	},
/obj/item/toy/cards/deck/cas/black{
	dir = 1
	},
/turf/open/floor/mineral/titanium/blue,
/area/shuttle/escape)
"aO" = (
/obj/structure/table/wood{
	dir = 1
	},
/turf/open/floor/mineral/titanium/blue,
/area/shuttle/escape)
"aP" = (
/obj/structure/table/wood{
	dir = 1
	},
/obj/item/toy/cards/deck/cas{
	dir = 1
	},
/turf/open/floor/mineral/titanium,
/area/shuttle/escape)
"aQ" = (
/obj/structure/chair/comfy/brown{
	dir = 8
	},
/turf/open/floor/mineral/titanium,
/area/shuttle/escape)
"aR" = (
/obj/structure/table_frame{
	dir = 1
	},
/turf/open/floor/mineral/titanium/blue,
/area/shuttle/escape)
"aS" = (
/obj/structure/table/wood{
	dir = 1
	},
/obj/item/storage/firstaid/fire{
	dir = 1
	},
/turf/open/floor/mineral/titanium/blue,
/area/shuttle/escape)
"aT" = (
/obj/structure/chair/comfy/shuttle{
	dir = 2
	},
/obj/structure/extinguisher_cabinet{
	pixel_y = 30;
	dir = 1
	},
/turf/open/floor/mineral/titanium/blue,
/area/shuttle/escape)
"aU" = (
/turf/open/floor/mineral/titanium/blue,
/area/shuttle/escape)
"aV" = (
/obj/structure/table{
	dir = 1
	},
/obj/machinery/recharger{
	dir = 1
	},
/turf/open/floor/mineral/titanium/blue,
/area/shuttle/escape)
"aW" = (
/obj/structure/window/reinforced{
	dir = 4
	},
/turf/open/floor/mineral/titanium/blue,
/area/shuttle/escape)
"aX" = (
/turf/open/floor/plasteel/grimy,
/area/shuttle/escape)
"aY" = (
/obj/structure/chair/wood{
	dir = 2
	},
/turf/open/floor/plasteel/grimy,
/area/shuttle/escape)
"ba" = (
/obj/structure/extinguisher_cabinet{
	pixel_y = 30;
	dir = 1
	},
/obj/effect/turf_decal/tile/bar{
	dir = 4
	},
/obj/effect/turf_decal/tile/bar{
	dir = 8
	},
/turf/open/floor/plasteel,
/area/shuttle/escape)
"bb" = (
/obj/structure/window/reinforced{
	dir = 4
	},
/obj/structure/barricade/wooden{
	dir = 1
	},
/obj/machinery/light{
	dir = 1
	},
/obj/effect/turf_decal/tile/bar{
	dir = 4
	},
/obj/effect/turf_decal/tile/bar{
	dir = 8
	},
/turf/open/floor/plasteel,
/area/shuttle/escape)
"bc" = (
/obj/machinery/status_display/evac{
	dir = 1
	},
/turf/closed/wall/mineral/titanium,
/area/shuttle/escape)
"be" = (
/turf/open/floor/plasteel/freezer,
/area/shuttle/escape)
"bf" = (
/obj/structure/extinguisher_cabinet{
	pixel_y = -30;
	dir = 1
	},
/obj/machinery/light/small{
	dir = 2
	},
/turf/open/floor/plasteel/freezer,
/area/shuttle/escape)
"bj" = (
/obj/structure/toilet{
	dir = 4
	},
/obj/machinery/light/small{
	dir = 4
	},
/turf/open/floor/plasteel/freezer,
/area/shuttle/escape)
"bk" = (
/obj/machinery/recharge_station{
	dir = 1
	},
/obj/machinery/light/small{
	dir = 4
	},
/turf/open/floor/plasteel/freezer,
/area/shuttle/escape)
"bl" = (
/obj/structure/window/reinforced{
	dir = 2
	},
/obj/structure/shuttle/engine/heater{
	dir = 1
	},
/turf/open/floor/plating/airless,
/area/shuttle/escape)
"bm" = (
/obj/structure/window/reinforced{
	dir = 2
	},
/obj/structure/shuttle/engine/heater{
	dir = 1
	},
/obj/structure/window/reinforced{
	dir = 4
	},
/turf/open/floor/plating/airless,
/area/shuttle/escape)
"bn" = (
/obj/structure/shuttle/engine/propulsion{
	dir = 1
	},
/turf/open/floor/plating/airless,
/area/shuttle/escape)
"bo" = (
/obj/structure/chair/comfy/shuttle{
	dir = 1
	},
/obj/machinery/light{
	dir = 2
	},
/turf/open/floor/mineral/titanium/blue,
/area/shuttle/escape)
"bp" = (
/obj/structure/chair/comfy/shuttle{
	dir = 2
	},
/obj/machinery/light{
	dir = 2
	},
/turf/open/floor/mineral/titanium/blue,
/area/shuttle/escape)
"bL" = (
/obj/machinery/door/airlock{
	name = "Unit 2";
	dir = 1
	},
/obj/machinery/door/firedoor{
	dir = 1
	},
/turf/open/floor/plasteel/freezer,
/area/shuttle/escape)
"cq" = (
/obj/structure/grille/broken{
	dir = 1
	},
/obj/machinery/door/firedoor{
	dir = 1
	},
/turf/open/floor/plasteel,
/area/shuttle/escape)
"gl" = (
/obj/machinery/door/airlock/titanium{
	name = "Emergency Shuttle Airlock";
	req_access_txt = "2";
	dir = 1
	},
/obj/structure/fans/tiny{
	dir = 1
	},
/turf/open/floor/plating,
/area/shuttle/escape)
"jr" = (
/obj/machinery/door/airlock/titanium{
	name = "Emergency Shuttle Airlock";
	dir = 1
	},
/obj/docking_port/mobile/emergency{
	name = "Scrapheap Challenge";
	dir = 4
	},
/obj/structure/fans/tiny{
	dir = 1
	},
/turf/open/floor/plating,
/area/shuttle/escape)
"ly" = (
/obj/structure/window/reinforced{
	dir = 4
	},
/obj/machinery/door/firedoor{
	dir = 1
	},
/turf/open/floor/mineral/titanium/blue,
/area/shuttle/escape)
"mJ" = (
/obj/machinery/door/airlock{
	name = "Unisex Restrooms";
	dir = 1
	},
/obj/machinery/door/firedoor{
	dir = 1
	},
/turf/open/floor/plasteel/freezer,
/area/shuttle/escape)
"mN" = (
/obj/machinery/door/airlock/titanium{
	name = "Emergency Shuttle Airlock";
	dir = 1
	},
/obj/structure/fans/tiny{
	dir = 1
	},
/turf/open/floor/plating,
/area/shuttle/escape)
"Dc" = (
/obj/machinery/door/airlock/titanium{
	name = "Emergency Shuttle Airlock";
	req_access_txt = "2";
	dir = 1
	},
/obj/machinery/door/firedoor{
	dir = 1
	},
/turf/open/floor/mineral/plastitanium/red/brig,
/area/shuttle/escape)
"Gw" = (
/obj/machinery/door/firedoor{
	dir = 1
	},
/turf/open/floor/mineral/titanium,
/area/shuttle/escape)
"KJ" = (
/obj/machinery/door/airlock{
	name = "Unit 1";
	dir = 1
	},
/obj/machinery/door/firedoor{
	dir = 1
	},
/turf/open/floor/plasteel/freezer,
/area/shuttle/escape)
"NP" = (
/obj/machinery/door/airlock/public/glass{
	name = "Emergency Shuttle Cockpit";
	req_access_txt = "19";
	dir = 1
	},
/obj/machinery/door/firedoor{
	dir = 1
	},
/turf/open/floor/carpet,
/area/shuttle/escape)
"Ow" = (
/obj/machinery/door/airlock{
	name = "Unit B";
	dir = 1
	},
/obj/machinery/door/firedoor{
	dir = 1
	},
/turf/open/floor/plasteel/freezer,
/area/shuttle/escape)
"Uc" = (
/obj/effect/spawner/structure/window/shuttle{
	dir = 1
	},
/obj/machinery/door/firedoor/window{
	dir = 1
	},
/turf/open/floor/plating,
/area/shuttle/escape)

(1,1,1) = {"
aa
ab
ab
ab
mN
ab
mN
ab
Uc
Uc
Uc
ab
jr
ab
gl
ab
ab
ab
aa
aa
aa
aa"}(2,1,1) = {"
ab
ab
bj
KJ
be
ab
av
aX
aR
aw
aG
cq
bp
ab
aD
ax
ac
ac
ab
ab
ab
aa"}(3,1,1) = {"
bn
bl
ab
ab
be
ab
ba
aY
aS
aP
aN
ac
aL
ab
aE
ay
at
Dc
am
ai
ad
ab"}(4,1,1) = {"
bn
bl
bj
bL
bf
ab
av
aY
aO
aQ
aO
ac
aL
ab
aE
ay
ac
ac
ak
aj
ae
ac"}(5,1,1) = {"
bn
bl
ab
ab
be
bc
av
ac
aL
aw
aG
ac
aL
ad
ac
az
ac
ab
an
ak
af
ac"}(6,1,1) = {"
bn
bl
bk
Ow
be
mJ
av
ac
aL
aw
aw
Gw
aw
aw
aF
aA
au
ab
ao
ak
ag
ac"}(7,1,1) = {"
bn
bm
ab
ab
ab
ad
bb
ac
aL
aw
aG
ac
aL
aw
aG
ac
av
NP
ap
ak
af
ac"}(8,1,1) = {"
aa
aa
aa
aa
aa
aa
aa
ab
aT
aw
aG
ac
aL
aw
bo
aB
ac
Uc
aa
al
ah
ac"}(9,1,1) = {"
aa
aa
aa
aa
aa
aa
aa
ab
aU
aw
aG
ac
aL
aw
aw
Gw
aw
as
aa
aa
aa
aa"}(10,1,1) = {"
aa
aa
aa
aa
aa
aa
aa
ab
aV
aw
aG
ac
aL
aw
aH
aB
Uc
Uc
aa
aa
aa
aa"}(11,1,1) = {"
aa
aa
aa
aa
aa
aa
aa
ab
aW
aJ
aM
ly
aM
aJ
aI
ab
aa
aa
aa
aa
aa
aa"}