//MAP CONVERTED BY dmm2tgm.py THIS HEADER COMMENT PREVENTS RECONVERSION, DO NOT REMOVE
"aa" = (
/turf/closed/wall/mineral/titanium,
/area/shuttle/escape)
"ab" = (
/obj/structure/window/shuttle{
	dir = 1
	},
/obj/structure/grille{
	dir = 1
	},
/turf/open/floor/plating,
/area/shuttle/escape)
"ac" = (
/obj/structure/sign/nanotrasen{
	dir = 1
	},
/turf/closed/wall/mineral/titanium,
/area/shuttle/escape)
"ad" = (
/obj/structure/chair/comfy/shuttle{
	dir = 4
	},
/obj/machinery/newscaster/security_unit{
	pixel_y = -32;
	dir = 1
	},
/obj/structure/reagent_dispensers/peppertank{
	pixel_x = -32;
	dir = 1
	},
/turf/open/floor/mineral/plastitanium/red/brig,
/area/shuttle/escape)
"ae" = (
/obj/structure/chair/comfy/shuttle{
	dir = 1
	},
/turf/open/floor/mineral/plastitanium/red/brig,
/area/shuttle/escape)
"af" = (
/obj/structure/chair/comfy/shuttle{
	dir = 8
	},
/obj/item/radio/intercom{
	name = "Station Intercom";
	pixel_y = -24;
	dir = 1
	},
/turf/open/floor/mineral/plastitanium/red/brig,
/area/shuttle/escape)
"ag" = (
/obj/structure/table/reinforced{
	dir = 1
	},
/obj/machinery/recharger{
	dir = 1
	},
/obj/machinery/status_display/evac{
	pixel_y = -32;
	dir = 1
	},
/obj/effect/turf_decal/tile/neutral{
	dir = 8
	},
/obj/effect/turf_decal/tile/neutral{
	dir = 4
	},
/obj/effect/turf_decal/tile/neutral{
	dir = 2
	},
/obj/effect/turf_decal/tile/neutral{
	dir = 1
	},
/turf/open/floor/plasteel/dark,
/area/shuttle/escape)
"ah" = (
/obj/machinery/computer/emergency_shuttle{
	dir = 1
	},
/obj/effect/turf_decal/tile/neutral{
	dir = 8
	},
/obj/effect/turf_decal/tile/neutral{
	dir = 4
	},
/obj/effect/turf_decal/tile/neutral{
	dir = 2
	},
/obj/effect/turf_decal/tile/neutral{
	dir = 1
	},
/turf/open/floor/plasteel/dark,
/area/shuttle/escape)
"ai" = (
/obj/machinery/computer/communications{
	dir = 1
	},
/obj/effect/turf_decal/tile/neutral{
	dir = 8
	},
/obj/effect/turf_decal/tile/neutral{
	dir = 4
	},
/obj/effect/turf_decal/tile/neutral{
	dir = 2
	},
/obj/effect/turf_decal/tile/neutral{
	dir = 1
	},
/turf/open/floor/plasteel/dark,
/area/shuttle/escape)
"aj" = (
/obj/structure/table/reinforced{
	dir = 1
	},
/obj/item/storage/firstaid/regular{
	dir = 1
	},
/obj/effect/turf_decal/tile/neutral{
	dir = 8
	},
/obj/effect/turf_decal/tile/neutral{
	dir = 4
	},
/obj/effect/turf_decal/tile/neutral{
	dir = 2
	},
/obj/effect/turf_decal/tile/neutral{
	dir = 1
	},
/turf/open/floor/plasteel/dark,
/area/shuttle/escape)
"ak" = (
/obj/structure/chair/comfy/shuttle{
	dir = 4
	},
/obj/machinery/status_display/evac{
	pixel_x = -32;
	dir = 1
	},
/obj/machinery/light{
	dir = 8
	},
/turf/open/floor/mineral/plastitanium/red/brig,
/area/shuttle/escape)
"al" = (
/turf/open/floor/mineral/plastitanium/red/brig,
/area/shuttle/escape)
"an" = (
/obj/effect/turf_decal/tile/neutral{
	dir = 8
	},
/obj/effect/turf_decal/tile/neutral{
	dir = 4
	},
/obj/effect/turf_decal/tile/neutral{
	dir = 2
	},
/obj/effect/turf_decal/tile/neutral{
	dir = 1
	},
/turf/open/floor/plasteel/dark,
/area/shuttle/escape)
"ao" = (
/obj/structure/chair/comfy/brown{
	color = "#596479";
	dir = 2
	},
/obj/effect/turf_decal/tile/neutral{
	dir = 8
	},
/obj/effect/turf_decal/tile/neutral{
	dir = 4
	},
/obj/effect/turf_decal/tile/neutral{
	dir = 2
	},
/obj/effect/turf_decal/tile/neutral{
	dir = 1
	},
/turf/open/floor/plasteel/dark,
/area/shuttle/escape)
"ap" = (
/obj/structure/table/reinforced{
	dir = 1
	},
/obj/item/storage/fancy/donut_box{
	dir = 1
	},
/obj/machinery/light{
	dir = 4
	},
/obj/effect/turf_decal/tile/neutral{
	dir = 8
	},
/obj/effect/turf_decal/tile/neutral{
	dir = 4
	},
/obj/effect/turf_decal/tile/neutral{
	dir = 2
	},
/obj/effect/turf_decal/tile/neutral{
	dir = 1
	},
/turf/open/floor/plasteel/dark,
/area/shuttle/escape)
"ar" = (
/obj/structure/table/reinforced{
	dir = 1
	},
/obj/machinery/recharger{
	dir = 1
	},
/turf/open/floor/mineral/plastitanium/red/brig,
/area/shuttle/escape)
"as" = (
/obj/item/kirbyplants{
	icon_state = "plant-21";
	pixel_x = -3;
	pixel_y = -3;
	dir = 1
	},
/obj/effect/turf_decal/tile/neutral{
	dir = 8
	},
/obj/effect/turf_decal/tile/neutral{
	dir = 4
	},
/obj/effect/turf_decal/tile/neutral{
	dir = 2
	},
/obj/effect/turf_decal/tile/neutral{
	dir = 1
	},
/turf/open/floor/plasteel/dark,
/area/shuttle/escape)
"at" = (
/obj/structure/chair/comfy/brown{
	color = "#596479";
	dir = 4
	},
/obj/effect/turf_decal/tile/neutral{
	dir = 8
	},
/obj/effect/turf_decal/tile/neutral{
	dir = 4
	},
/obj/effect/turf_decal/tile/neutral{
	dir = 2
	},
/obj/effect/turf_decal/tile/neutral{
	dir = 1
	},
/turf/open/floor/plasteel/dark,
/area/shuttle/escape)
"au" = (
/obj/machinery/computer/crew{
	dir = 8
	},
/obj/machinery/status_display/ai{
	pixel_x = 32;
	dir = 1
	},
/obj/effect/turf_decal/tile/neutral{
	dir = 8
	},
/obj/effect/turf_decal/tile/neutral{
	dir = 4
	},
/obj/effect/turf_decal/tile/neutral{
	dir = 2
	},
/obj/effect/turf_decal/tile/neutral{
	dir = 1
	},
/turf/open/floor/plasteel/dark,
/area/shuttle/escape)
"aw" = (
/obj/machinery/status_display/ai{
	dir = 1
	},
/turf/closed/wall/mineral/titanium/nodiagonal,
/area/shuttle/escape)
"az" = (
/obj/effect/turf_decal/delivery{
	dir = 4
	},
/turf/open/floor/plasteel,
/area/shuttle/escape)
"aA" = (
/obj/effect/turf_decal/tile/neutral{
	dir = 8
	},
/obj/effect/turf_decal/tile/neutral{
	dir = 2
	},
/turf/open/floor/plasteel,
/area/shuttle/escape)
"aB" = (
/obj/machinery/light{
	dir = 2
	},
/obj/effect/turf_decal/tile/neutral{
	dir = 8
	},
/obj/effect/turf_decal/tile/neutral{
	dir = 2
	},
/turf/open/floor/plasteel,
/area/shuttle/escape)
"aC" = (
/obj/item/kirbyplants{
	icon_state = "plant-21";
	pixel_x = -3;
	pixel_y = -3;
	dir = 1
	},
/obj/item/radio/intercom{
	name = "Station Intercom";
	pixel_x = 26;
	dir = 1
	},
/obj/effect/turf_decal/delivery{
	dir = 4
	},
/turf/open/floor/plasteel,
/area/shuttle/escape)
"aD" = (
/obj/structure/chair/comfy/shuttle{
	dir = 4
	},
/obj/machinery/status_display/evac{
	pixel_x = -32;
	dir = 1
	},
/obj/effect/turf_decal/bot{
	dir = 4
	},
/turf/open/floor/plasteel,
/area/shuttle/escape)
"aE" = (
/obj/effect/turf_decal/tile/neutral{
	dir = 8
	},
/obj/effect/turf_decal/tile/neutral{
	dir = 4
	},
/obj/effect/turf_decal/tile/neutral{
	dir = 2
	},
/obj/effect/turf_decal/tile/neutral{
	dir = 1
	},
/turf/open/floor/plasteel,
/area/shuttle/escape)
"aF" = (
/obj/structure/chair/comfy/shuttle{
	dir = 8
	},
/obj/effect/turf_decal/bot{
	dir = 4
	},
/turf/open/floor/plasteel,
/area/shuttle/escape)
"aG" = (
/obj/structure/flora/ausbushes/grassybush{
	dir = 1
	},
/obj/structure/flora/ausbushes/lavendergrass{
	dir = 1
	},
/obj/structure/flora/ausbushes/ppflowers{
	dir = 1
	},
/obj/structure/flora/ausbushes/sunnybush{
	dir = 1
	},
/obj/structure/window/shuttle{
	dir = 1
	},
/turf/open/floor/grass,
/area/shuttle/escape)
"aH" = (
/obj/item/clothing/suit/hazardvest{
	desc = "A high-visibility lifejacket complete with whistle and slot for oxygen tanks.";
	name = "emergency lifejacket";
	dir = 1
	},
/obj/item/clothing/suit/hazardvest{
	desc = "A high-visibility lifejacket complete with whistle and slot for oxygen tanks.";
	name = "emergency lifejacket";
	dir = 1
	},
/obj/item/clothing/suit/hazardvest{
	desc = "A high-visibility lifejacket complete with whistle and slot for oxygen tanks.";
	name = "emergency lifejacket";
	dir = 1
	},
/obj/item/clothing/suit/hazardvest{
	desc = "A high-visibility lifejacket complete with whistle and slot for oxygen tanks.";
	name = "emergency lifejacket";
	dir = 1
	},
/obj/item/clothing/suit/hazardvest{
	desc = "A high-visibility lifejacket complete with whistle and slot for oxygen tanks.";
	name = "emergency lifejacket";
	dir = 1
	},
/obj/item/tank/internals/emergency_oxygen{
	pixel_x = 3;
	dir = 1
	},
/obj/item/tank/internals/emergency_oxygen{
	pixel_x = 3;
	dir = 1
	},
/obj/item/tank/internals/emergency_oxygen{
	pixel_x = 3;
	dir = 1
	},
/obj/item/tank/internals/emergency_oxygen{
	pixel_x = 3;
	dir = 1
	},
/obj/item/tank/internals/emergency_oxygen{
	pixel_x = 3;
	dir = 1
	},
/obj/item/clothing/mask/breath{
	pixel_x = -3;
	pixel_y = 3;
	dir = 1
	},
/obj/item/clothing/mask/breath{
	pixel_x = -3;
	pixel_y = 3;
	dir = 1
	},
/obj/item/clothing/mask/breath{
	pixel_x = -3;
	pixel_y = 3;
	dir = 1
	},
/obj/item/clothing/mask/breath{
	pixel_x = -3;
	pixel_y = 3;
	dir = 1
	},
/obj/item/clothing/mask/breath{
	pixel_x = -3;
	pixel_y = 3;
	dir = 1
	},
/obj/item/clothing/head/hardhat/orange{
	name = "protective hat";
	pixel_y = -9;
	dir = 1
	},
/obj/item/clothing/head/hardhat/orange{
	name = "protective hat";
	pixel_y = -9;
	dir = 1
	},
/obj/item/clothing/head/hardhat/orange{
	name = "protective hat";
	pixel_y = -9;
	dir = 1
	},
/obj/item/clothing/head/hardhat/orange{
	name = "protective hat";
	pixel_y = -9;
	dir = 1
	},
/obj/item/clothing/head/hardhat/orange{
	name = "protective hat";
	pixel_y = -9;
	dir = 1
	},
/obj/structure/closet/crate/internals{
	dir = 1
	},
/obj/effect/turf_decal/bot{
	dir = 4
	},
/turf/open/floor/plasteel,
/area/shuttle/escape)
"aI" = (
/obj/structure/flora/ausbushes/grassybush{
	dir = 1
	},
/obj/structure/flora/ausbushes/lavendergrass{
	dir = 1
	},
/obj/structure/flora/ausbushes/ywflowers{
	dir = 1
	},
/obj/structure/flora/ausbushes/fernybush{
	dir = 1
	},
/obj/structure/window/shuttle{
	dir = 1
	},
/turf/open/floor/grass,
/area/shuttle/escape)
"aJ" = (
/obj/structure/chair/comfy/shuttle{
	dir = 4
	},
/obj/effect/turf_decal/bot{
	dir = 4
	},
/turf/open/floor/plasteel,
/area/shuttle/escape)
"aK" = (
/obj/structure/chair/comfy/shuttle{
	dir = 8
	},
/obj/effect/turf_decal/bot{
	dir = 4
	},
/obj/machinery/light/small{
	dir = 4
	},
/turf/open/floor/plasteel,
/area/shuttle/escape)
"aL" = (
/obj/structure/extinguisher_cabinet{
	dir = 1
	},
/turf/closed/wall/mineral/titanium/nodiagonal,
/area/shuttle/escape)
"aM" = (
/obj/machinery/vending/wallmed{
	name = "Emergency NanoMed";
	use_power = 0;
	dir = 1
	},
/turf/closed/wall/mineral/titanium/nodiagonal,
/area/shuttle/escape)
"aN" = (
/obj/structure/chair/comfy/shuttle{
	dir = 4
	},
/obj/effect/turf_decal/bot{
	dir = 4
	},
/obj/machinery/light/small{
	dir = 8
	},
/turf/open/floor/plasteel,
/area/shuttle/escape)
"aO" = (
/obj/structure/flora/ausbushes/grassybush{
	dir = 1
	},
/obj/structure/flora/ausbushes/lavendergrass{
	dir = 1
	},
/obj/structure/flora/ausbushes/brflowers{
	dir = 1
	},
/obj/structure/flora/ausbushes/grassybush{
	dir = 1
	},
/obj/structure/flora/ausbushes/pointybush{
	dir = 1
	},
/turf/open/floor/grass,
/area/shuttle/escape)
"aQ" = (
/obj/effect/turf_decal/tile/neutral{
	dir = 4
	},
/obj/effect/turf_decal/tile/neutral{
	dir = 1
	},
/turf/open/floor/plasteel,
/area/shuttle/escape)
"aR" = (
/obj/machinery/light{
	dir = 1
	},
/obj/effect/turf_decal/tile/neutral{
	dir = 4
	},
/obj/effect/turf_decal/tile/neutral{
	dir = 1
	},
/turf/open/floor/plasteel,
/area/shuttle/escape)
"aS" = (
/obj/item/kirbyplants{
	icon_state = "plant-21";
	pixel_x = -3;
	pixel_y = -3;
	dir = 1
	},
/obj/structure/extinguisher_cabinet{
	pixel_x = 24;
	dir = 1
	},
/obj/effect/turf_decal/delivery{
	dir = 4
	},
/turf/open/floor/plasteel,
/area/shuttle/escape)
"aU" = (
/obj/machinery/status_display/evac{
	dir = 1
	},
/turf/closed/wall/mineral/titanium/nodiagonal,
/area/shuttle/escape)
"aW" = (
/obj/effect/turf_decal/stripes/line{
	dir = 8
	},
/turf/open/floor/plasteel,
/area/shuttle/escape)
"aX" = (
/obj/effect/turf_decal/stripes/line{
	dir = 4
	},
/turf/open/floor/plasteel,
/area/shuttle/escape)
"aY" = (
/obj/structure/closet/crate/medical{
	name = "medical crate";
	dir = 1
	},
/obj/item/storage/firstaid/regular{
	dir = 1
	},
/obj/item/storage/firstaid/o2{
	pixel_x = 3;
	pixel_y = -3;
	dir = 1
	},
/obj/item/storage/firstaid/toxin{
	pixel_x = -4;
	pixel_y = -3;
	dir = 1
	},
/obj/item/healthanalyzer{
	pixel_x = 3;
	pixel_y = -3;
	dir = 1
	},
/obj/item/lazarus_injector{
	dir = 1
	},
/obj/effect/decal/cleanable/dirt{
	dir = 4
	},
/obj/effect/turf_decal/bot{
	dir = 4
	},
/mob/living/simple_animal/bot/medbot{
	name = "\improper emergency medibot";
	pixel_x = -3;
	pixel_y = -2
	},
/turf/open/floor/plasteel,
/area/shuttle/escape)
"aZ" = (
/turf/closed/wall/mineral/titanium/nodiagonal,
/area/shuttle/escape)
"ba" = (
/obj/machinery/vending/wallmed{
	name = "Emergency NanoMed";
	pixel_x = -26;
	use_power = 0;
	dir = 1
	},
/obj/effect/turf_decal/tile/blue{
	dir = 2
	},
/obj/effect/turf_decal/tile/blue{
	dir = 1
	},
/obj/machinery/stasis{
	dir = 1
	},
/turf/open/floor/plasteel/white,
/area/shuttle/escape)
"bb" = (
/obj/effect/turf_decal/tile/blue{
	dir = 2
	},
/obj/effect/turf_decal/tile/blue{
	dir = 1
	},
/turf/open/floor/plasteel/white,
/area/shuttle/escape)
"bc" = (
/obj/item/radio/intercom{
	name = "Station Intercom";
	pixel_x = 26;
	dir = 1
	},
/obj/effect/turf_decal/tile/blue{
	dir = 2
	},
/obj/effect/turf_decal/tile/blue{
	dir = 1
	},
/obj/machinery/stasis{
	dir = 1
	},
/turf/open/floor/plasteel/white,
/area/shuttle/escape)
"bd" = (
/obj/machinery/recharge_station{
	dir = 1
	},
/obj/machinery/status_display/evac{
	pixel_x = -32;
	dir = 1
	},
/obj/effect/decal/cleanable/dirt{
	dir = 4
	},
/obj/effect/turf_decal/delivery{
	dir = 4
	},
/obj/machinery/light{
	dir = 8
	},
/turf/open/floor/plasteel,
/area/shuttle/escape)
"be" = (
/obj/effect/turf_decal/stripes/line{
	dir = 9
	},
/turf/open/floor/plasteel,
/area/shuttle/escape)
"bf" = (
/obj/effect/decal/cleanable/dirt{
	dir = 4
	},
/obj/effect/turf_decal/stripes/line{
	dir = 5
	},
/turf/open/floor/plasteel,
/area/shuttle/escape)
"bg" = (
/obj/structure/closet/crate{
	name = "emergency supplies crate";
	dir = 1
	},
/obj/item/storage/toolbox/emergency{
	dir = 1
	},
/obj/item/storage/toolbox/emergency{
	dir = 1
	},
/obj/item/flashlight/flare{
	pixel_x = 3;
	pixel_y = -3;
	dir = 1
	},
/obj/item/flashlight/flare{
	pixel_x = -6;
	pixel_y = 2;
	dir = 1
	},
/obj/item/crowbar{
	dir = 1
	},
/obj/item/wrench{
	dir = 1
	},
/obj/item/radio{
	dir = 1
	},
/obj/effect/decal/cleanable/dirt{
	dir = 4
	},
/obj/effect/turf_decal/bot{
	dir = 4
	},
/turf/open/floor/plasteel,
/area/shuttle/escape)
"bh" = (
/obj/machinery/shower{
	dir = 4;
	name = "emergency shower"
	},
/obj/effect/turf_decal/tile/blue{
	dir = 2
	},
/obj/effect/turf_decal/tile/blue{
	dir = 1
	},
/turf/open/floor/plasteel/white,
/area/shuttle/escape)
"bi" = (
/obj/item/storage/firstaid/toxin{
	dir = 1
	},
/obj/item/storage/firstaid/o2{
	pixel_x = 3;
	pixel_y = -3;
	dir = 1
	},
/obj/structure/table/reinforced{
	dir = 1
	},
/obj/machinery/status_display/evac{
	pixel_x = 32;
	dir = 1
	},
/obj/machinery/light{
	dir = 4
	},
/obj/effect/turf_decal/tile/blue{
	dir = 8
	},
/obj/effect/turf_decal/tile/blue{
	dir = 4
	},
/obj/effect/turf_decal/tile/blue{
	dir = 2
	},
/turf/open/floor/plasteel/white,
/area/shuttle/escape)
"bj" = (
/obj/structure/table{
	dir = 1
	},
/obj/item/clipboard{
	dir = 1
	},
/obj/item/folder/yellow{
	dir = 1
	},
/obj/item/pen{
	dir = 1
	},
/obj/item/hand_labeler_refill{
	dir = 1
	},
/obj/structure/sign/warning/nosmoking/circle{
	pixel_x = -32;
	dir = 1
	},
/obj/item/radio/intercom{
	name = "Station Intercom";
	pixel_y = 26;
	dir = 1
	},
/obj/effect/decal/cleanable/dirt{
	dir = 4
	},
/obj/effect/turf_decal/bot{
	dir = 4
	},
/turf/open/floor/plasteel,
/area/shuttle/escape)
"bk" = (
/obj/structure/reagent_dispensers/fueltank{
	dir = 1
	},
/obj/effect/decal/cleanable/dirt{
	dir = 4
	},
/obj/effect/turf_decal/bot{
	dir = 4
	},
/turf/open/floor/plasteel,
/area/shuttle/escape)
"bl" = (
/obj/structure/rack{
	dir = 1
	},
/obj/item/storage/toolbox/electrical{
	pixel_x = -3;
	pixel_y = -1;
	dir = 1
	},
/obj/item/storage/toolbox/mechanical{
	pixel_y = 1;
	dir = 1
	},
/obj/item/storage/toolbox/emergency{
	pixel_x = 3;
	pixel_y = 5;
	dir = 1
	},
/obj/effect/turf_decal/bot{
	dir = 4
	},
/turf/open/floor/plasteel,
/area/shuttle/escape)
"bm" = (
/obj/structure/table{
	dir = 1
	},
/obj/machinery/cell_charger{
	dir = 1
	},
/obj/item/stock_parts/cell/high{
	dir = 1
	},
/obj/structure/extinguisher_cabinet{
	pixel_x = 24;
	dir = 1
	},
/obj/effect/decal/cleanable/dirt{
	dir = 4
	},
/obj/effect/turf_decal/bot{
	dir = 4
	},
/turf/open/floor/plasteel,
/area/shuttle/escape)
"bn" = (
/obj/item/scalpel{
	pixel_y = -12;
	dir = 1
	},
/obj/item/circular_saw{
	dir = 1
	},
/obj/item/retractor{
	pixel_x = 4;
	dir = 1
	},
/obj/item/hemostat{
	pixel_x = -4;
	dir = 1
	},
/obj/item/clothing/gloves/color/latex{
	dir = 1
	},
/obj/item/clothing/mask/surgical{
	dir = 1
	},
/obj/structure/table/reinforced{
	dir = 1
	},
/obj/structure/extinguisher_cabinet{
	pixel_x = -24;
	dir = 1
	},
/obj/effect/turf_decal/tile/blue{
	dir = 2
	},
/obj/effect/turf_decal/tile/blue{
	dir = 1
	},
/obj/item/cautery{
	dir = 1
	},
/obj/item/surgicaldrill{
	dir = 1
	},
/turf/open/floor/plasteel/white,
/area/shuttle/escape)
"bo" = (
/obj/structure/table/optable{
	dir = 1
	},
/obj/item/surgical_drapes{
	dir = 1
	},
/obj/effect/turf_decal/tile/blue{
	dir = 2
	},
/obj/effect/turf_decal/tile/blue{
	dir = 1
	},
/turf/open/floor/plasteel/white,
/area/shuttle/escape)
"bp" = (
/obj/item/defibrillator/loaded{
	dir = 1
	},
/obj/structure/table/reinforced{
	dir = 1
	},
/obj/effect/turf_decal/tile/blue{
	dir = 2
	},
/obj/effect/turf_decal/tile/blue{
	dir = 1
	},
/turf/open/floor/plasteel/white,
/area/shuttle/escape)
"bq" = (
/obj/item/storage/firstaid/fire{
	dir = 1
	},
/obj/item/storage/firstaid/regular{
	pixel_x = 2;
	pixel_y = -3;
	dir = 1
	},
/obj/structure/table/reinforced{
	dir = 1
	},
/obj/effect/turf_decal/tile/blue{
	dir = 4
	},
/obj/effect/turf_decal/tile/blue{
	dir = 2
	},
/turf/open/floor/plasteel/white,
/area/shuttle/escape)
"br" = (
/turf/closed/wall/mineral/plastitanium,
/area/shuttle/escape)
"bs" = (
/obj/structure/window/reinforced{
	dir = 2
	},
/obj/structure/shuttle/engine/heater{
	dir = 1
	},
/obj/effect/turf_decal/stripes/line{
	dir = 1
	},
/turf/open/floor/plating/airless,
/area/shuttle/escape)
"bt" = (
/obj/structure/window/reinforced{
	dir = 2
	},
/obj/structure/shuttle/engine/heater{
	dir = 1
	},
/obj/effect/decal/cleanable/dirt{
	dir = 4
	},
/obj/effect/turf_decal/stripes/line{
	dir = 1
	},
/turf/open/floor/plating/airless,
/area/shuttle/escape)
"bu" = (
/turf/template_noop,
/area/template_noop)
"bv" = (
/obj/structure/shuttle/engine/propulsion{
	dir = 1
	},
/obj/effect/turf_decal/stripes/line{
	dir = 1
	},
/turf/open/floor/plating/airless,
/area/shuttle/escape)
"fg" = (
/obj/machinery/door/airlock/security/glass{
	name = "Holding Area";
	req_access_txt = "2";
	dir = 1
	},
/obj/machinery/door/firedoor{
	dir = 1
	},
/turf/open/floor/mineral/plastitanium/red/brig,
/area/shuttle/escape)
"sC" = (
/obj/machinery/door/airlock/command/glass{
	name = "Cockpit";
	req_access_txt = "19";
	dir = 1
	},
/obj/effect/turf_decal/stripes/line{
	dir = 1
	},
/obj/effect/turf_decal/stripes/line{
	dir = 2
	},
/obj/machinery/door/firedoor{
	dir = 1
	},
/turf/open/floor/plasteel,
/area/shuttle/escape)
"wN" = (
/obj/machinery/door/airlock/shuttle{
	name = "Emergency Shuttle Airlock";
	dir = 1
	},
/obj/effect/turf_decal/stripes/line{
	dir = 8
	},
/obj/effect/turf_decal/stripes/line{
	dir = 4
	},
/obj/structure/fans/tiny{
	dir = 1
	},
/turf/open/floor/plasteel/white,
/area/shuttle/escape)
"Dr" = (
/obj/structure/window/shuttle{
	dir = 1
	},
/obj/structure/grille{
	dir = 1
	},
/obj/machinery/door/firedoor/window{
	dir = 1
	},
/turf/open/floor/plating,
/area/shuttle/escape)
"Eg" = (
/obj/machinery/door/airlock/medical/glass{
	name = "Escape Shuttle Infirmary";
	dir = 1
	},
/obj/effect/turf_decal/stripes/line{
	dir = 1
	},
/obj/effect/turf_decal/stripes/line{
	dir = 2
	},
/obj/machinery/door/firedoor{
	dir = 1
	},
/turf/open/floor/plasteel,
/area/shuttle/escape)
"Ls" = (
/obj/machinery/door/airlock/shuttle{
	name = "Emergency Shuttle Airlock";
	req_access_txt = "2";
	dir = 1
	},
/obj/effect/turf_decal/stripes/line{
	dir = 8
	},
/obj/effect/turf_decal/stripes/line{
	dir = 4
	},
/obj/structure/fans/tiny{
	dir = 1
	},
/turf/open/floor/plasteel/white,
/area/shuttle/escape)
"Mg" = (
/obj/machinery/door/airlock/shuttle{
	name = "Emergency Shuttle Airlock";
	dir = 1
	},
/obj/docking_port/mobile/emergency{
	dheight = 0;
	dwidth = 13;
	height = 11;
	name = "Omega emergency shuttle";
	width = 19;
	dir = 4
	},
/obj/effect/turf_decal/stripes/line{
	dir = 4
	},
/obj/effect/turf_decal/stripes/line{
	dir = 8
	},
/obj/structure/fans/tiny{
	dir = 1
	},
/turf/open/floor/plasteel/white,
/area/shuttle/escape)
"Rm" = (
/obj/machinery/door/airlock/command{
	name = "Emergency Recovery Airlock";
	req_access_txt = "19";
	dir = 1
	},
/obj/effect/turf_decal/stripes/line{
	dir = 8
	},
/obj/effect/turf_decal/stripes/line{
	dir = 4
	},
/obj/machinery/door/firedoor{
	dir = 1
	},
/turf/open/floor/plasteel,
/area/shuttle/escape)
"Ui" = (
/obj/machinery/door/airlock/shuttle{
	name = "Emergency Shuttle Cargo";
	dir = 1
	},
/obj/effect/turf_decal/stripes/line{
	dir = 1
	},
/obj/effect/turf_decal/stripes/line{
	dir = 2
	},
/obj/machinery/door/firedoor{
	dir = 1
	},
/turf/open/floor/plasteel,
/area/shuttle/escape)

(1,1,1) = {"
bu
br
aZ
aa
aa
wN
ac
wN
aa
Dr
Dr
Dr
aa
Mg
ac
Ls
aa
aa
aa"}(2,1,1) = {"
bv
br
aa
bj
bd
az
ab
az
aD
aJ
aJ
aJ
aD
az
ab
al
ak
ad
aa"}(3,1,1) = {"
bv
bs
Dr
bk
be
aW
Ui
aQ
aE
aE
aE
aE
aE
aA
fg
al
al
ae
Dr"}(4,1,1) = {"
bv
bt
Dr
bl
bf
aX
Ui
aQ
aF
aF
aF
aK
aF
aA
ab
al
al
ae
Dr"}(5,1,1) = {"
bv
bt
aa
bm
bg
aY
ab
aQ
aG
aM
aI
aL
aG
aA
ab
ar
al
af
aa"}(6,1,1) = {"
br
br
aZ
aZ
ab
aZ
aU
aR
aH
aI
aO
aG
aH
aB
aw
ab
Rm
ab
ac"}(7,1,1) = {"
bv
bt
aa
bn
bh
ba
ab
aQ
aI
aL
aG
aM
aI
aA
ab
as
an
ag
aa"}(8,1,1) = {"
bv
bt
Dr
bo
bb
bb
Eg
aQ
aJ
aJ
aJ
aN
aJ
aA
sC
an
ao
ah
Dr"}(9,1,1) = {"
bv
bt
Dr
bp
bb
bb
Eg
aQ
aE
aE
aE
aE
aE
aA
ab
at
an
ai
Dr"}(10,1,1) = {"
bv
br
aa
bq
bi
bc
ab
aS
aF
aF
aF
aF
aF
aC
aa
au
ap
aj
Dr"}(11,1,1) = {"
bu
br
aZ
aa
aa
aa
ac
aa
Dr
Dr
Dr
Dr
Dr
aa
ac
aa
Dr
Dr
aa"}