//MAP CONVERTED BY dmm2tgm.py THIS HEADER COMMENT PREVENTS RECONVERSION, DO NOT REMOVE
"aa" = (
/turf/template_noop,
/area/template_noop)
"ab" = (
/turf/closed/wall/mineral/titanium,
/area/shuttle/escape)
"ad" = (
/obj/structure/table{
	dir = 1
	},
/obj/item/scalpel{
	dir = 1
	},
/obj/item/retractor{
	pixel_y = -5;
	dir = 1
	},
/obj/item/hemostat{
	dir = 1
	},
/turf/open/floor/mineral/titanium/white,
/area/shuttle/escape)
"ae" = (
/obj/structure/table{
	dir = 1
	},
/obj/item/cautery{
	dir = 1
	},
/obj/item/surgicaldrill{
	dir = 1
	},
/obj/item/circular_saw{
	pixel_y = -9;
	dir = 1
	},
/turf/open/floor/mineral/titanium/white,
/area/shuttle/escape)
"af" = (
/turf/open/floor/mineral/titanium/white,
/area/shuttle/escape)
"ag" = (
/obj/structure/shuttle/engine/propulsion/right{
	dir = 4
	},
/turf/open/floor/plating/airless,
/area/shuttle/escape)
"ah" = (
/turf/closed/wall/mineral/titanium/nodiagonal,
/area/shuttle/escape)
"ai" = (
/obj/machinery/computer/emergency_shuttle{
	dir = 4
	},
/turf/open/floor/mineral/titanium/blue,
/area/shuttle/escape)
"aj" = (
/turf/open/floor/mineral/titanium/blue,
/area/shuttle/escape)
"ak" = (
/obj/item/kirbyplants{
	icon_state = "plant-22";
	dir = 1
	},
/turf/open/floor/mineral/titanium/blue,
/area/shuttle/escape)
"al" = (
/obj/structure/chair/comfy/shuttle{
	dir = 1
	},
/turf/open/floor/mineral/plastitanium/red/brig,
/area/shuttle/escape)
"am" = (
/obj/structure/chair/comfy/shuttle{
	dir = 1
	},
/obj/machinery/light{
	dir = 2
	},
/turf/open/floor/mineral/plastitanium/red/brig,
/area/shuttle/escape)
"an" = (
/obj/structure/table/optable{
	dir = 1
	},
/obj/item/surgical_drapes{
	dir = 1
	},
/turf/open/floor/mineral/titanium/white,
/area/shuttle/escape)
"ao" = (
/obj/machinery/light{
	dir = 4
	},
/turf/open/floor/mineral/titanium/white,
/area/shuttle/escape)
"ap" = (
/obj/structure/shuttle/engine/propulsion{
	dir = 4
	},
/turf/open/floor/plating/airless,
/area/shuttle/escape)
"aq" = (
/obj/machinery/computer/communications{
	dir = 4
	},
/turf/open/floor/mineral/titanium/blue,
/area/shuttle/escape)
"ar" = (
/obj/structure/chair/comfy/shuttle{
	dir = 8
	},
/turf/open/floor/mineral/titanium,
/area/shuttle/escape)
"at" = (
/turf/open/floor/mineral/plastitanium/red/brig,
/area/shuttle/escape)
"au" = (
/obj/structure/shuttle/engine/propulsion/left{
	dir = 4
	},
/turf/open/floor/plating/airless,
/area/shuttle/escape)
"av" = (
/obj/machinery/light{
	dir = 1
	},
/turf/open/floor/mineral/titanium,
/area/shuttle/escape)
"aw" = (
/obj/machinery/vending/wallmed{
	name = "Emergency NanoMed";
	use_power = 0;
	dir = 1
	},
/turf/closed/wall/mineral/titanium/nodiagonal,
/area/shuttle/escape)
"ax" = (
/obj/structure/table{
	dir = 1
	},
/obj/machinery/recharger{
	active_power_usage = 0;
	idle_power_usage = 0;
	pixel_y = -4;
	use_power = 0;
	dir = 1
	},
/turf/open/floor/mineral/plastitanium/red/brig,
/area/shuttle/escape)
"ay" = (
/obj/structure/table{
	dir = 1
	},
/obj/item/storage/box/handcuffs{
	dir = 1
	},
/turf/open/floor/mineral/plastitanium/red/brig,
/area/shuttle/escape)
"aB" = (
/obj/item/kirbyplants{
	icon_state = "plant-21";
	dir = 1
	},
/turf/open/floor/mineral/titanium,
/area/shuttle/escape)
"aC" = (
/turf/open/floor/mineral/titanium,
/area/shuttle/escape)
"aD" = (
/turf/open/floor/mineral/plastitanium,
/area/shuttle/escape)
"aE" = (
/obj/structure/chair/comfy/shuttle{
	dir = 4
	},
/turf/open/floor/mineral/plastitanium,
/area/shuttle/escape)
"aF" = (
/obj/structure/table{
	dir = 1
	},
/obj/machinery/light{
	dir = 2
	},
/turf/open/floor/mineral/plastitanium,
/area/shuttle/escape)
"aH" = (
/obj/structure/chair/comfy/shuttle{
	dir = 8
	},
/turf/open/floor/mineral/plastitanium,
/area/shuttle/escape)
"aI" = (
/obj/structure/table{
	dir = 1
	},
/obj/item/reagent_containers/food/snacks/spaghetti/boiledspaghetti{
	name = "pasghetti";
	pixel_x = 4;
	pixel_y = -7;
	dir = 1
	},
/turf/open/floor/mineral/plastitanium,
/area/shuttle/escape)
"aJ" = (
/obj/machinery/light/small{
	dir = 1
	},
/turf/open/floor/mineral/titanium,
/area/shuttle/escape)
"aL" = (
/obj/structure/table{
	dir = 1
	},
/turf/open/floor/mineral/plastitanium,
/area/shuttle/escape)
"aM" = (
/obj/structure/table{
	dir = 1
	},
/obj/item/reagent_containers/food/snacks/chocolatebar{
	dir = 1
	},
/turf/open/floor/mineral/plastitanium,
/area/shuttle/escape)
"aN" = (
/obj/structure/chair/comfy/shuttle{
	dir = 2
	},
/obj/structure/window/reinforced{
	dir = 1
	},
/turf/open/floor/mineral/plastitanium,
/area/shuttle/escape)
"aO" = (
/obj/structure/chair/comfy/shuttle{
	dir = 2
	},
/obj/structure/window/reinforced{
	dir = 1
	},
/obj/machinery/light{
	dir = 4
	},
/turf/open/floor/mineral/plastitanium,
/area/shuttle/escape)
"aP" = (
/obj/structure/chair/comfy/shuttle{
	dir = 1
	},
/obj/structure/window/reinforced{
	dir = 2;
	pixel_y = -2
	},
/turf/open/floor/mineral/plastitanium,
/area/shuttle/escape)
"aQ" = (
/obj/structure/extinguisher_cabinet{
	pixel_x = -27;
	dir = 1
	},
/turf/open/floor/mineral/titanium/white,
/area/shuttle/escape)
"aR" = (
/obj/structure/table/glass{
	dir = 1
	},
/obj/item/storage/firstaid/fire{
	pixel_x = 5;
	pixel_y = -5;
	dir = 1
	},
/obj/item/storage/firstaid/toxin{
	dir = 1
	},
/turf/open/floor/mineral/titanium/white,
/area/shuttle/escape)
"aS" = (
/obj/structure/chair/comfy/shuttle{
	dir = 2
	},
/turf/open/floor/mineral/plastitanium,
/area/shuttle/escape)
"aT" = (
/obj/structure/chair/comfy/shuttle{
	dir = 2
	},
/obj/machinery/light{
	dir = 1
	},
/turf/open/floor/mineral/plastitanium,
/area/shuttle/escape)
"aU" = (
/obj/structure/table/glass{
	dir = 1
	},
/obj/item/storage/firstaid/brute{
	pixel_x = 5;
	pixel_y = -5;
	dir = 1
	},
/obj/item/storage/firstaid/brute{
	dir = 1
	},
/obj/machinery/light{
	dir = 4
	},
/turf/open/floor/mineral/titanium/white,
/area/shuttle/escape)
"aV" = (
/obj/structure/extinguisher_cabinet{
	pixel_y = 32;
	dir = 1
	},
/turf/open/floor/mineral/titanium,
/area/shuttle/escape)
"aW" = (
/obj/structure/chair/comfy/shuttle{
	dir = 1
	},
/turf/open/floor/mineral/plastitanium,
/area/shuttle/escape)
"aX" = (
/obj/machinery/stasis{
	dir = 1
	},
/turf/open/floor/mineral/titanium/white,
/area/shuttle/escape)
"aY" = (
/obj/structure/table/glass{
	dir = 1
	},
/obj/item/defibrillator/loaded{
	dir = 1
	},
/turf/open/floor/mineral/titanium/white,
/area/shuttle/escape)
"xJ" = (
/obj/machinery/door/airlock/command/glass{
	name = "bridge door";
	req_access_txt = "19";
	dir = 1
	},
/obj/machinery/door/firedoor{
	dir = 1
	},
/turf/open/floor/mineral/titanium,
/area/shuttle/escape)
"Hy" = (
/obj/machinery/door/airlock/public/glass{
	dir = 1
	},
/obj/machinery/door/firedoor{
	dir = 1
	},
/turf/open/floor/mineral/titanium/white,
/area/shuttle/escape)
"Mg" = (
/obj/machinery/door/airlock/titanium{
	dir = 1
	},
/obj/docking_port/mobile/emergency{
	dheight = 0;
	dir = 8;
	dwidth = 7;
	height = 18;
	name = "Birdboat emergency escape shuttle";
	port_direction = 4;
	width = 14
	},
/obj/machinery/door/firedoor{
	dir = 1
	},
/turf/open/floor/mineral/titanium,
/area/shuttle/escape)
"MN" = (
/obj/effect/spawner/structure/window/shuttle{
	dir = 1
	},
/turf/open/floor/plating,
/area/shuttle/escape)
"Ti" = (
/obj/machinery/door/airlock/titanium{
	dir = 1
	},
/obj/machinery/door/firedoor{
	dir = 1
	},
/turf/open/floor/mineral/titanium,
/area/shuttle/escape)
"Wn" = (
/obj/machinery/door/airlock/security/glass{
	name = "security airlock";
	req_access_txt = "63";
	dir = 1
	},
/obj/machinery/door/firedoor{
	dir = 1
	},
/turf/open/floor/mineral/plastitanium/red/brig,
/area/shuttle/escape)

(1,1,1) = {"
aa
aa
ab
MN
MN
MN
MN
MN
ab
MN
ab
ab
aa
aa"}(2,1,1) = {"
aa
ab
ah
aB
aH
aH
aH
aB
MN
ak
aq
ah
ab
aa"}(3,1,1) = {"
aa
ab
aS
aC
aC
aC
aC
aC
xJ
aC
ar
ai
ab
aa"}(4,1,1) = {"
aa
ab
aS
aC
aC
aL
aD
aD
ab
av
aC
aj
MN
aa"}(5,1,1) = {"
aa
ab
aS
aC
aC
aM
aE
aE
ab
aV
aC
aj
MN
aa"}(6,1,1) = {"
ab
ah
aT
aC
aC
aL
aI
aF
ab
ak
aC
ak
ab
aa"}(7,1,1) = {"
ab
aB
aC
aC
aC
aC
aC
aC
ab
MN
xJ
ab
ab
aa"}(8,1,1) = {"
ab
aV
aC
aC
aC
aC
aC
aB
MN
at
at
al
ab
aa"}(9,1,1) = {"
MN
aW
aC
aC
aP
aN
aC
aC
Wn
at
at
al
ab
aa"}(10,1,1) = {"
MN
aW
aC
aC
aP
aN
aC
aC
MN
at
at
am
ab
aa"}(11,1,1) = {"
MN
aW
aC
aC
aP
aN
aC
aC
ab
ax
at
al
ab
aa"}(12,1,1) = {"
ab
aB
aC
aC
aP
aO
aC
aC
ab
ay
at
al
ab
aa"}(13,1,1) = {"
ab
ab
MN
Hy
ab
aw
aC
aC
ah
ab
ab
ab
ab
ab"}(14,1,1) = {"
ab
aX
af
af
aQ
Hy
aC
aC
Hy
af
af
an
ad
ab"}(15,1,1) = {"
ab
af
af
af
af
Hy
aC
aC
Hy
af
af
af
ae
ab"}(16,1,1) = {"
ab
aY
aU
aR
ab
ab
Ti
Ti
ab
ab
af
ao
af
ab"}(17,1,1) = {"
ab
ab
ab
ab
ab
ab
aJ
aC
ab
ab
ab
ab
ab
ab"}(18,1,1) = {"
ab
au
ap
ag
ab
ab
Mg
Ti
ab
ab
au
ap
ag
ab"}