//MAP CONVERTED BY dmm2tgm.py THIS HEADER COMMENT PREVENTS RECONVERSION, DO NOT REMOVE
"a" = (
/obj/structure/shuttle/engine/propulsion{
	dir = 8;
	icon_state = "propulsion"
	},
/turf/closed/wall/mineral/titanium,
/area/shuttle/escape)
"b" = (
/turf/closed/wall/mineral/titanium,
/area/shuttle/escape)
"c" = (
/obj/structure/grille{
	dir = 1
	},
/obj/structure/window/shuttle{
	dir = 1
	},
/turf/open/floor/plating,
/area/shuttle/escape)
"d" = (
/turf/open/space/basic,
/area/space)
"f" = (
/obj/structure/chair/comfy/shuttle{
	dir = 1
	},
/turf/open/floor/mineral/titanium/blue,
/area/shuttle/escape)
"g" = (
/turf/open/floor/mineral/titanium/blue,
/area/shuttle/escape)
"i" = (
/obj/machinery/light{
	dir = 8;
	icon_state = "tube"
	},
/turf/open/floor/mineral/titanium/blue,
/area/shuttle/escape)
"j" = (
/obj/structure/chair/comfy/shuttle{
	dir = 2
	},
/turf/open/floor/mineral/titanium/blue,
/area/shuttle/escape)
"k" = (
/obj/machinery/computer/emergency_shuttle{
	dir = 8
	},
/obj/machinery/light/small{
	dir = 4;
	icon_state = "bulb"
	},
/turf/open/floor/mineral/titanium/blue,
/area/shuttle/escape)
"K" = (
/obj/machinery/door/airlock/titanium{
	name = "Shuttle Airlock";
	dir = 1
	},
/obj/structure/fans/tiny{
	dir = 1
	},
/turf/open/floor/mineral/titanium/blue,
/area/shuttle/escape)
"T" = (
/obj/machinery/door/airlock/titanium{
	name = "Shuttle Airlock";
	dir = 1
	},
/obj/docking_port/mobile/emergency{
	port_direction = 2;
	preferred_direction = 4;
	dir = 4
	},
/obj/structure/fans/tiny{
	dir = 1
	},
/turf/open/floor/mineral/titanium/blue,
/area/shuttle/escape)

(1,1,1) = {"
a
K
b
K
a
d
d
d
a
T
b
K
a"}(2,1,1) = {"
b
j
i
f
b
d
d
d
b
j
i
f
b"}(3,1,1) = {"
c
j
g
f
c
d
d
d
c
j
g
f
c"}(4,1,1) = {"
b
j
g
f
b
d
d
d
b
j
g
f
b"}(5,1,1) = {"
b
b
k
b
b
d
d
d
b
b
k
b
b"}(6,1,1) = {"
d
b
c
b
d
d
d
d
d
b
c
b
d"}