//MAP CONVERTED BY dmm2tgm.py THIS HEADER COMMENT PREVENTS RECONVERSION, DO NOT REMOVE
"aa" = (
/turf/template_noop,
/area/template_noop)
"ab" = (
/turf/closed/indestructible/riveted/uranium,
/area/shuttle/escape/luxury)
"ac" = (
/obj/machinery/door/airlock/external{
	dir = 1
	},
/obj/structure/fans/tiny{
	dir = 1
	},
/turf/open/floor/wood{
	icon_state = "wood-broken2"
	},
/area/shuttle/escape/luxury)
"ad" = (
/obj/machinery/door/airlock/gold{
	dir = 1
	},
/obj/effect/forcefield/luxury_shuttle{
	name = "Ticket Booth";
	dir = 1
	},
/turf/open/floor/mineral/gold,
/area/shuttle/escape/luxury)
"ae" = (
/obj/docking_port/mobile/emergency{
	dir = 1;
	dwidth = 19;
	height = 14;
	name = "Luxury emergency shuttle";
	width = 25
	},
/obj/machinery/door/airlock/gold{
	dir = 1
	},
/obj/effect/forcefield/luxury_shuttle{
	name = "Ticket Booth";
	dir = 1
	},
/turf/open/floor/mineral/gold,
/area/shuttle/escape/luxury)
"af" = (
/turf/open/floor/wood{
	icon_state = "wood-broken3"
	},
/area/shuttle/escape/luxury)
"ag" = (
/turf/open/floor/wood,
/area/shuttle/escape/luxury)
"ah" = (
/turf/open/floor/wood{
	icon_state = "wood-broken"
	},
/area/shuttle/escape/luxury)
"ai" = (
/turf/open/floor/wood{
	icon_state = "wood-broken5"
	},
/area/shuttle/escape/luxury)
"aj" = (
/turf/open/floor/mineral/gold,
/area/shuttle/escape/luxury)
"ak" = (
/obj/item/kirbyplants{
	icon_state = "plant-10";
	dir = 1
	},
/turf/open/floor/mineral/gold,
/area/shuttle/escape/luxury)
"al" = (
/obj/structure/mirror{
	pixel_y = -32;
	dir = 1
	},
/turf/open/floor/mineral/gold,
/area/shuttle/escape/luxury)
"am" = (
/turf/open/floor/wood{
	icon_state = "wood-broken7"
	},
/area/shuttle/escape/luxury)
"an" = (
/obj/machinery/light/small{
	dir = 1
	},
/turf/open/floor/wood{
	icon_state = "wood-broken2"
	},
/area/shuttle/escape/luxury)
"ao" = (
/obj/machinery/light/small{
	dir = 1
	},
/turf/open/floor/wood{
	icon_state = "wood-broken6"
	},
/area/shuttle/escape/luxury)
"ap" = (
/obj/structure/toilet{
	dir = 4
	},
/turf/open/floor/mineral/gold,
/area/shuttle/escape/luxury)
"aq" = (
/obj/machinery/door/airlock/gold{
	dir = 1
	},
/turf/open/floor/mineral/gold,
/area/shuttle/escape/luxury)
"ar" = (
/obj/structure/shuttle/engine/propulsion{
	dir = 8
	},
/turf/open/floor/plating/airless,
/area/shuttle/escape/luxury)
"as" = (
/obj/structure/shuttle/engine/heater{
	dir = 8
	},
/obj/structure/window/reinforced{
	dir = 4
	},
/turf/open/floor/plating/airless,
/area/shuttle/escape/luxury)
"at" = (
/turf/open/floor/carpet,
/area/shuttle/escape/luxury)
"au" = (
/obj/structure/chair/comfy{
	dir = 1
	},
/turf/open/floor/carpet,
/area/shuttle/escape/luxury)
"av" = (
/obj/structure/chair/comfy{
	dir = 4
	},
/turf/open/floor/mineral/gold,
/area/shuttle/escape/luxury)
"aw" = (
/obj/machinery/computer/communications{
	dir = 8
	},
/turf/open/floor/mineral/gold,
/area/shuttle/escape/luxury)
"ax" = (
/obj/structure/table/wood/fancy{
	dir = 1
	},
/obj/item/reagent_containers/food/snacks/spaghetti/meatballspaghetti{
	dir = 1
	},
/turf/open/floor/carpet,
/area/shuttle/escape/luxury)
"ay" = (
/obj/structure/table/wood/fancy{
	dir = 1
	},
/obj/item/reagent_containers/food/snacks/notasandwich{
	dir = 1
	},
/turf/open/floor/carpet,
/area/shuttle/escape/luxury)
"az" = (
/obj/structure/table/wood/fancy{
	dir = 1
	},
/obj/item/reagent_containers/food/snacks/spaghetti/pastatomato{
	dir = 1
	},
/turf/open/floor/carpet,
/area/shuttle/escape/luxury)
"aA" = (
/obj/structure/table/wood/fancy{
	dir = 1
	},
/obj/item/reagent_containers/food/snacks/kebab/tofu{
	dir = 1
	},
/turf/open/floor/carpet,
/area/shuttle/escape/luxury)
"aB" = (
/obj/structure/table/wood/fancy{
	dir = 1
	},
/obj/item/reagent_containers/food/snacks/honkdae{
	dir = 1
	},
/turf/open/floor/carpet,
/area/shuttle/escape/luxury)
"aC" = (
/obj/structure/table/wood/fancy{
	dir = 1
	},
/obj/item/reagent_containers/food/snacks/enchiladas{
	dir = 1
	},
/turf/open/floor/carpet,
/area/shuttle/escape/luxury)
"aD" = (
/obj/structure/table/wood/fancy{
	dir = 1
	},
/obj/item/reagent_containers/food/snacks/candiedapple{
	dir = 1
	},
/turf/open/floor/carpet,
/area/shuttle/escape/luxury)
"aE" = (
/obj/structure/table/wood/fancy{
	dir = 1
	},
/obj/item/reagent_containers/food/snacks/burger/baconburger{
	dir = 1
	},
/turf/open/floor/carpet,
/area/shuttle/escape/luxury)
"aF" = (
/obj/structure/table/wood/fancy{
	dir = 1
	},
/obj/item/reagent_containers/food/snacks/benedict{
	dir = 1
	},
/turf/open/floor/carpet,
/area/shuttle/escape/luxury)
"aG" = (
/obj/structure/table/wood/fancy{
	dir = 1
	},
/obj/item/reagent_containers/food/snacks/cakeslice/chocolate{
	dir = 1
	},
/turf/open/floor/carpet,
/area/shuttle/escape/luxury)
"aH" = (
/obj/structure/table/wood/fancy{
	dir = 1
	},
/obj/item/reagent_containers/food/snacks/spaghetti/chowmein{
	dir = 1
	},
/turf/open/floor/carpet,
/area/shuttle/escape/luxury)
"aI" = (
/obj/structure/table/wood/fancy{
	dir = 1
	},
/obj/item/reagent_containers/food/snacks/dulcedebatataslice{
	dir = 1
	},
/turf/open/floor/carpet,
/area/shuttle/escape/luxury)
"aJ" = (
/obj/structure/table/wood/fancy{
	dir = 1
	},
/obj/item/reagent_containers/food/snacks/salad/validsalad{
	dir = 1
	},
/turf/open/floor/carpet,
/area/shuttle/escape/luxury)
"aK" = (
/obj/structure/table/wood/fancy{
	dir = 1
	},
/obj/item/reagent_containers/food/snacks/carneburrito{
	dir = 1
	},
/turf/open/floor/carpet,
/area/shuttle/escape/luxury)
"aL" = (
/obj/structure/table/wood/fancy{
	dir = 1
	},
/obj/item/reagent_containers/food/snacks/chawanmushi{
	dir = 1
	},
/turf/open/floor/carpet,
/area/shuttle/escape/luxury)
"aM" = (
/obj/machinery/computer/emergency_shuttle{
	dir = 8
	},
/turf/open/floor/mineral/gold,
/area/shuttle/escape/luxury)
"aN" = (
/obj/structure/table/wood/fancy{
	dir = 1
	},
/obj/item/reagent_containers/food/snacks/melonfruitbowl{
	dir = 1
	},
/turf/open/floor/carpet,
/area/shuttle/escape/luxury)
"aO" = (
/obj/structure/table/wood/fancy{
	dir = 1
	},
/obj/item/reagent_containers/food/snacks/khachapuri{
	dir = 1
	},
/turf/open/floor/carpet,
/area/shuttle/escape/luxury)
"aP" = (
/obj/structure/table/wood/fancy{
	dir = 1
	},
/obj/item/reagent_containers/food/snacks/grilledcheese{
	dir = 1
	},
/turf/open/floor/carpet,
/area/shuttle/escape/luxury)
"aQ" = (
/obj/structure/table/wood/fancy{
	dir = 1
	},
/obj/item/reagent_containers/food/snacks/jelliedtoast/cherry{
	dir = 1
	},
/turf/open/floor/carpet,
/area/shuttle/escape/luxury)
"aR" = (
/obj/structure/table/wood/fancy{
	dir = 1
	},
/obj/item/reagent_containers/food/snacks/honeybun{
	dir = 1
	},
/turf/open/floor/carpet,
/area/shuttle/escape/luxury)
"aS" = (
/obj/structure/table/wood/fancy{
	dir = 1
	},
/obj/item/reagent_containers/food/snacks/eggplantparm{
	dir = 1
	},
/turf/open/floor/carpet,
/area/shuttle/escape/luxury)
"aT" = (
/obj/structure/table/wood/fancy{
	dir = 1
	},
/obj/item/reagent_containers/food/snacks/spaghetti/copypasta{
	dir = 1
	},
/turf/open/floor/carpet,
/area/shuttle/escape/luxury)
"aU" = (
/obj/structure/table/wood/fancy{
	dir = 1
	},
/obj/item/reagent_containers/food/snacks/bearsteak{
	dir = 1
	},
/turf/open/floor/carpet,
/area/shuttle/escape/luxury)
"aV" = (
/obj/structure/table/wood/fancy{
	dir = 1
	},
/obj/item/reagent_containers/food/snacks/spaghetti/boiledspaghetti{
	dir = 1
	},
/turf/open/floor/carpet,
/area/shuttle/escape/luxury)
"aW" = (
/obj/structure/table/wood/fancy{
	dir = 1
	},
/obj/item/reagent_containers/food/snacks/cherrycupcake{
	dir = 1
	},
/turf/open/floor/carpet,
/area/shuttle/escape/luxury)
"aX" = (
/obj/structure/table/wood/fancy{
	dir = 1
	},
/obj/item/reagent_containers/food/snacks/customizable/pizza{
	dir = 1
	},
/turf/open/floor/carpet,
/area/shuttle/escape/luxury)
"aY" = (
/obj/structure/table/wood/fancy{
	dir = 1
	},
/obj/item/reagent_containers/food/snacks/hotdog{
	dir = 1
	},
/turf/open/floor/carpet,
/area/shuttle/escape/luxury)
"aZ" = (
/obj/structure/table/wood/fancy{
	dir = 1
	},
/obj/item/reagent_containers/food/snacks/pie/grapetart{
	dir = 1
	},
/turf/open/floor/carpet,
/area/shuttle/escape/luxury)
"ba" = (
/obj/structure/table/wood/fancy{
	dir = 1
	},
/obj/item/reagent_containers/food/snacks/burger/superbite{
	dir = 1
	},
/turf/open/floor/carpet,
/area/shuttle/escape/luxury)
"bb" = (
/obj/structure/table/wood/fancy{
	dir = 1
	},
/obj/item/reagent_containers/food/snacks/cakeslice/slimecake{
	dir = 1
	},
/turf/open/floor/carpet,
/area/shuttle/escape/luxury)
"bc" = (
/obj/machinery/computer/station_alert{
	dir = 4
	},
/turf/open/floor/mineral/gold,
/area/shuttle/escape/luxury)
"bd" = (
/obj/structure/chair/comfy{
	dir = 2
	},
/turf/open/floor/carpet,
/area/shuttle/escape/luxury)
"be" = (
/obj/machinery/computer/crew{
	dir = 8
	},
/turf/open/floor/mineral/gold,
/area/shuttle/escape/luxury)
"bf" = (
/obj/machinery/stasis{
	dir = 1
	},
/turf/open/floor/mineral/gold,
/area/shuttle/escape/luxury)
"bi" = (
/obj/machinery/light{
	dir = 1
	},
/turf/open/floor/mineral/gold,
/area/shuttle/escape/luxury)
"bj" = (
/obj/machinery/light{
	dir = 8
	},
/turf/open/floor/mineral/gold,
/area/shuttle/escape/luxury)
"bk" = (
/obj/machinery/light{
	dir = 4
	},
/turf/open/floor/mineral/gold,
/area/shuttle/escape/luxury)
"bl" = (
/obj/item/kirbyplants{
	icon_state = "plant-10";
	dir = 1
	},
/obj/machinery/light{
	dir = 8
	},
/turf/open/floor/mineral/gold,
/area/shuttle/escape/luxury)
"cu" = (
/obj/item/kirbyplants{
	icon_state = "plant-21";
	pixel_x = -3;
	pixel_y = -3;
	dir = 1
	},
/obj/effect/turf_decal/pool{
	dir = 2
	},
/turf/open/floor/mineral/gold,
/area/shuttle/escape/luxury)
"hA" = (
/obj/structure/table/optable{
	dir = 1
	},
/obj/item/surgical_drapes{
	dir = 1
	},
/turf/open/floor/mineral/gold,
/area/shuttle/escape/luxury)
"nZ" = (
/obj/item/pool/pool_noodle{
	dir = 1
	},
/turf/open/indestructible/sound/pool,
/area/shuttle/escape/luxury)
"vB" = (
/obj/item/kirbyplants{
	icon_state = "plant-21";
	pixel_x = -3;
	pixel_y = -3;
	dir = 1
	},
/obj/machinery/light{
	dir = 1
	},
/obj/effect/turf_decal/pool{
	dir = 1
	},
/turf/open/floor/mineral/gold,
/area/shuttle/escape/luxury)
"wf" = (
/obj/item/kirbyplants{
	icon_state = "plant-21";
	pixel_x = -3;
	pixel_y = -3;
	dir = 1
	},
/obj/machinery/light{
	dir = 1
	},
/obj/effect/turf_decal/pool{
	dir = 2
	},
/turf/open/floor/mineral/gold,
/area/shuttle/escape/luxury)
"zg" = (
/obj/machinery/vending/wallmed{
	dir = 1
	},
/turf/closed/indestructible/riveted/uranium,
/area/shuttle/escape/luxury)
"CU" = (
/obj/effect/turf_decal/pool/corner{
	dir = 4
	},
/turf/open/floor/mineral/gold,
/area/shuttle/escape/luxury)
"Jr" = (
/obj/effect/turf_decal/pool{
	dir = 4
	},
/turf/open/floor/mineral/gold,
/area/shuttle/escape/luxury)
"OL" = (
/obj/item/surgicaldrill{
	dir = 1
	},
/obj/item/scalpel{
	dir = 1
	},
/obj/item/retractor{
	dir = 1
	},
/obj/item/cautery{
	dir = 1
	},
/obj/item/hemostat{
	dir = 1
	},
/obj/item/circular_saw{
	dir = 1
	},
/obj/structure/table/wood/fancy{
	dir = 1
	},
/turf/open/floor/mineral/gold,
/area/shuttle/escape/luxury)
"Ui" = (
/obj/item/pool/rubber_ring{
	dir = 1
	},
/turf/open/indestructible/sound/pool,
/area/shuttle/escape/luxury)
"Vf" = (
/turf/open/indestructible/sound/pool,
/area/shuttle/escape/luxury)
"Vm" = (
/obj/effect/turf_decal/pool/corner{
	dir = 2
	},
/turf/open/floor/mineral/gold,
/area/shuttle/escape/luxury)
"Vq" = (
/obj/item/kirbyplants{
	icon_state = "plant-21";
	pixel_x = -3;
	pixel_y = -3;
	dir = 1
	},
/obj/effect/turf_decal/pool{
	dir = 1
	},
/turf/open/floor/mineral/gold,
/area/shuttle/escape/luxury)

(1,1,1) = {"
aa
ab
ab
ab
ab
ar
ar
ar
ar
ab
ab
ab
ab
aa"}(2,1,1) = {"
ab
ab
hA
bf
ab
as
as
as
as
ab
ab
am
ab
ab"}(3,1,1) = {"
ab
zg
aj
aj
zg
ab
ab
ab
ab
ab
ab
ag
af
ab"}(4,1,1) = {"
ab
OL
aj
aj
bj
aj
aj
aj
aj
bl
ab
an
ag
ab"}(5,1,1) = {"
ab
aj
aj
aj
aj
at
at
at
at
aj
ab
ag
ag
ab"}(6,1,1) = {"
ab
wf
cu
CU
aj
bd
aN
ax
au
aj
ab
ag
ag
ab"}(7,1,1) = {"
ab
Vf
Vf
Jr
aj
bd
aO
ay
au
aj
ab
ag
ah
ab"}(8,1,1) = {"
ab
Vf
nZ
Jr
aj
bd
aP
az
au
aj
ab
ag
ag
ab"}(9,1,1) = {"
ab
Vf
Vf
Jr
aj
bd
aQ
aA
au
aj
ab
ag
ag
ab"}(10,1,1) = {"
ab
Ui
Vf
Jr
aj
bd
aR
aB
au
aj
ab
ao
ai
ab"}(11,1,1) = {"
ab
Vf
Vf
Jr
aj
bd
aS
aC
au
aj
ab
ag
ag
ab"}(12,1,1) = {"
ab
Vf
Vf
Jr
aj
bd
aT
aD
au
aj
ab
af
ag
ac"}(13,1,1) = {"
ab
Vf
Vf
Jr
aj
bd
aU
aE
au
aj
ab
ab
ab
ab"}(14,1,1) = {"
ab
Vf
nZ
Jr
aj
bd
aV
aF
au
aj
bj
aj
aj
ad"}(15,1,1) = {"
ab
Vf
Vf
Jr
aj
bd
aW
aG
au
aj
aj
aj
aj
ab"}(16,1,1) = {"
ab
Vf
Vf
Jr
aj
bd
aX
aH
au
aj
aj
aj
aj
ab"}(17,1,1) = {"
ab
Vf
Vf
Jr
aj
bd
aY
aI
au
aj
aj
aj
aj
ab"}(18,1,1) = {"
ab
Vf
Ui
Jr
aj
bd
aZ
aJ
au
aj
aj
aj
aj
ab"}(19,1,1) = {"
ab
Vf
Vf
Jr
aj
bd
ba
aK
au
aj
aj
aj
aj
ab"}(20,1,1) = {"
ab
vB
Vq
Vm
aj
bd
bb
aL
au
aj
bk
aj
aj
ae"}(21,1,1) = {"
ab
aj
aj
aj
aj
at
at
at
at
aj
ab
ab
ab
ab"}(22,1,1) = {"
ab
aj
aj
aj
aj
aj
aj
aj
aj
aj
ab
ap
ak
ab"}(23,1,1) = {"
ab
aj
aj
aj
aj
av
av
av
av
aj
ab
bi
aj
ab"}(24,1,1) = {"
ab
ak
aj
aj
bk
be
bc
aM
aw
bk
aq
aj
al
ab"}(25,1,1) = {"
ab
ab
ab
ab
ab
ab
ab
ab
ab
ab
ab
ab
ab
ab"}