//MAP CONVERTED BY dmm2tgm.py THIS HEADER COMMENT PREVENTS RECONVERSION, DO NOT REMOVE
"aa" = (
/turf/template_noop,
/area/template_noop)
"ab" = (
/turf/closed/wall/mineral/titanium,
/area/shuttle/escape)
"ac" = (
/obj/effect/spawner/structure/window/shuttle{
	dir = 1
	},
/turf/open/floor/plating,
/area/shuttle/escape)
"ad" = (
/turf/closed/wall/mineral/titanium/nodiagonal,
/area/shuttle/escape)
"ae" = (
/obj/structure/table{
	dir = 1
	},
/obj/item/phone{
	pixel_x = -3;
	pixel_y = -3;
	dir = 1
	},
/obj/machinery/light{
	dir = 8
	},
/turf/open/floor/mineral/titanium/blue,
/area/shuttle/escape)
"af" = (
/obj/machinery/computer/station_alert{
	dir = 1
	},
/turf/open/floor/mineral/titanium/blue,
/area/shuttle/escape)
"ag" = (
/obj/machinery/computer/emergency_shuttle{
	dir = 4
	},
/turf/open/floor/mineral/titanium/blue,
/area/shuttle/escape)
"ah" = (
/obj/machinery/computer/communications{
	dir = 1
	},
/turf/open/floor/mineral/titanium/blue,
/area/shuttle/escape)
"ai" = (
/obj/machinery/computer/crew{
	dir = 1
	},
/turf/open/floor/mineral/titanium/blue,
/area/shuttle/escape)
"aj" = (
/obj/structure/table{
	dir = 1
	},
/obj/item/storage/firstaid/regular{
	dir = 1
	},
/obj/machinery/light{
	dir = 4
	},
/turf/open/floor/mineral/titanium/blue,
/area/shuttle/escape)
"ak" = (
/turf/open/floor/mineral/titanium/blue,
/area/shuttle/escape)
"al" = (
/obj/structure/chair/comfy/shuttle{
	dir = 2
	},
/turf/open/floor/mineral/titanium/blue,
/area/shuttle/escape)
"am" = (
/turf/open/floor/mineral/titanium,
/area/shuttle/escape)
"an" = (
/obj/structure/table{
	dir = 1
	},
/obj/item/restraints/handcuffs{
	pixel_y = -3;
	dir = 1
	},
/turf/open/floor/mineral/titanium/blue,
/area/shuttle/escape)
"ao" = (
/obj/machinery/button/flasher{
	id = "cockpit_flasher";
	pixel_x = 6;
	pixel_y = 24;
	dir = 1
	},
/turf/open/floor/mineral/titanium,
/area/shuttle/escape)
"ap" = (
/obj/structure/table{
	dir = 1
	},
/obj/item/paper_bin{
	dir = 1
	},
/obj/item/pen{
	dir = 1
	},
/turf/open/floor/mineral/titanium/blue,
/area/shuttle/escape)
"aq" = (
/obj/structure/table{
	dir = 1
	},
/turf/open/floor/mineral/titanium/blue,
/area/shuttle/escape)
"ar" = (
/obj/structure/table{
	dir = 1
	},
/obj/item/storage/toolbox/mechanical{
	dir = 1
	},
/obj/item/crowbar{
	dir = 1
	},
/turf/open/floor/mineral/titanium/blue,
/area/shuttle/escape)
"as" = (
/obj/structure/table{
	dir = 1
	},
/obj/item/storage/fancy/donut_box{
	dir = 1
	},
/turf/open/floor/mineral/titanium/blue,
/area/shuttle/escape)
"at" = (
/obj/structure/table{
	dir = 1
	},
/obj/machinery/recharger{
	active_power_usage = 0;
	idle_power_usage = 0;
	pixel_y = -4;
	use_power = 0;
	dir = 1
	},
/turf/open/floor/mineral/titanium/blue,
/area/shuttle/escape)
"av" = (
/obj/machinery/status_display/evac{
	dir = 1
	},
/turf/closed/wall/mineral/titanium,
/area/shuttle/escape)
"aw" = (
/obj/machinery/flasher{
	id = "cockpit_flasher";
	pixel_x = 6;
	pixel_y = -24;
	dir = 1
	},
/turf/open/floor/mineral/titanium/blue,
/area/shuttle/escape)
"ax" = (
/obj/structure/closet/emcloset{
	dir = 1
	},
/turf/open/floor/mineral/titanium/blue,
/area/shuttle/escape)
"ay" = (
/obj/structure/chair/comfy/shuttle{
	dir = 4
	},
/turf/open/floor/mineral/plastitanium/red/brig,
/area/shuttle/escape)
"az" = (
/obj/machinery/button/flasher{
	id = "shuttle_flasher";
	pixel_x = 8;
	pixel_y = -24;
	dir = 1
	},
/turf/open/floor/mineral/plastitanium/red/brig,
/area/shuttle/escape)
"aA" = (
/obj/structure/chair{
	dir = 1
	},
/turf/open/floor/mineral/plastitanium/red/brig,
/area/shuttle/escape)
"aB" = (
/obj/structure/chair{
	dir = 1
	},
/obj/machinery/flasher{
	id = "shuttle_flasher";
	pixel_x = -6;
	pixel_y = -24;
	dir = 1
	},
/turf/open/floor/mineral/plastitanium/red/brig,
/area/shuttle/escape)
"aC" = (
/turf/open/floor/mineral/plastitanium/red/brig,
/area/shuttle/escape)
"aE" = (
/obj/machinery/light{
	dir = 4
	},
/turf/open/floor/mineral/plastitanium/red/brig,
/area/shuttle/escape)
"aF" = (
/obj/structure/chair{
	dir = 2
	},
/turf/open/floor/mineral/plastitanium/red/brig,
/area/shuttle/escape)
"aG" = (
/obj/structure/chair/comfy/shuttle{
	dir = 4
	},
/obj/machinery/light{
	dir = 8
	},
/turf/open/floor/mineral/plastitanium/red/brig,
/area/shuttle/escape)
"aH" = (
/obj/machinery/status_display/evac{
	dir = 1
	},
/turf/closed/wall/mineral/titanium/nodiagonal,
/area/shuttle/escape)
"aI" = (
/obj/structure/table{
	dir = 1
	},
/obj/item/storage/fancy/donut_box{
	dir = 1
	},
/obj/item/book/manual/wiki/security_space_law{
	dir = 1
	},
/obj/item/storage/box/handcuffs{
	dir = 1
	},
/turf/open/floor/mineral/plastitanium/red/brig,
/area/shuttle/escape)
"aJ" = (
/obj/machinery/light{
	dir = 1
	},
/turf/open/floor/mineral/titanium,
/area/shuttle/escape)
"aK" = (
/obj/structure/table{
	dir = 1
	},
/obj/machinery/recharger{
	dir = 1
	},
/obj/structure/reagent_dispensers/peppertank{
	pixel_y = -32;
	dir = 1
	},
/turf/open/floor/mineral/plastitanium/red/brig,
/area/shuttle/escape)
"aM" = (
/obj/structure/chair/comfy/shuttle{
	dir = 8
	},
/turf/open/floor/mineral/titanium/blue,
/area/shuttle/escape)
"aN" = (
/obj/machinery/vending/wallmed{
	name = "Emergency NanoMed";
	use_power = 0;
	dir = 1
	},
/turf/closed/wall/mineral/titanium,
/area/shuttle/escape)
"aO" = (
/obj/structure/chair/comfy/shuttle{
	dir = 4
	},
/turf/open/floor/mineral/titanium/blue,
/area/shuttle/escape)
"aQ" = (
/obj/structure/chair/comfy/shuttle{
	dir = 2
	},
/turf/open/floor/mineral/plastitanium/red/brig,
/area/shuttle/escape)
"aT" = (
/obj/structure/extinguisher_cabinet{
	dir = 1
	},
/turf/closed/wall/mineral/titanium,
/area/shuttle/escape)
"aU" = (
/obj/machinery/light{
	dir = 1
	},
/obj/machinery/light{
	dir = 2
	},
/turf/open/floor/mineral/titanium,
/area/shuttle/escape)
"aV" = (
/obj/machinery/light{
	dir = 2
	},
/turf/open/floor/mineral/titanium,
/area/shuttle/escape)
"aW" = (
/obj/structure/chair/comfy/shuttle{
	dir = 2
	},
/obj/structure/window/reinforced{
	dir = 1
	},
/turf/open/floor/mineral/titanium/blue,
/area/shuttle/escape)
"aX" = (
/obj/structure/chair/comfy/shuttle{
	dir = 1
	},
/obj/structure/window/reinforced{
	dir = 2
	},
/turf/open/floor/mineral/titanium/blue,
/area/shuttle/escape)
"aY" = (
/obj/structure/sign/departments/medbay/alt{
	pixel_y = 32;
	dir = 1
	},
/turf/open/floor/mineral/titanium,
/area/shuttle/escape)
"aZ" = (
/obj/machinery/holopad{
	dir = 1
	},
/turf/open/floor/mineral/titanium,
/area/shuttle/escape)
"ba" = (
/obj/structure/reagent_dispensers/fueltank{
	dir = 1
	},
/obj/effect/turf_decal/bot{
	dir = 4
	},
/turf/open/floor/plasteel,
/area/shuttle/escape)
"bb" = (
/turf/open/floor/mineral/titanium/yellow,
/area/shuttle/escape)
"bd" = (
/obj/structure/tank_dispenser/oxygen{
	dir = 1
	},
/obj/effect/turf_decal/bot{
	dir = 4
	},
/turf/open/floor/plasteel,
/area/shuttle/escape)
"be" = (
/obj/structure/reagent_dispensers/watertank{
	dir = 1
	},
/obj/effect/turf_decal/bot{
	dir = 4
	},
/turf/open/floor/plasteel,
/area/shuttle/escape)
"bf" = (
/obj/machinery/stasis{
	dir = 1
	},
/turf/open/floor/mineral/titanium,
/area/shuttle/escape)
"bg" = (
/turf/open/floor/mineral/titanium/white,
/area/shuttle/escape)
"bh" = (
/obj/structure/closet/crate{
	name = "emergency supplies crate";
	dir = 1
	},
/obj/item/storage/toolbox/emergency{
	dir = 4
	},
/obj/item/storage/toolbox/emergency{
	dir = 4
	},
/obj/item/flashlight/flare{
	pixel_x = 3;
	pixel_y = -3;
	dir = 1
	},
/obj/item/flashlight/flare{
	pixel_x = -6;
	pixel_y = 2;
	dir = 1
	},
/obj/item/crowbar{
	dir = 1
	},
/obj/item/wrench{
	dir = 1
	},
/obj/item/radio{
	dir = 1
	},
/obj/effect/turf_decal/bot{
	dir = 4
	},
/turf/open/floor/plasteel,
/area/shuttle/escape)
"bi" = (
/obj/machinery/light{
	dir = 1
	},
/obj/machinery/portable_atmospherics/canister/oxygen{
	dir = 1
	},
/obj/effect/turf_decal/bot{
	dir = 4
	},
/turf/open/floor/plasteel,
/area/shuttle/escape)
"bj" = (
/obj/structure/sink{
	dir = 8;
	pixel_x = -12
	},
/turf/open/floor/mineral/titanium/white,
/area/shuttle/escape)
"bk" = (
/obj/machinery/shower{
	dir = 8
	},
/turf/open/floor/mineral/titanium/white,
/area/shuttle/escape)
"bl" = (
/obj/structure/closet/crate/medical{
	name = "medical crate";
	dir = 1
	},
/obj/item/storage/firstaid/regular{
	dir = 1
	},
/obj/item/storage/firstaid/o2{
	pixel_x = 3;
	pixel_y = -3;
	dir = 1
	},
/obj/item/storage/firstaid/toxin{
	pixel_x = -4;
	pixel_y = -3;
	dir = 1
	},
/obj/item/healthanalyzer{
	pixel_x = 3;
	pixel_y = -3;
	dir = 1
	},
/obj/item/lazarus_injector{
	dir = 1
	},
/obj/effect/turf_decal/bot{
	dir = 4
	},
/obj/machinery/light{
	dir = 1
	},
/mob/living/simple_animal/bot/medbot{
	name = "\improper emergency medibot";
	pixel_x = -3;
	pixel_y = -2
	},
/turf/open/floor/plasteel,
/area/shuttle/escape)
"bm" = (
/obj/structure/closet/emcloset{
	dir = 1
	},
/obj/effect/turf_decal/stripes/line{
	dir = 2
	},
/turf/open/floor/plasteel,
/area/shuttle/escape)
"bn" = (
/obj/structure/table{
	dir = 1
	},
/obj/item/reagent_containers/glass/bottle/epinephrine{
	pixel_x = 6;
	dir = 1
	},
/obj/item/reagent_containers/glass/bottle/charcoal{
	pixel_x = -3;
	dir = 1
	},
/obj/item/reagent_containers/glass/bottle/epinephrine{
	pixel_x = -3;
	pixel_y = -8;
	dir = 1
	},
/obj/item/reagent_containers/glass/bottle/charcoal{
	pixel_x = 6;
	pixel_y = -8;
	dir = 1
	},
/obj/item/reagent_containers/syringe/epinephrine{
	pixel_x = 3;
	pixel_y = 2;
	dir = 1
	},
/obj/item/reagent_containers/syringe/epinephrine{
	pixel_x = 4;
	pixel_y = -1;
	dir = 1
	},
/obj/item/reagent_containers/syringe/epinephrine{
	pixel_x = -2;
	pixel_y = -5;
	dir = 1
	},
/obj/item/reagent_containers/syringe/epinephrine{
	pixel_x = 2;
	pixel_y = -8;
	dir = 1
	},
/obj/machinery/light{
	dir = 1
	},
/turf/open/floor/mineral/titanium,
/area/shuttle/escape)
"bo" = (
/obj/structure/table{
	dir = 1
	},
/obj/item/storage/firstaid/fire{
	dir = 1
	},
/obj/item/storage/firstaid/regular{
	pixel_x = 2;
	pixel_y = -3;
	dir = 1
	},
/turf/open/floor/mineral/titanium,
/area/shuttle/escape)
"bp" = (
/obj/structure/table{
	dir = 1
	},
/obj/item/storage/firstaid/toxin{
	dir = 1
	},
/obj/item/storage/firstaid/o2{
	pixel_x = 3;
	pixel_y = -3;
	dir = 1
	},
/turf/open/floor/mineral/titanium,
/area/shuttle/escape)
"bq" = (
/obj/structure/table{
	dir = 1
	},
/obj/item/defibrillator/loaded{
	dir = 1
	},
/obj/machinery/light{
	dir = 1
	},
/turf/open/floor/mineral/titanium,
/area/shuttle/escape)
"br" = (
/obj/effect/turf_decal/stripes/line{
	dir = 2
	},
/obj/machinery/recharge_station{
	dir = 1
	},
/turf/open/floor/plasteel,
/area/shuttle/escape)
"bs" = (
/obj/structure/window/reinforced{
	dir = 2
	},
/obj/structure/shuttle/engine/heater{
	dir = 1
	},
/turf/open/floor/plating/airless,
/area/shuttle/escape)
"bt" = (
/obj/structure/shuttle/engine/propulsion{
	dir = 1
	},
/turf/open/floor/plating/airless,
/area/shuttle/escape)
"bS" = (
/obj/item/storage/backpack/duffelbag/med/surgery{
	dir = 1
	},
/obj/item/clothing/suit/apron/surgical{
	dir = 1
	},
/obj/item/clothing/mask/surgical{
	dir = 1
	},
/obj/structure/table/optable{
	dir = 1
	},
/turf/open/floor/mineral/titanium,
/area/shuttle/escape)
"fg" = (
/obj/machinery/door/airlock/public/glass{
	name = "Emergency Shuttle Infirmary";
	dir = 1
	},
/obj/machinery/door/firedoor{
	dir = 1
	},
/turf/open/floor/mineral/titanium/white,
/area/shuttle/escape)
"hl" = (
/obj/machinery/door/airlock/command/glass{
	name = "Cockpit";
	req_access_txt = "19";
	dir = 1
	},
/obj/machinery/door/firedoor{
	dir = 1
	},
/turf/open/floor/mineral/titanium,
/area/shuttle/escape)
"pk" = (
/obj/machinery/door/airlock/titanium{
	name = "Emergency Shuttle Airlock";
	req_access_txt = "2";
	dir = 1
	},
/obj/structure/fans/tiny{
	dir = 1
	},
/turf/open/floor/plating,
/area/shuttle/escape)
"uu" = (
/obj/machinery/door/airlock/titanium{
	name = "Emergency Shuttle Airlock";
	dir = 1
	},
/obj/structure/fans/tiny{
	dir = 1
	},
/turf/open/floor/plating,
/area/shuttle/escape)
"Dr" = (
/obj/effect/spawner/structure/window/shuttle{
	dir = 1
	},
/obj/machinery/door/firedoor/window{
	dir = 1
	},
/turf/open/floor/plating,
/area/shuttle/escape)
"FX" = (
/obj/machinery/door/airlock/titanium{
	name = "Emergency Shuttle Airlock";
	dir = 1
	},
/obj/docking_port/mobile/emergency{
	name = "Donut emergency shuttle";
	width = 34;
	dir = 4
	},
/obj/structure/fans/tiny{
	dir = 1
	},
/turf/open/floor/plating,
/area/shuttle/escape)
"Ia" = (
/obj/machinery/door/airlock/public/glass{
	name = "Containment Cell";
	req_access_txt = "2";
	dir = 1
	},
/obj/machinery/door/firedoor{
	dir = 1
	},
/turf/open/floor/mineral/plastitanium/red/brig,
/area/shuttle/escape)
"JF" = (
/obj/machinery/door/airlock/public/glass{
	name = "Emergency Shuttle Brig";
	req_access_txt = "2";
	dir = 1
	},
/obj/machinery/door/firedoor{
	dir = 1
	},
/turf/open/floor/mineral/titanium,
/area/shuttle/escape)

(1,1,1) = {"
aa
aa
aa
ab
ab
ab
ab
ab
aa
ab
uu
Dr
uu
ab
aa
aa
aa
ab
FX
ab
pk
ab
ab
aa
aa
aa
aa
aa
aa
aa
aa
aa
aa
aa"}(2,1,1) = {"
ab
ab
ab
ad
bi
be
ba
ad
ab
ad
ak
ak
ak
ad
Dr
Dr
Dr
ab
ak
ab
aC
aK
ad
ab
ab
ab
ab
ab
ab
aa
aa
aa
aa
aa"}(3,1,1) = {"
bt
bs
ab
bm
bb
bb
bb
am
am
am
am
am
am
am
am
am
am
am
ak
ab
aC
aC
aC
aG
ay
ay
ay
ab
ab
ab
Dr
Dr
ab
aa"}(4,1,1) = {"
bt
bs
ab
ab
ac
ac
aH
am
am
am
am
aM
aM
aM
aM
aM
am
am
ak
ab
aQ
aC
aC
aC
aC
aC
az
ab
ap
an
ak
ak
ad
ab"}(5,1,1) = {"
bt
bs
ab
bn
bj
bS
ab
aY
aX
aW
aV
aT
ac
ab
ac
aN
aJ
am
ak
ab
aQ
aC
aI
ad
ac
Ia
ac
av
aq
am
am
ak
ae
ab"}(6,1,1) = {"
bt
bs
ab
bg
bg
bg
fg
am
aX
aW
am
aO
aO
aO
aO
aO
am
am
ak
aH
ac
JF
ac
ab
aF
aC
aA
ab
ar
am
am
al
af
Dr"}(7,1,1) = {"
bt
bs
ab
bo
bg
bf
ac
aZ
aX
aW
am
am
am
am
am
am
am
am
am
am
am
am
am
ab
aF
aC
aB
ab
as
am
am
al
ag
Dr"}(8,1,1) = {"
bt
bs
ab
bp
bg
bf
ac
aZ
aX
aW
am
am
am
am
am
am
am
am
am
am
am
am
am
ab
aF
aE
aA
ab
at
am
am
al
ah
Dr"}(9,1,1) = {"
bt
bs
ab
bg
bg
bg
fg
am
aX
aW
am
aM
aM
aM
aM
aM
am
aM
aM
aM
aM
aM
am
aH
ab
ab
ab
ab
ad
am
am
al
ai
Dr"}(10,1,1) = {"
bt
bs
ab
bq
bk
bf
ab
aY
aX
aW
aV
aT
ac
ab
ac
aN
aU
aT
ac
ab
ac
aN
aJ
ak
ak
ak
ak
aw
ad
ao
am
ak
aj
ab"}(11,1,1) = {"
bt
bs
ab
ab
ac
ac
aH
am
am
am
am
aO
aO
aO
aO
aO
am
aO
aO
aO
aO
aO
am
am
am
am
am
am
hl
ak
ak
ak
ad
ab"}(12,1,1) = {"
bt
bs
ab
br
bb
bb
bb
am
am
am
am
am
am
am
am
am
am
am
am
am
am
am
am
ak
ak
aq
ax
ax
ad
ab
Dr
Dr
ab
aa"}(13,1,1) = {"
ab
ab
ab
ad
bl
bh
bd
ad
ab
ad
ak
ak
ak
ad
Dr
Dr
Dr
ad
ak
ak
ak
ak
ad
ab
ab
ab
ab
ab
ab
aa
aa
aa
aa
aa"}(14,1,1) = {"
aa
aa
aa
ab
ab
ab
ab
ab
aa
ab
uu
Dr
uu
ab
aa
aa
aa
ab
uu
Dr
uu
ab
ab
aa
aa
aa
aa
aa
aa
aa
aa
aa
aa
aa"}