//MAP CONVERTED BY dmm2tgm.py THIS HEADER COMMENT PREVENTS RECONVERSION, DO NOT REMOVE
"h" = (
/obj/structure/chair/comfy/shuttle{
	dir = 4
	},
/obj/item/storage/pod{
	pixel_x = -24;
	dir = 1
	},
/turf/open/floor/mineral/titanium/blue,
/area/shuttle/pod_1)
"r" = (
/turf/open/floor/mineral/titanium/blue,
/area/shuttle/pod_1)
"u" = (
/obj/structure/grille{
	dir = 1
	},
/obj/structure/window/shuttle{
	dir = 1
	},
/turf/open/floor/plating,
/area/shuttle/pod_1)
"A" = (
/obj/structure/chair/comfy/shuttle{
	dir = 8
	},
/obj/item/radio/intercom{
	pixel_x = 30;
	dir = 1
	},
/turf/open/floor/mineral/titanium/blue,
/area/shuttle/pod_1)
"B" = (
/turf/closed/wall/mineral/titanium,
/area/shuttle/pod_1)
"C" = (
/obj/machinery/computer/shuttle_flight/monastery_shuttle{
	dir = 1
	},
/obj/machinery/light{
	dir = 2
	},
/turf/open/floor/mineral/titanium/blue,
/area/shuttle/pod_1)
"H" = (
/obj/structure/chair/comfy/shuttle{
	dir = 8
	},
/turf/open/floor/mineral/titanium/blue,
/area/shuttle/pod_1)
"J" = (
/obj/structure/chair/comfy/shuttle{
	dir = 4
	},
/obj/machinery/status_display/evac{
	pixel_x = -32;
	dir = 1
	},
/turf/open/floor/mineral/titanium/blue,
/area/shuttle/pod_1)
"L" = (
/obj/structure/chair/comfy/shuttle{
	dir = 4
	},
/turf/open/floor/mineral/titanium/blue,
/area/shuttle/pod_1)
"M" = (
/obj/structure/chair/comfy/shuttle{
	dir = 8
	},
/obj/machinery/status_display/evac{
	pixel_x = 32;
	dir = 1
	},
/turf/open/floor/mineral/titanium/blue,
/area/shuttle/pod_1)
"O" = (
/obj/machinery/door/airlock/titanium{
	name = "Shuttle Airlock";
	dir = 1
	},
/obj/docking_port/mobile/pod{
	dwidth = 2;
	height = 6;
	launch_status = 0;
	port_direction = 2;
	width = 5;
	dir = 2
	},
/turf/open/floor/mineral/titanium/blue,
/area/shuttle/pod_1)
"W" = (
/turf/template_noop,
/area/template_noop)
"Z" = (
/obj/structure/shuttle/engine/propulsion/burst{
	dir = 1
	},
/turf/closed/wall/mineral/titanium,
/area/shuttle/pod_1)

(1,1,1) = {"
Z
B
u
B
B
W"}(2,1,1) = {"
Z
h
L
J
B
B"}(3,1,1) = {"
O
r
r
r
C
u"}(4,1,1) = {"
Z
A
H
M
B
B"}(5,1,1) = {"
Z
B
u
B
B
W"}