//MAP CONVERTED BY dmm2tgm.py THIS HEADER COMMENT PREVENTS RECONVERSION, DO NOT REMOVE
"aR" = (
/obj/structure/lattice{
	dir = 1
	},
/obj/machinery/atmospherics/pipe/simple/scrubbers/hidden{
	dir = 1
	},
/turf/template_noop,
/area/shuttle/exploration)
"cg" = (
/obj/machinery/airalarm{
	pixel_y = -23;
	dir = 1
	},
/obj/machinery/atmospherics/pipe/simple/scrubbers/hidden{
	dir = 4
	},
/obj/structure/chair/comfy/shuttle{
	dir = 1
	},
/turf/open/floor/mineral/titanium,
/area/shuttle/exploration)
"cu" = (
/obj/structure/lattice/catwalk{
	dir = 1
	},
/obj/machinery/atmospherics/components/unary/outlet_injector/on{
	dir = 1
	},
/turf/template_noop,
/area/shuttle/exploration)
"cH" = (
/obj/item/radio/intercom{
	frequency = 1453;
	pixel_y = -24;
	dir = 1
	},
/obj/machinery/atmospherics/pipe/simple/scrubbers/hidden{
	dir = 5
	},
/turf/open/floor/mineral/titanium,
/area/shuttle/exploration)
"da" = (
/turf/closed/wall/mineral/titanium,
/area/shuttle/exploration)
"fr" = (
/obj/machinery/atmospherics/pipe/manifold/supply/hidden{
	dir = 4
	},
/turf/closed/wall/mineral/titanium/nodiagonal,
/area/shuttle/exploration)
"fF" = (
/obj/machinery/door/airlock/external/glass{
	dir = 1
	},
/obj/machinery/atmospherics/pipe/simple/scrubbers/hidden{
	dir = 4
	},
/obj/effect/mapping_helpers/airlock/cyclelink_helper{
	dir = 4
	},
/turf/open/floor/mineral/plastitanium,
/area/shuttle/exploration)
"hl" = (
/obj/machinery/shuttle/engine/plasma{
	dir = 2
	},
/turf/open/floor/plating,
/area/shuttle/exploration)
"hY" = (
/obj/effect/turf_decal/stripes/line{
	dir = 2
	},
/obj/structure/cable/yellow{
	icon_state = "0-8"
	},
/obj/machinery/power/apc/auto_name/east,
/obj/machinery/atmospherics/pipe/manifold/supply/hidden{
	dir = 8
	},
/turf/open/floor/mineral/titanium,
/area/shuttle/exploration)
"ir" = (
/turf/open/floor/mineral/plastitanium,
/area/shuttle/exploration)
"jR" = (
/obj/effect/turf_decal/stripes/line{
	dir = 2
	},
/obj/structure/cable/yellow{
	icon_state = "4-8"
	},
/turf/open/floor/mineral/titanium,
/area/shuttle/exploration)
"kp" = (
/mob/living/simple_animal/chicken/turkey{
	atmos_requirements = list("min_oxy" = 0, "max_oxy" = 0, "min_tox" = 0, "max_tox" = 0, "min_co2" = 0, "max_co2" = 0, "min_n2" = 0, "max_n2" = 0);
	desc = "A veteran of Nanotrasen's Animal Experimentation Program that attempted to replicate the organic space suit that some hostile entities are known to have exhibited, Tom now serves Nanotrasen as the mascot of the Exploration Crew.";
	health = 200;
	maxHealth = 200;
	melee_damage = 5;
	minbodytemp = 2.7;
	name = "Tom"
	},
/obj/machinery/atmospherics/pipe/simple/scrubbers/hidden{
	dir = 1
	},
/turf/open/floor/mineral/titanium,
/area/shuttle/exploration)
"ll" = (
/obj/machinery/telecomms/relay/preset/exploration{
	dir = 1
	},
/obj/effect/turf_decal/delivery{
	dir = 4
	},
/obj/machinery/light/small{
	dir = 8
	},
/turf/open/floor/mineral/titanium,
/area/shuttle/exploration)
"oC" = (
/obj/effect/spawner/structure/window/shuttle{
	dir = 1
	},
/turf/open/floor/plating,
/area/shuttle/exploration)
"oH" = (
/obj/machinery/atmospherics/components/binary/dp_vent_pump{
	dir = 8
	},
/turf/open/floor/mineral/plastitanium,
/area/shuttle/exploration)
"po" = (
/obj/machinery/computer/crew{
	dir = 1
	},
/turf/open/floor/mineral/plastitanium,
/area/shuttle/exploration)
"pG" = (
/obj/machinery/atmospherics/components/unary/portables_connector/visible{
	dir = 8
	},
/obj/machinery/portable_atmospherics/canister/toxins{
	dir = 1
	},
/turf/open/floor/mineral/titanium,
/area/shuttle/exploration)
"qa" = (
/obj/machinery/atmospherics/components/unary/tank/air{
	dir = 4;
	initialize_directions = 4
	},
/obj/machinery/light/small{
	dir = 1
	},
/turf/open/floor/mineral/plastitanium,
/area/shuttle/exploration)
"qi" = (
/obj/machinery/atmospherics/pipe/simple/supply/hidden{
	dir = 10
	},
/turf/closed/wall/mineral/titanium/nodiagonal,
/area/shuttle/exploration)
"qX" = (
/obj/structure/table{
	dir = 1
	},
/obj/machinery/recharger{
	dir = 1
	},
/turf/open/floor/mineral/titanium,
/area/shuttle/exploration)
"rQ" = (
/obj/structure/table{
	dir = 1
	},
/obj/item/trash/syndi_cakes{
	pixel_x = -3;
	pixel_y = -5;
	dir = 1
	},
/obj/item/broken_bottle{
	pixel_x = 8;
	pixel_y = 2;
	dir = 1
	},
/obj/item/gps/mining/exploration{
	dir = 1
	},
/turf/open/floor/mineral/titanium,
/area/shuttle/exploration)
"sz" = (
/obj/machinery/computer/objective{
	dir = 1
	},
/obj/machinery/light{
	dir = 8
	},
/turf/open/floor/mineral/titanium,
/area/shuttle/exploration)
"sE" = (
/obj/machinery/computer/shuttle_flight/custom_shuttle/exploration{
	dir = 1
	},
/turf/open/floor/mineral/plastitanium,
/area/shuttle/exploration)
"sT" = (
/obj/structure/chair/comfy/shuttle{
	dir = 2
	},
/turf/open/floor/mineral/titanium,
/area/shuttle/exploration)
"sY" = (
/obj/structure/table{
	dir = 1
	},
/obj/item/trash/sosjerky{
	dir = 1
	},
/obj/item/trash/popcorn{
	pixel_y = -11;
	dir = 1
	},
/obj/item/paper/crumpled{
	info = "<p>I bought you some food, but I ate it all before you came, sorry.</p><p>- RTH</p>";
	name = "scribbled note";
	dir = 1
	},
/turf/open/floor/mineral/titanium,
/area/shuttle/exploration)
"tq" = (
/obj/machinery/atmospherics/pipe/simple/scrubbers/hidden{
	dir = 4
	},
/obj/machinery/atmospherics/pipe/simple/supply/hidden{
	dir = 1
	},
/turf/open/floor/mineral/titanium,
/area/shuttle/exploration)
"ts" = (
/obj/machinery/atmospherics/components/unary/vent_scrubber/on{
	dir = 4
	},
/turf/open/floor/mineral/titanium,
/area/shuttle/exploration)
"tz" = (
/turf/closed/wall/mineral/plastitanium/nodiagonal,
/area/shuttle/exploration)
"vc" = (
/obj/machinery/computer/arcade/orion_trail{
	dir = 1
	},
/obj/effect/turf_decal/bot{
	dir = 4
	},
/turf/open/floor/mineral/titanium,
/area/shuttle/exploration)
"vd" = (
/obj/machinery/light/small{
	dir = 4
	},
/obj/structure/chair/comfy/shuttle{
	dir = 2
	},
/turf/open/floor/mineral/titanium,
/area/shuttle/exploration)
"vi" = (
/obj/structure/tank_dispenser/oxygen{
	dir = 1
	},
/turf/open/floor/mineral/titanium,
/area/shuttle/exploration)
"zN" = (
/obj/effect/turf_decal/bot{
	dir = 4
	},
/obj/machinery/atmospherics/components/unary/vent_scrubber/on{
	dir = 4
	},
/turf/open/floor/mineral/titanium,
/area/shuttle/exploration)
"Ax" = (
/turf/closed/wall/mineral/titanium/nodiagonal,
/area/shuttle/exploration)
"BF" = (
/obj/machinery/light/small{
	dir = 4
	},
/obj/structure/chair/comfy/shuttle{
	dir = 1
	},
/turf/open/floor/mineral/titanium,
/area/shuttle/exploration)
"CU" = (
/obj/machinery/atmospherics/components/unary/plasma_refiner{
	dir = 4
	},
/turf/open/floor/plating,
/area/shuttle/exploration)
"Dl" = (
/obj/effect/spawner/structure/window/shuttle{
	dir = 1
	},
/obj/machinery/atmospherics/pipe/simple/scrubbers/hidden{
	dir = 1
	},
/turf/open/floor/plating,
/area/shuttle/exploration)
"DM" = (
/obj/machinery/door/airlock/shuttle{
	dir = 1
	},
/obj/machinery/atmospherics/pipe/simple/scrubbers/hidden{
	dir = 1
	},
/turf/open/floor/mineral/titanium,
/area/shuttle/exploration)
"GH" = (
/obj/machinery/atmospherics/pipe/manifold/purple/visible{
	dir = 2
	},
/obj/effect/turf_decal/delivery{
	dir = 4
	},
/turf/open/floor/mineral/titanium,
/area/shuttle/exploration)
"Hf" = (
/turf/open/floor/mineral/titanium,
/area/shuttle/exploration)
"HD" = (
/obj/docking_port/mobile{
	dir = 8;
	dwidth = 9;
	height = 8;
	id = "exploration";
	name = "Exploration Shuttle";
	port_direction = 4;
	shuttle_object_type = /datum/orbital_object/shuttle/custom_shuttle;
	width = 16
	},
/obj/machinery/door/airlock/external/glass{
	dir = 1
	},
/obj/machinery/atmospherics/pipe/simple/supply/hidden{
	dir = 9
	},
/obj/effect/mapping_helpers/airlock/cyclelink_helper{
	dir = 8
	},
/turf/open/floor/mineral/plastitanium,
/area/shuttle/exploration)
"In" = (
/obj/machinery/atmospherics/pipe/simple/scrubbers/hidden{
	dir = 1
	},
/turf/open/floor/mineral/titanium,
/area/shuttle/exploration)
"IP" = (
/obj/machinery/atmospherics/pipe/manifold4w/purple/visible{
	dir = 1
	},
/obj/effect/turf_decal/delivery{
	dir = 4
	},
/turf/open/floor/mineral/titanium,
/area/shuttle/exploration)
"IQ" = (
/obj/machinery/atmospherics/pipe/simple/scrubbers/hidden{
	dir = 10
	},
/obj/structure/chair/comfy/shuttle{
	dir = 1
	},
/turf/open/floor/mineral/titanium,
/area/shuttle/exploration)
"IS" = (
/obj/machinery/atmospherics/components/unary/vent_pump/on{
	dir = 1
	},
/turf/open/floor/mineral/titanium,
/area/shuttle/exploration)
"KU" = (
/obj/effect/turf_decal/stripes/line{
	dir = 2
	},
/obj/structure/cable/yellow{
	icon_state = "0-4"
	},
/obj/machinery/power/port_gen/pacman{
	dir = 1
	},
/obj/item/wrench{
	dir = 1
	},
/obj/item/stack/sheet/mineral/plasma/fifty{
	dir = 1
	},
/turf/open/floor/plating,
/area/shuttle/exploration)
"Nc" = (
/obj/machinery/holopad{
	dir = 1
	},
/obj/machinery/atmospherics/pipe/simple/scrubbers/hidden{
	dir = 1
	},
/turf/open/floor/mineral/titanium,
/area/shuttle/exploration)
"Nx" = (
/obj/structure/chair/comfy/shuttle{
	dir = 2
	},
/obj/item/radio/intercom{
	frequency = 1453;
	pixel_y = 30;
	dir = 1
	},
/obj/machinery/light/small{
	dir = 8
	},
/turf/open/floor/mineral/plastitanium,
/area/shuttle/exploration)
"NT" = (
/obj/structure/table{
	dir = 1
	},
/obj/item/trash/pistachios{
	dir = 1
	},
/obj/item/trash/can/food/beans{
	pixel_y = -10;
	dir = 1
	},
/turf/open/floor/mineral/titanium,
/area/shuttle/exploration)
"OE" = (
/obj/structure/closet/emcloset/anchored{
	dir = 1
	},
/obj/machinery/advanced_airlock_controller/directional/east,
/turf/open/floor/mineral/plastitanium,
/area/shuttle/exploration)
"OU" = (
/obj/effect/turf_decal/bot{
	dir = 4
	},
/obj/item/storage/toolbox/mechanical{
	dir = 1
	},
/obj/item/multitool{
	dir = 1
	},
/obj/machinery/atmospherics/components/unary/vent_pump/on{
	dir = 2
	},
/turf/open/floor/mineral/titanium,
/area/shuttle/exploration)
"PA" = (
/obj/machinery/atmospherics/pipe/manifold/scrubbers/hidden{
	dir = 4
	},
/turf/open/floor/mineral/titanium,
/area/shuttle/exploration)
"Qb" = (
/obj/machinery/atmospherics/pipe/simple/supply/hidden{
	dir = 1
	},
/turf/closed/wall/mineral/titanium/nodiagonal,
/area/shuttle/exploration)
"Qy" = (
/obj/machinery/atmospherics/pipe/simple/purple/visible{
	dir = 5
	},
/obj/effect/turf_decal/bot{
	dir = 4
	},
/obj/machinery/light/small{
	dir = 2
	},
/turf/open/floor/mineral/titanium,
/area/shuttle/exploration)
"Rk" = (
/obj/structure/window/reinforced/survival_pod{
	dir = 2
	},
/obj/machinery/atmospherics/components/unary/shuttle/heater{
	dir = 2
	},
/turf/open/floor/plating,
/area/shuttle/exploration)
"Rp" = (
/obj/machinery/door/airlock/shuttle{
	dir = 1
	},
/obj/effect/turf_decal/stripes/line{
	dir = 1
	},
/obj/effect/turf_decal/stripes/line{
	dir = 2
	},
/turf/open/floor/mineral/plastitanium,
/area/shuttle/exploration)
"RQ" = (
/turf/template_noop,
/area/template_noop)
"SA" = (
/obj/effect/turf_decal/bot{
	dir = 4
	},
/obj/machinery/atmospherics/pipe/simple/scrubbers/hidden{
	dir = 10
	},
/turf/open/floor/mineral/titanium,
/area/shuttle/exploration)
"Vj" = (
/obj/effect/turf_decal/stripes/line{
	dir = 2
	},
/obj/structure/cable/yellow{
	icon_state = "4-8"
	},
/obj/machinery/atmospherics/pipe/simple/scrubbers/hidden{
	dir = 1
	},
/turf/open/floor/mineral/titanium,
/area/shuttle/exploration)
"Vl" = (
/turf/closed/wall/mineral/plastitanium,
/area/shuttle/exploration)
"Xj" = (
/obj/machinery/atmospherics/pipe/simple/supply/hidden{
	dir = 4
	},
/turf/closed/wall/mineral/titanium/nodiagonal,
/area/shuttle/exploration)
"Yi" = (
/obj/structure/closet/crate{
	dir = 1
	},
/obj/item/circuitboard/computer/shuttle/exploration_shuttle{
	dir = 1
	},
/obj/item/stack/sheet/mineral/plasma/five{
	dir = 1
	},
/obj/item/pickaxe{
	dir = 1
	},
/obj/item/mining_scanner{
	dir = 1
	},
/obj/item/radio/headset/headset_exploration{
	dir = 1
	},
/obj/item/radio/headset/headset_exploration{
	dir = 1
	},
/obj/machinery/light/small{
	dir = 8
	},
/turf/open/floor/plating,
/area/shuttle/exploration)
"ZX" = (
/obj/machinery/atmospherics/pipe/manifold/scrubbers/hidden{
	dir = 8
	},
/turf/open/floor/mineral/titanium,
/area/shuttle/exploration)

(1,1,1) = {"
RQ
Vl
tz
Ax
Ax
Ax
Ax
Ax
oC
Ax
oC
Ax
da
da
da
da"}(2,1,1) = {"
Vl
tz
CU
Yi
KU
Ax
ll
Hf
Hf
qX
sT
sz
da
Nx
sE
oC"}(3,1,1) = {"
hl
Rk
GH
zN
jR
Ax
vi
Hf
Hf
ts
Hf
Hf
Rp
ir
po
oC"}(4,1,1) = {"
hl
Rk
GH
SA
Vj
DM
ZX
kp
In
PA
Nc
cH
da
oC
oC
oC"}(5,1,1) = {"
hl
Rk
GH
OU
hY
Qb
tq
IS
vc
sT
rQ
cg
da
RQ
RQ
RQ"}(6,1,1) = {"
hl
Rk
IP
Qy
Xj
Ax
fF
Ax
Ax
sT
sY
IQ
Dl
aR
aR
cu"}(7,1,1) = {"
Vl
tz
pG
pG
Xj
qa
oH
OE
Ax
vd
NT
BF
oC
RQ
RQ
RQ"}(8,1,1) = {"
RQ
Vl
tz
Ax
qi
fr
HD
Ax
Ax
Ax
oC
da
da
RQ
RQ
RQ"}