//MAP CONVERTED BY dmm2tgm.py THIS HEADER COMMENT PREVENTS RECONVERSION, DO NOT REMOVE
"ak" = (
/obj/machinery/telecomms/relay/preset/exploration,
/obj/effect/turf_decal/delivery,
/obj/effect/decal/cleanable/dirt/dust,
/turf/open/floor/plasteel/techmaint,
/area/shuttle/exploration)
"am" = (
/obj/structure/extinguisher_cabinet{
	pixel_y = 30
	},
/turf/open/floor/mineral/titanium,
/area/shuttle/exploration)
"aq" = (
/obj/machinery/atmospherics/pipe/simple/purple/visible{
	dir = 9
	},
/obj/effect/turf_decal/stripes/line{
	dir = 6
	},
/obj/structure/cable/yellow{
	icon_state = "0-8"
	},
/obj/machinery/light,
/obj/machinery/power/apc/highcap{
	pixel_y = -24
	},
/turf/open/floor/plasteel/techmaint,
/area/shuttle/exploration)
"av" = (
/turf/open/floor/mineral/titanium,
/area/shuttle/exploration)
"ay" = (
/obj/structure/window/reinforced/survival_pod{
	dir = 1
	},
/obj/machinery/atmospherics/components/unary/shuttle/heater{
	dir = 1
	},
/turf/open/floor/plating,
/area/shuttle/exploration)
"aA" = (
/obj/effect/turf_decal/bot,
/turf/open/floor/mineral/plastitanium,
/area/shuttle/exploration)
"aB" = (
/obj/effect/turf_decal/tile/red{
	dir = 1
	},
/obj/effect/turf_decal/tile/red,
/obj/effect/turf_decal/tile/yellow{
	dir = 4
	},
/obj/effect/turf_decal/tile/yellow{
	dir = 8
	},
/obj/machinery/vending/cigarette,
/obj/effect/turf_decal/bot,
/turf/open/floor/plasteel,
/area/shuttle/exploration)
"aM" = (
/obj/structure/sign/poster/official/random{
	pixel_y = 32
	},
/obj/effect/decal/cleanable/dirt/dust,
/turf/open/floor/mineral/titanium,
/area/shuttle/exploration)
"bB" = (
/obj/effect/turf_decal/stripes/line{
	dir = 10
	},
/obj/item/kirbyplants/random,
/obj/machinery/light,
/obj/effect/decal/cleanable/dirt/dust,
/turf/open/floor/plasteel/techmaint,
/area/shuttle/exploration)
"bT" = (
/turf/closed/wall/mineral/plastitanium,
/area/shuttle/exploration)
"cb" = (
/obj/structure/flora/ausbushes/fullgrass,
/obj/structure/flora/ausbushes/sparsegrass,
/obj/structure/flora/grass/green{
	pixel_x = -2
	},
/obj/machinery/light/floor,
/turf/open/floor/grass,
/area/shuttle/exploration)
"cd" = (
/obj/effect/decal/cleanable/dirt/dust,
/turf/open/floor/carpet/blue,
/area/shuttle/exploration)
"ce" = (
/obj/effect/turf_decal/tile/red{
	dir = 1
	},
/obj/effect/turf_decal/tile/red,
/obj/effect/turf_decal/tile/yellow{
	dir = 4
	},
/obj/effect/turf_decal/tile/yellow{
	dir = 8
	},
/obj/structure/window/reinforced/spawner/north{
	pixel_y = 4
	},
/obj/structure/chair/sofa/corp/corner,
/turf/open/floor/plasteel,
/area/shuttle/exploration)
"cp" = (
/obj/effect/turf_decal/stripes/line{
	dir = 1
	},
/turf/open/floor/plasteel/techmaint,
/area/shuttle/exploration)
"df" = (
/obj/structure/closet/emcloset/anchored,
/obj/machinery/light/small{
	dir = 1
	},
/obj/machinery/advanced_airlock_controller{
	dir = 8;
	pixel_x = 24
	},
/obj/effect/turf_decal/bot,
/turf/open/floor/mineral/plastitanium,
/area/shuttle/exploration)
"dZ" = (
/obj/effect/turf_decal/tile/red{
	dir = 1
	},
/obj/effect/turf_decal/tile/red,
/obj/effect/turf_decal/tile/yellow{
	dir = 4
	},
/obj/effect/turf_decal/tile/yellow{
	dir = 8
	},
/obj/effect/decal/cleanable/dirt/dust,
/turf/open/floor/plasteel,
/area/shuttle/exploration)
"ew" = (
/obj/structure/window/reinforced/spawner/north{
	pixel_y = 4
	},
/obj/machinery/suit_storage_unit/exploration,
/obj/effect/turf_decal/delivery,
/obj/effect/decal/cleanable/dirt/dust,
/turf/open/floor/plasteel,
/area/shuttle/exploration)
"eZ" = (
/obj/structure/closet/secure_closet/freezer/fridge,
/obj/effect/decal/cleanable/dirt/dust,
/turf/open/floor/plasteel,
/area/shuttle/exploration)
"fh" = (
/obj/structure/table/reinforced,
/obj/effect/turf_decal/tile/neutral,
/turf/open/floor/plasteel,
/area/shuttle/exploration)
"gr" = (
/obj/structure/railing/corner{
	dir = 8
	},
/turf/open/floor/mineral/plastitanium,
/area/shuttle/exploration)
"gI" = (
/obj/structure/flora/ausbushes/grassybush,
/obj/structure/flora/ausbushes/sparsegrass,
/turf/open/floor/grass,
/area/shuttle/exploration)
"iQ" = (
/obj/machinery/atmospherics/components/binary/dp_vent_pump{
	dir = 8
	},
/obj/effect/decal/cleanable/dirt/dust,
/turf/open/floor/mineral/plastitanium,
/area/shuttle/exploration)
"jd" = (
/obj/structure/flora/ausbushes/grassybush,
/obj/structure/flora/ausbushes/sparsegrass,
/obj/structure/flora/ausbushes/sparsegrass{
	pixel_x = -8;
	pixel_y = 15
	},
/obj/machinery/light/floor,
/turf/open/floor/grass,
/area/shuttle/exploration)
"jf" = (
/obj/machinery/door/poddoor/shutters{
	id = "exploration"
	},
/obj/structure/fans/tiny,
/obj/effect/turf_decal/delivery,
/turf/open/floor/mineral/plastitanium,
/area/shuttle/exploration)
"jp" = (
/obj/structure/railing/corner,
/obj/effect/turf_decal/tile/neutral{
	dir = 1
	},
/turf/open/floor/plasteel,
/area/shuttle/exploration)
"jB" = (
/obj/structure/table,
/obj/item/flashlight/lamp{
	pixel_x = -1;
	pixel_y = 12
	},
/obj/machinery/firealarm{
	dir = 4;
	pixel_x = -26
	},
/obj/machinery/recharger,
/turf/open/floor/carpet/blue,
/area/shuttle/exploration)
"jI" = (
/obj/structure/closet/crate/science,
/obj/item/radio/headset/headset_exploration,
/obj/item/radio/headset/headset_exploration,
/obj/item/mining_scanner,
/obj/item/pickaxe,
/obj/machinery/light/small{
	dir = 1
	},
/obj/effect/turf_decal/bot,
/turf/open/floor/mineral/plastitanium,
/area/shuttle/exploration)
"lM" = (
/obj/effect/turf_decal/box,
/obj/structure/table/reinforced,
/obj/item/storage/toolbox/mechanical{
	pixel_x = -2;
	pixel_y = 6
	},
/obj/item/stack/cable_coil/white,
/obj/item/stack/cable_coil/white{
	pixel_x = 3;
	pixel_y = 3
	},
/turf/open/floor/plasteel/techmaint,
/area/shuttle/exploration)
"mA" = (
/obj/machinery/atmospherics/pipe/manifold/dark/hidden{
	dir = 4
	},
/turf/closed/wall/mineral/titanium/nodiagonal,
/area/shuttle/exploration)
"mU" = (
/obj/machinery/atmospherics/pipe/simple/purple/visible{
	dir = 8
	},
/obj/effect/turf_decal/stripes/line{
	dir = 1
	},
/obj/structure/cable/yellow{
	icon_state = "0-2"
	},
/obj/machinery/power/port_gen/pacman,
/obj/item/stack/sheet/mineral/plasma/twenty,
/turf/open/floor/plasteel/techmaint,
/area/shuttle/exploration)
"ns" = (
/obj/machinery/light{
	dir = 4
	},
/obj/effect/turf_decal/tile/neutral{
	dir = 4
	},
/turf/open/floor/plasteel,
/area/shuttle/exploration)
"ov" = (
/obj/structure/extinguisher_cabinet{
	pixel_x = -25
	},
/turf/open/floor/mineral/titanium,
/area/shuttle/exploration)
"oG" = (
/obj/structure/railing/corner,
/obj/machinery/door/poddoor/shutters{
	id = "exploration"
	},
/obj/structure/fans/tiny,
/obj/effect/turf_decal/delivery,
/turf/open/floor/mineral/plastitanium,
/area/shuttle/exploration)
"pA" = (
/obj/machinery/door/airlock/shuttle,
/obj/machinery/door/firedoor,
/obj/effect/turf_decal/stripes/line,
/obj/effect/turf_decal/stripes/line{
	dir = 1
	},
/turf/open/floor/mineral/titanium,
/area/shuttle/exploration)
"pP" = (
/obj/effect/turf_decal/tile/red{
	dir = 1
	},
/obj/effect/turf_decal/tile/red,
/obj/effect/turf_decal/tile/yellow{
	dir = 4
	},
/obj/effect/turf_decal/tile/yellow{
	dir = 8
	},
/obj/structure/chair/sofa/corp/right{
	dir = 4
	},
/turf/open/floor/plasteel,
/area/shuttle/exploration)
"pV" = (
/obj/effect/turf_decal/tile/red{
	dir = 1
	},
/obj/effect/turf_decal/tile/red,
/obj/effect/turf_decal/tile/yellow{
	dir = 4
	},
/obj/effect/turf_decal/tile/yellow{
	dir = 8
	},
/obj/machinery/light{
	dir = 8
	},
/turf/open/floor/plasteel,
/area/shuttle/exploration)
"rq" = (
/obj/structure/railing,
/turf/open/floor/mineral/plastitanium,
/area/shuttle/exploration)
"sP" = (
/obj/machinery/atmospherics/pipe/manifold/purple/visible,
/obj/effect/turf_decal/stripes/line{
	dir = 1
	},
/turf/open/floor/plasteel/techmaint,
/area/shuttle/exploration)
"tP" = (
/obj/machinery/door/airlock/shuttle,
/obj/machinery/door/firedoor,
/obj/effect/turf_decal/stripes/line{
	dir = 4
	},
/obj/effect/turf_decal/stripes/line{
	dir = 8
	},
/turf/open/floor/plasteel,
/area/shuttle/exploration)
"tU" = (
/obj/structure/table/reinforced,
/obj/item/storage/box/donkpockets,
/obj/item/storage/box/donkpockets{
	pixel_x = 3;
	pixel_y = 3
	},
/obj/item/reagent_containers/food/condiment/enzyme{
	pixel_x = -7;
	pixel_y = 4
	},
/turf/open/floor/plasteel,
/area/shuttle/exploration)
"uJ" = (
/obj/machinery/door/airlock/external/glass,
/obj/machinery/atmospherics/pipe/simple/dark/hidden{
	dir = 6
	},
/obj/docking_port/mobile{
	dir = 4;
	dwidth = 8;
	height = 13;
	id = "exploration";
	name = "Exploration Shuttle";
	port_direction = 8;
	shuttle_object_type = /datum/orbital_object/shuttle/custom_shuttle;
	width = 20
	},
/obj/effect/turf_decal/stripes/line{
	dir = 8
	},
/obj/effect/turf_decal/stripes/line{
	dir = 4
	},
/turf/open/floor/mineral/plastitanium,
/area/shuttle/exploration)
"vp" = (
/obj/structure/extinguisher_cabinet{
	pixel_x = 6;
	pixel_y = -30
	},
/obj/machinery/light{
	dir = 1
	},
/turf/open/floor/mineral/titanium,
/area/shuttle/exploration)
"wh" = (
/turf/closed/wall/mineral/titanium/nodiagonal,
/area/shuttle/exploration)
"wx" = (
/obj/structure/chair/comfy/shuttle{
	dir = 1
	},
/turf/open/floor/carpet/blue,
/area/shuttle/exploration)
"wX" = (
/obj/effect/spawner/structure/window/shuttle,
/turf/open/floor/plating,
/area/shuttle/exploration)
"xm" = (
/obj/structure/flora/ausbushes/fullgrass,
/obj/structure/flora/ausbushes/grassybush{
	pixel_x = -2
	},
/obj/structure/flora/ausbushes/grassybush,
/obj/structure/flora/ausbushes/lavendergrass,
/obj/structure/flora/ausbushes/stalkybush{
	pixel_x = 16;
	pixel_y = 26
	},
/obj/structure/flora/ausbushes/brflowers,
/obj/machinery/light/floor,
/turf/open/floor/grass,
/area/shuttle/exploration)
"xt" = (
/obj/machinery/computer/objective,
/obj/effect/turf_decal/bot,
/turf/open/floor/carpet/blue,
/area/shuttle/exploration)
"xO" = (
/obj/structure/railing/corner{
	dir = 4
	},
/obj/effect/turf_decal/loading_area,
/turf/open/floor/plasteel/techmaint,
/area/shuttle/exploration)
"yu" = (
/obj/effect/turf_decal/stripes/line{
	dir = 1
	},
/obj/machinery/atmospherics/pipe/manifold/purple/visible,
/turf/open/floor/plasteel/techmaint,
/area/shuttle/exploration)
"yE" = (
/obj/machinery/button/door{
	desc = "A remote control switch.";
	id = "exploration";
	name = "Exploration Shuttle Shutters";
	pixel_x = -24
	},
/obj/effect/turf_decal/bot,
/turf/open/floor/mineral/plastitanium,
/area/shuttle/exploration)
"zn" = (
/obj/machinery/atmospherics/pipe/simple/dark/hidden{
	dir = 4
	},
/turf/closed/wall/mineral/titanium/nodiagonal,
/area/shuttle/exploration)
"zW" = (
/obj/effect/turf_decal/tile/neutral{
	dir = 1
	},
/obj/effect/turf_decal/tile/neutral,
/turf/open/floor/plasteel,
/area/shuttle/exploration)
"Ay" = (
/obj/machinery/atmospherics/pipe/manifold/purple/visible{
	dir = 1
	},
/obj/effect/turf_decal/stripes/line,
/turf/open/floor/plasteel/techmaint,
/area/shuttle/exploration)
"BH" = (
/obj/effect/turf_decal/delivery,
/obj/structure/reagent_dispensers/fueltank,
/turf/open/floor/mineral/plastitanium,
/area/shuttle/exploration)
"CE" = (
/obj/structure/table,
/obj/item/paper_bin{
	pixel_x = -1;
	pixel_y = 5
	},
/obj/item/pen{
	pixel_x = -4
	},
/turf/open/floor/carpet/blue,
/area/shuttle/exploration)
"CN" = (
/obj/machinery/light,
/turf/open/floor/carpet/blue,
/area/shuttle/exploration)
"CT" = (
/obj/effect/turf_decal/tile/red{
	dir = 1
	},
/obj/effect/turf_decal/tile/red,
/obj/effect/turf_decal/tile/yellow{
	dir = 4
	},
/obj/effect/turf_decal/tile/yellow{
	dir = 8
	},
/obj/structure/chair/stool/bar,
/turf/open/floor/plasteel,
/area/shuttle/exploration)
"DK" = (
/turf/closed/wall/mineral/titanium,
/area/shuttle/exploration)
"Fs" = (
/obj/effect/turf_decal/tile/red{
	dir = 1
	},
/obj/effect/turf_decal/tile/red,
/obj/effect/turf_decal/tile/yellow{
	dir = 4
	},
/obj/effect/turf_decal/tile/yellow{
	dir = 8
	},
/turf/open/floor/plasteel,
/area/shuttle/exploration)
"Ft" = (
/turf/open/floor/carpet/blue,
/area/shuttle/exploration)
"Gk" = (
/obj/effect/turf_decal/tile/red{
	dir = 1
	},
/obj/effect/turf_decal/tile/red,
/obj/effect/turf_decal/tile/yellow{
	dir = 4
	},
/obj/effect/turf_decal/tile/yellow{
	dir = 8
	},
/obj/structure/chair/sofa/corp/left{
	dir = 8
	},
/turf/open/floor/plasteel,
/area/shuttle/exploration)
"Hl" = (
/obj/machinery/atmospherics/pipe/simple/dark/hidden,
/turf/closed/wall/mineral/titanium/nodiagonal,
/area/shuttle/exploration)
"Ho" = (
/obj/effect/turf_decal/tile/neutral,
/turf/open/floor/plasteel,
/area/shuttle/exploration)
"Jp" = (
/obj/machinery/portable_atmospherics/canister/toxins,
/obj/machinery/atmospherics/components/unary/portables_connector/visible,
/obj/effect/turf_decal/box/corners{
	dir = 1
	},
/obj/effect/turf_decal/box/corners{
	dir = 8
	},
/turf/open/floor/plasteel/tech/grid,
/area/shuttle/exploration)
"JS" = (
/obj/machinery/door/airlock/shuttle,
/obj/machinery/door/firedoor,
/obj/effect/turf_decal/stripes/line,
/obj/effect/turf_decal/stripes/line{
	dir = 1
	},
/obj/effect/decal/cleanable/dirt/dust,
/turf/open/floor/mineral/titanium,
/area/shuttle/exploration)
"Ke" = (
/obj/structure/flora/ausbushes/grassybush,
/obj/structure/flora/ausbushes/sparsegrass,
/obj/structure/flora/ausbushes/sparsegrass{
	pixel_y = 12
	},
/obj/structure/flora/ausbushes/lavendergrass{
	pixel_x = -11;
	pixel_y = 15
	},
/obj/structure/flora/grass/green{
	pixel_x = 12;
	pixel_y = 4
	},
/turf/open/floor/grass,
/area/shuttle/exploration)
"KC" = (
/turf/template_noop,
/area/template_noop)
"KG" = (
/obj/effect/turf_decal/tile/red{
	dir = 1
	},
/obj/effect/turf_decal/tile/red,
/obj/effect/turf_decal/tile/yellow{
	dir = 4
	},
/obj/effect/turf_decal/tile/yellow{
	dir = 8
	},
/obj/structure/window/reinforced/spawner/north{
	pixel_y = 4
	},
/obj/structure/chair/sofa/corp,
/obj/effect/decal/cleanable/dirt/dust,
/turf/open/floor/plasteel,
/area/shuttle/exploration)
"Ld" = (
/obj/effect/turf_decal/tile/neutral{
	dir = 4
	},
/obj/structure/sign/poster/official/random{
	pixel_y = 32
	},
/obj/structure/closet/secure_closet/freezer/kitchen,
/turf/open/floor/plasteel,
/area/shuttle/exploration)
"MK" = (
/obj/structure/railing{
	dir = 4
	},
/turf/open/floor/plasteel/stairs/old,
/area/shuttle/exploration)
"MM" = (
/obj/effect/turf_decal/tile/red{
	dir = 1
	},
/obj/effect/turf_decal/tile/red,
/obj/effect/turf_decal/tile/yellow{
	dir = 4
	},
/obj/effect/turf_decal/tile/yellow{
	dir = 8
	},
/mob/living/simple_animal/chicken/turkey{
	atmos_requirements = list("min_oxy" = 0, "max_oxy" = 0, "min_tox" = 0, "max_tox" = 0, "min_co2" = 0, "max_co2" = 0, "min_n2" = 0, "max_n2" = 0);
	desc = "A veteran of Nanotrasen's Animal Experimentation Program that attempted to replicate the organic space suit that some hostile entities are known to have exhibited, Tom now serves Nanotrasen as the mascot of the Exploration Crew.";
	health = 200;
	maxHealth = 200;
	melee_damage = 5;
	minbodytemp = 2.7;
	name = "Tom"
	},
/turf/open/floor/plasteel,
/area/shuttle/exploration)
"NB" = (
/turf/open/floor/mineral/plastitanium,
/area/shuttle/exploration)
"NM" = (
/obj/effect/turf_decal/tile/red{
	dir = 1
	},
/obj/effect/turf_decal/tile/red,
/obj/effect/turf_decal/tile/yellow{
	dir = 4
	},
/obj/effect/turf_decal/tile/yellow{
	dir = 8
	},
/obj/structure/table,
/obj/item/reagent_containers/food/drinks/beer/almost_empty{
	pixel_x = 6;
	pixel_y = 13
	},
/obj/item/reagent_containers/food/drinks/beer/almost_empty{
	pixel_x = -8;
	pixel_y = 2
	},
/obj/item/toy/cards/deck{
	pixel_x = 2
	},
/turf/open/floor/plasteel,
/area/shuttle/exploration)
"NN" = (
/obj/effect/turf_decal/stripes/line{
	dir = 9
	},
/turf/open/floor/plasteel/techmaint,
/area/shuttle/exploration)
"OB" = (
/obj/structure/railing{
	dir = 8
	},
/obj/machinery/light/small{
	dir = 2
	},
/obj/effect/decal/cleanable/dirt/dust,
/turf/open/floor/mineral/plastitanium,
/area/shuttle/exploration)
"OP" = (
/obj/structure/table/reinforced,
/obj/item/stack/sheet/mineral/plasma/fifty{
	pixel_x = 3;
	pixel_y = -3
	},
/obj/item/circuitboard/computer/exploration_shuttle{
	pixel_x = -4;
	pixel_y = 6
	},
/obj/effect/decal/cleanable/dirt/dust,
/turf/open/floor/plasteel/techmaint,
/area/shuttle/exploration)
"OS" = (
/obj/structure/railing/corner{
	dir = 1
	},
/obj/effect/turf_decal/loading_area,
/turf/open/floor/plasteel/techmaint,
/area/shuttle/exploration)
"Ph" = (
/obj/machinery/computer/crew,
/obj/effect/turf_decal/bot,
/obj/effect/decal/cleanable/dirt/dust,
/turf/open/floor/carpet/blue,
/area/shuttle/exploration)
"Pj" = (
/obj/structure/tank_dispenser/oxygen,
/obj/effect/turf_decal/delivery,
/turf/open/floor/plasteel,
/area/shuttle/exploration)
"Pu" = (
/obj/effect/turf_decal/tile/neutral{
	dir = 4
	},
/turf/open/floor/plasteel,
/area/shuttle/exploration)
"PF" = (
/obj/machinery/atmospherics/pipe/simple/dark/hidden{
	dir = 5
	},
/turf/closed/wall/mineral/titanium/nodiagonal,
/area/shuttle/exploration)
"PR" = (
/obj/structure/railing{
	dir = 8
	},
/turf/open/floor/plasteel/stairs/old,
/area/shuttle/exploration)
"QE" = (
/obj/machinery/atmospherics/pipe/manifold/purple/visible{
	dir = 1
	},
/obj/effect/turf_decal/stripes/line,
/obj/structure/cable/yellow{
	icon_state = "1-4"
	},
/turf/open/floor/plasteel/techmaint,
/area/shuttle/exploration)
"QK" = (
/obj/machinery/shuttle/engine/plasma{
	dir = 1
	},
/turf/open/floor/plating,
/area/shuttle/exploration)
"Rf" = (
/obj/machinery/atmospherics/components/unary/tank/air{
	dir = 4;
	initialize_directions = 4
	},
/obj/effect/turf_decal/delivery,
/turf/open/floor/mineral/plastitanium,
/area/shuttle/exploration)
"Rh" = (
/obj/machinery/atmospherics/pipe/simple/purple/visible{
	dir = 5
	},
/obj/effect/turf_decal/stripes/line{
	dir = 1
	},
/turf/open/floor/plasteel/techmaint,
/area/shuttle/exploration)
"Rv" = (
/obj/structure/table/reinforced,
/obj/machinery/microwave{
	pixel_y = 6
	},
/obj/machinery/light{
	dir = 8
	},
/obj/effect/turf_decal/tile/neutral{
	dir = 1
	},
/turf/open/floor/plasteel,
/area/shuttle/exploration)
"RD" = (
/obj/machinery/door/airlock/external/glass,
/obj/machinery/atmospherics/pipe/simple/dark/hidden{
	dir = 10
	},
/obj/effect/turf_decal/stripes/line{
	dir = 8
	},
/obj/effect/turf_decal/stripes/line{
	dir = 4
	},
/turf/open/floor/mineral/plastitanium,
/area/shuttle/exploration)
"RN" = (
/obj/structure/table/reinforced,
/obj/item/clothing/head/welding{
	pixel_x = 4;
	pixel_y = 7
	},
/obj/item/gps/mining{
	pixel_x = -9
	},
/obj/machinery/light/small{
	dir = 4;
	pixel_y = -5
	},
/turf/open/floor/plasteel/techmaint,
/area/shuttle/exploration)
"Sa" = (
/obj/effect/turf_decal/tile/neutral{
	dir = 1
	},
/turf/open/floor/plasteel,
/area/shuttle/exploration)
"Sh" = (
/obj/machinery/atmospherics/pipe/simple/purple/visible{
	dir = 6
	},
/obj/effect/turf_decal/stripes/line,
/turf/open/floor/plasteel/techmaint,
/area/shuttle/exploration)
"Sk" = (
/turf/closed/wall/mineral/plastitanium/nodiagonal,
/area/shuttle/exploration)
"Sr" = (
/obj/effect/turf_decal/stripes/line{
	dir = 5
	},
/obj/machinery/atmospherics/pipe/simple/purple/visible{
	dir = 10
	},
/obj/structure/chair/office/light{
	dir = 4
	},
/turf/open/floor/plasteel/techmaint,
/area/shuttle/exploration)
"SH" = (
/obj/machinery/light/small{
	dir = 8
	},
/obj/effect/decal/cleanable/dirt/dust,
/turf/open/floor/mineral/titanium,
/area/shuttle/exploration)
"ST" = (
/obj/machinery/atmospherics/pipe/manifold/purple/visible{
	dir = 1
	},
/obj/effect/turf_decal/stripes/line,
/obj/structure/cable/yellow{
	icon_state = "4-8"
	},
/turf/open/floor/plasteel/techmaint,
/area/shuttle/exploration)
"Th" = (
/obj/effect/turf_decal/box,
/obj/machinery/atmospherics/components/unary/plasma_refiner,
/obj/effect/decal/cleanable/dirt/dust,
/turf/open/floor/plasteel/techmaint,
/area/shuttle/exploration)
"Ua" = (
/obj/machinery/door/airlock/shuttle,
/obj/machinery/door/firedoor,
/obj/effect/turf_decal/stripes/line,
/obj/effect/turf_decal/stripes/line{
	dir = 1
	},
/turf/open/floor/noslip/dark,
/area/shuttle/exploration)
"Ug" = (
/obj/effect/turf_decal/tile/red{
	dir = 1
	},
/obj/effect/turf_decal/tile/red,
/obj/effect/turf_decal/tile/yellow{
	dir = 4
	},
/obj/effect/turf_decal/tile/yellow{
	dir = 8
	},
/obj/structure/table,
/obj/machinery/recharger{
	pixel_x = 1;
	pixel_y = 3
	},
/turf/open/floor/plasteel,
/area/shuttle/exploration)
"US" = (
/obj/machinery/portable_atmospherics/canister/toxins,
/obj/machinery/atmospherics/components/unary/portables_connector/visible,
/obj/effect/turf_decal/box/corners,
/obj/effect/turf_decal/box/corners{
	dir = 4
	},
/turf/open/floor/plasteel/tech/grid,
/area/shuttle/exploration)
"Ve" = (
/obj/effect/turf_decal/tile/red{
	dir = 1
	},
/obj/effect/turf_decal/tile/red,
/obj/effect/turf_decal/tile/yellow{
	dir = 4
	},
/obj/effect/turf_decal/tile/yellow{
	dir = 8
	},
/obj/structure/window/reinforced/spawner/north{
	pixel_y = 4
	},
/obj/structure/chair/sofa/corp/corner{
	dir = 4
	},
/obj/effect/decal/cleanable/dirt/dust,
/turf/open/floor/plasteel,
/area/shuttle/exploration)
"Wo" = (
/obj/structure/flora/ausbushes/grassybush,
/obj/structure/flora/ausbushes/sparsegrass,
/obj/structure/flora/ausbushes/lavendergrass,
/obj/structure/flora/ausbushes/ywflowers,
/turf/open/floor/grass,
/area/shuttle/exploration)
"Wq" = (
/obj/machinery/computer/shuttle_flight/custom_shuttle/exploration,
/obj/effect/turf_decal/bot,
/turf/open/floor/carpet/blue,
/area/shuttle/exploration)
"WA" = (
/obj/structure/railing/corner{
	dir = 8
	},
/obj/machinery/door/window/westleft{
	pixel_x = -6
	},
/obj/effect/turf_decal/tile/neutral,
/turf/open/floor/plasteel,
/area/shuttle/exploration)
"WT" = (
/obj/structure/window/reinforced/spawner/north{
	pixel_y = 4
	},
/obj/machinery/suit_storage_unit/exploration,
/obj/effect/turf_decal/delivery,
/turf/open/floor/plasteel,
/area/shuttle/exploration)
"Xo" = (
/obj/item/kirbyplants/random,
/obj/machinery/light{
	dir = 4
	},
/obj/effect/decal/cleanable/dirt/dust,
/turf/open/floor/mineral/titanium,
/area/shuttle/exploration)
"XE" = (
/obj/machinery/door/airlock/shuttle,
/obj/machinery/door/firedoor,
/obj/effect/turf_decal/stripes/line{
	dir = 8
	},
/obj/effect/turf_decal/stripes/line{
	dir = 4
	},
/turf/open/floor/mineral/titanium,
/area/shuttle/exploration)
"XU" = (
/obj/effect/turf_decal/delivery,
/obj/machinery/computer/cargo/request{
	dir = 4
	},
/turf/open/floor/mineral/plastitanium,
/area/shuttle/exploration)
"Yr" = (
/obj/machinery/door/window/westleft{
	pixel_x = -6
	},
/turf/open/floor/plasteel,
/area/shuttle/exploration)
"Za" = (
/obj/machinery/portable_atmospherics/canister/toxins,
/obj/machinery/atmospherics/components/unary/portables_connector/visible,
/obj/effect/decal/cleanable/dirt/dust,
/turf/open/floor/plasteel/tech/grid,
/area/shuttle/exploration)
"ZN" = (
/obj/machinery/atmospherics/pipe/simple/dark/hidden{
	dir = 9
	},
/turf/closed/wall/mineral/titanium/nodiagonal,
/area/shuttle/exploration)
"ZX" = (
/obj/structure/table/reinforced,
/obj/item/storage/bag/tray,
/obj/effect/turf_decal/tile/neutral{
	dir = 1
	},
/turf/open/floor/plasteel,
/area/shuttle/exploration)

(1,1,1) = {"
KC
KC
DK
wh
wh
wh
wh
wh
uJ
Hl
PF
wh
wh
wh
wh
wh
wh
Sk
bT
KC
"}
(2,1,1) = {"
DK
wh
wh
BH
rq
XU
wh
df
iQ
Rf
zn
Pj
ew
WT
wh
wh
ak
Sk
bT
KC
"}
(3,1,1) = {"
wh
jI
yE
NB
gr
OB
wh
wh
RD
mA
ZN
Pu
Yr
WA
PR
OS
NN
bB
Sk
bT
"}
(4,1,1) = {"
wh
aA
aA
NB
NB
NB
Ua
ov
av
SH
pA
Ho
ns
jp
MK
xO
cp
Sh
ay
QK
"}
(5,1,1) = {"
DK
jf
oG
jf
wh
wh
wh
wh
tP
wh
wh
wh
wh
XE
wh
wh
cp
Ay
ay
QK
"}
(6,1,1) = {"
KC
KC
KC
KC
KC
wX
xt
jB
Ft
wh
Rv
tU
wh
av
wh
Jp
Rh
Ay
ay
QK
"}
(7,1,1) = {"
KC
KC
KC
KC
KC
wX
Wq
wx
CN
wh
eZ
Sa
JS
av
wh
Za
sP
Ay
ay
QK
"}
(8,1,1) = {"
KC
KC
KC
KC
KC
wX
Ph
CE
cd
wh
Ld
zW
wh
vp
wh
US
sP
Ay
ay
QK
"}
(9,1,1) = {"
KC
KC
KC
DK
wh
wh
wX
wX
tP
wh
ZX
fh
wh
aM
wh
wh
mU
QE
ay
QK
"}
(10,1,1) = {"
KC
KC
KC
wX
cb
xm
Ve
pP
Fs
pV
CT
CT
wh
am
wh
Th
yu
ST
ay
QK
"}
(11,1,1) = {"
KC
KC
KC
wX
gI
Ke
KG
NM
MM
Fs
dZ
Fs
pA
av
wh
lM
Sr
aq
Sk
bT
"}
(12,1,1) = {"
KC
KC
KC
wX
Wo
jd
ce
Gk
Fs
Fs
Ug
aB
wh
Xo
wh
RN
OP
Sk
bT
KC
"}
(13,1,1) = {"
KC
KC
KC
DK
wh
DK
wh
wh
wX
wX
wX
wh
wh
wh
wh
wh
wh
Sk
bT
KC
"}
