//MAP CONVERTED BY dmm2tgm.py THIS HEADER COMMENT PREVENTS RECONVERSION, DO NOT REMOVE
"aA" = (
/obj/machinery/atmospherics/components/unary/portables_connector/visible{
	dir = 4
	},
/obj/effect/turf_decal/delivery{
	dir = 4
	},
/turf/open/floor/plating,
/area/shuttle/exploration)
"aP" = (
/obj/effect/turf_decal/delivery{
	dir = 4
	},
/obj/machinery/atmospherics/components/unary/portables_connector/visible{
	dir = 1
	},
/obj/machinery/portable_atmospherics/canister/air{
	dir = 1
	},
/turf/open/floor/mineral/titanium/purple,
/area/shuttle/exploration)
"aV" = (
/obj/structure/extinguisher_cabinet{
	pixel_x = -25;
	dir = 1
	},
/obj/machinery/atmospherics/components/unary/vent_pump/on{
	dir = 1
	},
/turf/open/floor/mineral/plastitanium,
/area/shuttle/exploration)
"bb" = (
/obj/machinery/atmospherics/components/binary/dp_vent_pump{
	dir = 2
	},
/obj/effect/turf_decal/stripes/line{
	dir = 1
	},
/obj/effect/turf_decal/stripes/line{
	dir = 2
	},
/turf/open/floor/mineral/titanium,
/area/shuttle/exploration)
"bA" = (
/obj/structure/closet/crate{
	dir = 1
	},
/obj/item/radio/headset/headset_exploration{
	dir = 1
	},
/obj/item/radio/headset/headset_exploration{
	dir = 1
	},
/obj/item/wrench{
	dir = 1
	},
/obj/item/pickaxe{
	dir = 1
	},
/obj/item/mining_scanner{
	dir = 1
	},
/obj/effect/turf_decal/bot{
	dir = 4
	},
/turf/open/floor/mineral/plastitanium,
/area/shuttle/exploration)
"bS" = (
/obj/machinery/holopad{
	dir = 1
	},
/obj/machinery/atmospherics/pipe/simple/supply/hidden{
	dir = 4
	},
/obj/machinery/atmospherics/pipe/simple/scrubbers/hidden{
	dir = 1
	},
/turf/open/floor/mineral/titanium,
/area/shuttle/exploration)
"ce" = (
/obj/machinery/door/airlock/shuttle{
	dir = 1
	},
/obj/machinery/atmospherics/pipe/simple/supply/hidden{
	dir = 4
	},
/turf/open/floor/mineral/titanium,
/area/shuttle/exploration)
"cr" = (
/obj/machinery/atmospherics/pipe/manifold4w/scrubbers/hidden{
	dir = 1
	},
/turf/open/floor/mineral/titanium,
/area/shuttle/exploration)
"cG" = (
/obj/effect/turf_decal/stripes/corner{
	dir = 4
	},
/turf/open/floor/mineral/titanium,
/area/shuttle/exploration)
"df" = (
/turf/closed/wall/mineral/titanium/nodiagonal,
/area/shuttle/exploration)
"dq" = (
/obj/effect/turf_decal/stripes/corner{
	dir = 8
	},
/turf/open/floor/mineral/plastitanium,
/area/shuttle/exploration)
"dv" = (
/obj/machinery/atmospherics/pipe/manifold/purple/visible{
	dir = 4
	},
/obj/effect/turf_decal/stripes/line{
	dir = 8
	},
/obj/effect/turf_decal/stripes/corner{
	dir = 4
	},
/turf/open/floor/mineral/titanium,
/area/shuttle/exploration)
"dN" = (
/obj/machinery/door/airlock/external/glass{
	dir = 1
	},
/obj/machinery/atmospherics/pipe/simple/supply/hidden{
	dir = 1
	},
/obj/effect/turf_decal/delivery{
	dir = 4
	},
/obj/effect/mapping_helpers/airlock/cyclelink_helper{
	dir = 2
	},
/turf/open/floor/mineral/titanium,
/area/shuttle/exploration)
"dS" = (
/obj/machinery/atmospherics/components/binary/pump/on{
	dir = 4
	},
/obj/effect/turf_decal/stripes/corner{
	dir = 2
	},
/obj/effect/turf_decal/stripes/corner{
	dir = 8
	},
/turf/open/floor/mineral/titanium,
/area/shuttle/exploration)
"eN" = (
/mob/living/simple_animal/chicken/turkey{
	atmos_requirements = list("min_oxy" = 0, "max_oxy" = 0, "min_tox" = 0, "max_tox" = 0, "min_co2" = 0, "max_co2" = 0, "min_n2" = 0, "max_n2" = 0);
	desc = "A veteran of Nanotrasen's Animal Experimentation Program that attempted to replicate the organic space suit that some hostile entities are known to have exhibited, Tom now serves Nanotrasen as the mascot of the Exploration Crew.";
	health = 200;
	maxHealth = 200;
	melee_damage = 5;
	minbodytemp = 2.7;
	name = "Tom"
	},
/turf/open/floor/mineral/titanium,
/area/shuttle/exploration)
"fy" = (
/obj/machinery/atmospherics/pipe/simple/scrubbers/hidden{
	dir = 1
	},
/turf/open/floor/mineral/titanium,
/area/shuttle/exploration)
"fO" = (
/turf/open/floor/mineral/titanium,
/area/shuttle/exploration)
"fU" = (
/obj/machinery/atmospherics/pipe/simple/supply/hidden{
	dir = 6
	},
/turf/open/floor/mineral/titanium,
/area/shuttle/exploration)
"gJ" = (
/turf/closed/wall/mineral/titanium,
/area/shuttle/exploration)
"gM" = (
/obj/machinery/atmospherics/pipe/simple/scrubbers/hidden{
	dir = 1
	},
/obj/effect/turf_decal/stripes/line{
	dir = 1
	},
/obj/effect/turf_decal/stripes/line{
	dir = 2
	},
/turf/open/floor/mineral/titanium,
/area/shuttle/exploration)
"gS" = (
/obj/effect/turf_decal/bot{
	dir = 4
	},
/obj/machinery/power/port_gen/pacman{
	dir = 1
	},
/obj/structure/cable/yellow{
	icon_state = "0-2"
	},
/turf/open/floor/plating,
/area/shuttle/exploration)
"gW" = (
/obj/machinery/atmospherics/pipe/simple/supply/hidden{
	dir = 4
	},
/obj/machinery/atmospherics/pipe/simple/scrubbers/hidden{
	dir = 1
	},
/turf/open/floor/mineral/titanium,
/area/shuttle/exploration)
"hc" = (
/obj/machinery/camera/autoname{
	dir = 8;
	name = "Exploration Shuttle";
	network = list("exploration shuttle")
	},
/obj/machinery/atmospherics/pipe/manifold/supply/hidden{
	dir = 4
	},
/obj/machinery/light{
	dir = 4
	},
/obj/effect/turf_decal/stripes/line{
	dir = 4
	},
/turf/open/floor/mineral/titanium,
/area/shuttle/exploration)
"hP" = (
/obj/machinery/atmospherics/components/unary/portables_connector/visible{
	dir = 4
	},
/obj/effect/turf_decal/delivery{
	dir = 4
	},
/obj/machinery/light{
	dir = 8
	},
/turf/open/floor/plating,
/area/shuttle/exploration)
"hW" = (
/obj/machinery/atmospherics/pipe/simple/scrubbers/hidden{
	dir = 4
	},
/turf/closed/wall/mineral/titanium/nodiagonal,
/area/shuttle/exploration)
"iG" = (
/obj/structure/chair/comfy/shuttle{
	dir = 1
	},
/turf/open/floor/mineral/plastitanium,
/area/shuttle/exploration)
"iT" = (
/obj/machinery/computer/rdconsole{
	dir = 1
	},
/obj/effect/turf_decal/delivery{
	dir = 4
	},
/turf/open/floor/mineral/plastitanium,
/area/shuttle/exploration)
"jt" = (
/obj/machinery/portable_atmospherics/canister/toxins{
	dir = 1
	},
/obj/effect/turf_decal/bot{
	dir = 4
	},
/turf/open/floor/mineral/plastitanium,
/area/shuttle/exploration)
"jB" = (
/obj/effect/spawner/structure/window/shuttle{
	dir = 1
	},
/turf/open/floor/plating,
/area/shuttle/exploration)
"jO" = (
/obj/effect/turf_decal/delivery{
	dir = 4
	},
/obj/machinery/light{
	dir = 8
	},
/obj/machinery/suit_storage_unit/open{
	dir = 1
	},
/turf/open/floor/mineral/plastitanium,
/area/shuttle/exploration)
"jR" = (
/obj/structure/extinguisher_cabinet{
	pixel_x = 25;
	dir = 1
	},
/obj/machinery/light{
	dir = 4
	},
/turf/open/floor/mineral/plastitanium,
/area/shuttle/exploration)
"jS" = (
/obj/machinery/atmospherics/pipe/simple/purple/visible{
	dir = 10
	},
/obj/effect/turf_decal/stripes/corner{
	dir = 2
	},
/obj/machinery/light{
	dir = 4
	},
/turf/open/floor/mineral/titanium,
/area/shuttle/exploration)
"ka" = (
/obj/effect/turf_decal/stripes/line{
	dir = 1
	},
/turf/open/floor/mineral/plastitanium,
/area/shuttle/exploration)
"kx" = (
/obj/machinery/computer/security{
	dir = 1
	},
/obj/effect/turf_decal/delivery{
	dir = 4
	},
/turf/open/floor/mineral/plastitanium,
/area/shuttle/exploration)
"kH" = (
/obj/effect/turf_decal/bot{
	dir = 4
	},
/turf/open/floor/mineral/plastitanium,
/area/shuttle/exploration)
"kI" = (
/obj/effect/turf_decal/stripes/line{
	dir = 8
	},
/obj/effect/turf_decal/stripes/line{
	dir = 4
	},
/obj/machinery/door/airlock/shuttle{
	dir = 1
	},
/obj/effect/turf_decal/delivery{
	dir = 4
	},
/turf/open/floor/mineral/plastitanium,
/area/shuttle/exploration)
"kO" = (
/obj/structure/chair/comfy/shuttle{
	dir = 2
	},
/turf/open/floor/mineral/plastitanium,
/area/shuttle/exploration)
"lc" = (
/obj/machinery/atmospherics/components/trinary/mixer/airmix/flipped{
	dir = 1
	},
/turf/open/floor/mineral/titanium,
/area/shuttle/exploration)
"lg" = (
/obj/machinery/atmospherics/pipe/simple/supply/hidden{
	dir = 5
	},
/turf/open/floor/mineral/titanium,
/area/shuttle/exploration)
"lY" = (
/obj/machinery/portable_atmospherics/canister/toxins{
	dir = 1
	},
/turf/open/floor/mineral/plastitanium,
/area/shuttle/exploration)
"mb" = (
/obj/machinery/atmospherics/components/unary/shuttle/heater{
	dir = 4
	},
/obj/structure/window/reinforced/survival_pod{
	dir = 4
	},
/turf/open/floor/engine,
/area/shuttle/exploration)
"mk" = (
/obj/machinery/door/airlock/external/glass{
	dir = 1
	},
/obj/machinery/atmospherics/pipe/simple/supply/hidden{
	dir = 1
	},
/obj/effect/turf_decal/delivery{
	dir = 4
	},
/obj/effect/mapping_helpers/airlock/cyclelink_helper{
	dir = 1
	},
/turf/open/floor/mineral/titanium,
/area/shuttle/exploration)
"ml" = (
/obj/effect/turf_decal/bot{
	dir = 4
	},
/obj/structure/tank_dispenser/oxygen{
	dir = 1
	},
/turf/open/floor/mineral/plastitanium,
/area/shuttle/exploration)
"mr" = (
/obj/machinery/atmospherics/pipe/manifold/supply/hidden{
	dir = 8
	},
/obj/machinery/light{
	dir = 8
	},
/obj/effect/turf_decal/stripes/line{
	dir = 8
	},
/turf/open/floor/mineral/titanium,
/area/shuttle/exploration)
"mL" = (
/obj/machinery/computer/objective{
	dir = 2
	},
/obj/effect/turf_decal/delivery{
	dir = 4
	},
/turf/open/floor/mineral/plastitanium,
/area/shuttle/exploration)
"mR" = (
/obj/machinery/door/airlock/external/glass{
	dir = 1
	},
/obj/machinery/atmospherics/pipe/simple/scrubbers/hidden{
	dir = 6
	},
/obj/effect/turf_decal/delivery{
	dir = 4
	},
/obj/effect/mapping_helpers/airlock/cyclelink_helper{
	dir = 2
	},
/turf/open/floor/mineral/titanium,
/area/shuttle/exploration)
"nu" = (
/obj/structure/extinguisher_cabinet{
	pixel_y = -29;
	dir = 1
	},
/turf/open/floor/mineral/titanium,
/area/shuttle/exploration)
"nF" = (
/obj/machinery/atmospherics/pipe/manifold/dark/visible{
	dir = 1
	},
/obj/effect/turf_decal/stripes/line{
	dir = 2
	},
/turf/open/floor/mineral/titanium,
/area/shuttle/exploration)
"nK" = (
/obj/machinery/atmospherics/pipe/simple/scrubbers/hidden{
	dir = 9
	},
/obj/effect/turf_decal/stripes/corner{
	dir = 8
	},
/turf/open/floor/mineral/titanium,
/area/shuttle/exploration)
"nY" = (
/obj/structure/chair/comfy/shuttle{
	dir = 4
	},
/turf/open/floor/mineral/plastitanium,
/area/shuttle/exploration)
"om" = (
/obj/machinery/atmospherics/pipe/simple/scrubbers/hidden{
	dir = 10
	},
/obj/effect/turf_decal/stripes/corner{
	dir = 1
	},
/turf/open/floor/mineral/titanium,
/area/shuttle/exploration)
"pd" = (
/obj/machinery/atmospherics/pipe/manifold/supply/hidden{
	dir = 4
	},
/obj/effect/turf_decal/caution{
	dir = 4
	},
/obj/effect/turf_decal/stripes/line{
	dir = 2
	},
/turf/open/floor/mineral/titanium,
/area/shuttle/exploration)
"pi" = (
/obj/effect/turf_decal/delivery{
	dir = 4
	},
/obj/machinery/suit_storage_unit/open{
	dir = 1
	},
/turf/open/floor/mineral/plastitanium,
/area/shuttle/exploration)
"pR" = (
/obj/structure/table{
	dir = 1
	},
/obj/item/toy/cards/deck/unum{
	dir = 1
	},
/turf/open/floor/mineral/titanium/blue,
/area/shuttle/exploration)
"pT" = (
/obj/effect/turf_decal/stripes/line{
	dir = 2
	},
/turf/open/floor/mineral/plastitanium,
/area/shuttle/exploration)
"qJ" = (
/obj/machinery/atmospherics/pipe/simple/purple/visible{
	dir = 9
	},
/obj/structure/extinguisher_cabinet{
	pixel_x = 24;
	dir = 1
	},
/obj/machinery/light{
	dir = 4
	},
/obj/structure/cable/yellow{
	icon_state = "1-2"
	},
/obj/structure/cable/yellow{
	icon_state = "2-8"
	},
/turf/open/floor/mineral/titanium,
/area/shuttle/exploration)
"sh" = (
/obj/effect/spawner/structure/window/shuttle{
	dir = 1
	},
/obj/machinery/atmospherics/pipe/simple/scrubbers/visible{
	dir = 1
	},
/turf/open/floor/plating,
/area/shuttle/exploration)
"sD" = (
/obj/machinery/computer/shuttle_flight/custom_shuttle/exploration{
	dir = 8
	},
/obj/effect/turf_decal/delivery{
	dir = 4
	},
/turf/open/floor/mineral/plastitanium,
/area/shuttle/exploration)
"sO" = (
/obj/machinery/atmospherics/pipe/simple/scrubbers/hidden{
	dir = 6
	},
/obj/effect/turf_decal/stripes/line{
	dir = 2
	},
/turf/open/floor/mineral/titanium,
/area/shuttle/exploration)
"sY" = (
/obj/machinery/atmospherics/pipe/manifold/dark/visible{
	dir = 8
	},
/obj/machinery/airalarm/unlocked{
	dir = 4;
	pixel_x = -24
	},
/obj/machinery/light{
	dir = 8
	},
/obj/effect/turf_decal/stripes/line{
	dir = 2
	},
/turf/open/floor/mineral/titanium,
/area/shuttle/exploration)
"te" = (
/obj/machinery/atmospherics/pipe/simple/supply/hidden{
	dir = 4
	},
/turf/open/floor/mineral/titanium,
/area/shuttle/exploration)
"tt" = (
/obj/machinery/computer/crew{
	dir = 2
	},
/obj/effect/turf_decal/delivery{
	dir = 4
	},
/turf/open/floor/mineral/plastitanium,
/area/shuttle/exploration)
"tD" = (
/obj/machinery/atmospherics/pipe/simple/supply/hidden{
	dir = 1
	},
/obj/machinery/atmospherics/pipe/simple/scrubbers/hidden{
	dir = 4
	},
/obj/effect/turf_decal/caution{
	dir = 8
	},
/obj/effect/turf_decal/stripes/line{
	dir = 1
	},
/turf/open/floor/mineral/titanium,
/area/shuttle/exploration)
"um" = (
/obj/item/storage/toolbox/mechanical{
	dir = 1
	},
/obj/machinery/power/smes{
	charge = 1e+006;
	dir = 1
	},
/obj/structure/cable/yellow{
	icon_state = "0-1"
	},
/turf/open/floor/mineral/titanium,
/area/shuttle/exploration)
"up" = (
/obj/machinery/atmospherics/pipe/manifold4w/purple/visible{
	dir = 1
	},
/obj/effect/turf_decal/stripes/line{
	dir = 8
	},
/turf/open/floor/mineral/titanium,
/area/shuttle/exploration)
"uQ" = (
/obj/machinery/atmospherics/pipe/manifold/scrubbers/hidden{
	dir = 2
	},
/obj/effect/turf_decal/stripes/line{
	dir = 1
	},
/turf/open/floor/mineral/titanium,
/area/shuttle/exploration)
"vb" = (
/obj/effect/turf_decal/stripes/line{
	dir = 8
	},
/turf/open/floor/mineral/plastitanium,
/area/shuttle/exploration)
"ve" = (
/obj/machinery/atmospherics/components/binary/pump/on{
	dir = 2
	},
/turf/open/floor/mineral/titanium,
/area/shuttle/exploration)
"vx" = (
/obj/machinery/atmospherics/pipe/simple/purple/visible{
	dir = 1
	},
/obj/effect/turf_decal/stripes/line{
	dir = 8
	},
/turf/open/floor/mineral/titanium,
/area/shuttle/exploration)
"wc" = (
/obj/machinery/atmospherics/pipe/simple/dark/visible{
	dir = 4
	},
/turf/open/floor/mineral/titanium,
/area/shuttle/exploration)
"wo" = (
/obj/machinery/atmospherics/pipe/simple/scrubbers/hidden{
	dir = 1
	},
/obj/effect/turf_decal/stripes/line{
	dir = 2
	},
/obj/effect/turf_decal/stripes/line{
	dir = 1
	},
/turf/open/floor/mineral/titanium,
/area/shuttle/exploration)
"xl" = (
/obj/machinery/atmospherics/pipe/simple/scrubbers/hidden{
	dir = 6
	},
/turf/open/floor/mineral/titanium,
/area/shuttle/exploration)
"yh" = (
/turf/closed/wall/mineral/plastitanium/nodiagonal,
/area/shuttle/exploration)
"ym" = (
/obj/machinery/atmospherics/pipe/simple/purple/visible{
	dir = 10
	},
/obj/effect/turf_decal/stripes/corner{
	dir = 8
	},
/turf/open/floor/mineral/titanium,
/area/shuttle/exploration)
"yz" = (
/obj/machinery/atmospherics/components/trinary/filter/atmos/n2{
	dir = 2
	},
/turf/open/floor/mineral/titanium,
/area/shuttle/exploration)
"yM" = (
/obj/machinery/atmospherics/components/unary/outlet_injector/on{
	dir = 1
	},
/obj/effect/turf_decal/stripes/line{
	dir = 1
	},
/turf/open/floor/mineral/plastitanium,
/area/shuttle/exploration)
"zN" = (
/obj/machinery/atmospherics/pipe/manifold/purple/visible{
	dir = 4
	},
/obj/effect/turf_decal/stripes/line{
	dir = 8
	},
/turf/open/floor/mineral/titanium,
/area/shuttle/exploration)
"Ac" = (
/obj/machinery/door/airlock/external/glass{
	dir = 1
	},
/obj/machinery/atmospherics/pipe/simple/scrubbers/hidden{
	dir = 5
	},
/obj/effect/turf_decal/delivery{
	dir = 4
	},
/obj/effect/mapping_helpers/airlock/cyclelink_helper{
	dir = 1
	},
/turf/open/floor/mineral/titanium,
/area/shuttle/exploration)
"Af" = (
/obj/structure/chair/comfy/shuttle{
	dir = 2
	},
/obj/machinery/light{
	dir = 1
	},
/turf/open/floor/mineral/titanium/blue,
/area/shuttle/exploration)
"Ay" = (
/turf/closed/wall/mineral/plastitanium,
/area/shuttle/exploration)
"Az" = (
/obj/machinery/atmospherics/pipe/simple/scrubbers/hidden{
	dir = 4
	},
/turf/open/floor/mineral/titanium,
/area/shuttle/exploration)
"AN" = (
/obj/machinery/door/airlock/external/glass{
	dir = 1
	},
/obj/machinery/atmospherics/pipe/simple/scrubbers/hidden{
	dir = 10
	},
/obj/effect/turf_decal/delivery{
	dir = 4
	},
/obj/docking_port/mobile{
	dwidth = 6;
	height = 15;
	id = "exploration";
	name = "Exploration Shuttle";
	port_direction = 4;
	shuttle_object_type = /datum/orbital_object/shuttle/custom_shuttle;
	width = 23;
	dir = 2
	},
/obj/effect/mapping_helpers/airlock/cyclelink_helper{
	dir = 2
	},
/turf/open/floor/mineral/titanium,
/area/shuttle/exploration)
"AU" = (
/obj/effect/turf_decal/bot{
	dir = 4
	},
/obj/machinery/atmospherics/components/unary/plasma_refiner{
	dir = 4
	},
/turf/open/floor/plating,
/area/shuttle/exploration)
"Cc" = (
/obj/machinery/atmospherics/pipe/manifold4w/purple/visible{
	dir = 1
	},
/obj/effect/turf_decal/stripes/line{
	dir = 8
	},
/obj/structure/cable/yellow{
	icon_state = "1-4"
	},
/turf/open/floor/mineral/titanium,
/area/shuttle/exploration)
"Cu" = (
/obj/machinery/door/airlock/external/glass{
	dir = 1
	},
/obj/machinery/atmospherics/pipe/simple/scrubbers/hidden{
	dir = 1
	},
/obj/effect/turf_decal/delivery{
	dir = 4
	},
/obj/effect/mapping_helpers/airlock/cyclelink_helper{
	dir = 2
	},
/turf/open/floor/mineral/titanium,
/area/shuttle/exploration)
"CU" = (
/obj/machinery/door/airlock/external/glass{
	dir = 1
	},
/obj/machinery/atmospherics/pipe/simple/scrubbers/hidden{
	dir = 1
	},
/obj/effect/turf_decal/delivery{
	dir = 4
	},
/obj/effect/mapping_helpers/airlock/cyclelink_helper{
	dir = 1
	},
/turf/open/floor/mineral/titanium,
/area/shuttle/exploration)
"Dn" = (
/turf/open/floor/mineral/plastitanium,
/area/shuttle/exploration)
"Fr" = (
/obj/machinery/atmospherics/pipe/manifold/scrubbers/hidden{
	dir = 8
	},
/turf/open/floor/mineral/titanium,
/area/shuttle/exploration)
"Gb" = (
/obj/structure/table{
	dir = 1
	},
/obj/item/storage/toolbox/electrical{
	dir = 1
	},
/obj/item/gps/mining/exploration{
	dir = 1
	},
/obj/effect/turf_decal/bot{
	dir = 4
	},
/turf/open/floor/mineral/plastitanium,
/area/shuttle/exploration)
"Gt" = (
/obj/machinery/atmospherics/components/unary/vent_pump/on{
	dir = 1
	},
/obj/effect/turf_decal/stripes/line{
	dir = 4
	},
/turf/open/floor/mineral/titanium,
/area/shuttle/exploration)
"GI" = (
/obj/structure/closet/crate/science{
	dir = 1
	},
/obj/item/circuitboard/computer/shuttle/exploration_shuttle{
	dir = 1
	},
/obj/item/stack/sheet/mineral/plasma/five{
	dir = 1
	},
/obj/effect/turf_decal/bot{
	dir = 4
	},
/turf/open/floor/mineral/plastitanium,
/area/shuttle/exploration)
"Hm" = (
/obj/effect/turf_decal/delivery{
	dir = 4
	},
/obj/machinery/atmospherics/components/unary/portables_connector/visible{
	dir = 1
	},
/obj/machinery/portable_atmospherics/canister/air{
	dir = 1
	},
/obj/item/wrench{
	dir = 1
	},
/turf/open/floor/mineral/titanium/purple,
/area/shuttle/exploration)
"HG" = (
/obj/machinery/atmospherics/pipe/simple/supply/hidden{
	dir = 1
	},
/obj/effect/turf_decal/stripes/corner{
	dir = 1
	},
/turf/open/floor/mineral/titanium,
/area/shuttle/exploration)
"HU" = (
/obj/machinery/telecomms/relay/preset/exploration{
	dir = 1
	},
/obj/effect/turf_decal/delivery{
	dir = 4
	},
/turf/open/floor/mineral/plastitanium,
/area/shuttle/exploration)
"JG" = (
/obj/machinery/atmospherics/pipe/simple/purple/visible{
	dir = 10
	},
/obj/effect/turf_decal/stripes/line{
	dir = 9
	},
/obj/structure/cable/yellow{
	icon_state = "1-2"
	},
/turf/open/floor/mineral/titanium,
/area/shuttle/exploration)
"JP" = (
/obj/structure/table{
	dir = 1
	},
/obj/item/stack/sheet/mineral/plasma/five{
	dir = 1
	},
/turf/open/floor/mineral/titanium/blue,
/area/shuttle/exploration)
"JV" = (
/obj/machinery/atmospherics/pipe/simple/supply/hidden{
	dir = 10
	},
/turf/open/floor/mineral/titanium,
/area/shuttle/exploration)
"Kc" = (
/obj/machinery/atmospherics/pipe/simple/scrubbers/hidden{
	dir = 4
	},
/obj/effect/turf_decal/stripes/corner{
	dir = 4
	},
/turf/open/floor/mineral/titanium,
/area/shuttle/exploration)
"KX" = (
/obj/structure/table{
	dir = 1
	},
/obj/item/toy/cards/deck{
	dir = 1
	},
/turf/open/floor/mineral/titanium/blue,
/area/shuttle/exploration)
"Lc" = (
/obj/machinery/atmospherics/pipe/simple/purple/visible{
	dir = 9
	},
/obj/effect/turf_decal/stripes/line{
	dir = 10
	},
/turf/open/floor/mineral/titanium,
/area/shuttle/exploration)
"Ls" = (
/obj/machinery/atmospherics/pipe/simple/scrubbers/visible{
	dir = 1
	},
/turf/open/floor/mineral/titanium/purple,
/area/shuttle/exploration)
"LA" = (
/obj/machinery/atmospherics/pipe/simple/scrubbers/hidden{
	dir = 9
	},
/turf/open/floor/mineral/plastitanium,
/area/shuttle/exploration)
"LR" = (
/obj/structure/chair/comfy/shuttle{
	dir = 2
	},
/turf/open/floor/mineral/titanium/blue,
/area/shuttle/exploration)
"My" = (
/obj/machinery/atmospherics/pipe/simple/supply/hidden{
	dir = 1
	},
/turf/open/floor/mineral/plastitanium,
/area/shuttle/exploration)
"MF" = (
/obj/machinery/atmospherics/pipe/simple/supply/hidden{
	dir = 6
	},
/obj/effect/turf_decal/stripes/corner{
	dir = 2
	},
/turf/open/floor/mineral/titanium,
/area/shuttle/exploration)
"Nl" = (
/obj/machinery/atmospherics/pipe/simple/dark/visible{
	dir = 6
	},
/turf/open/floor/mineral/titanium,
/area/shuttle/exploration)
"NO" = (
/obj/machinery/door/airlock/external/glass{
	dir = 1
	},
/obj/machinery/atmospherics/pipe/simple/scrubbers/hidden{
	dir = 9
	},
/obj/effect/turf_decal/delivery{
	dir = 4
	},
/obj/effect/mapping_helpers/airlock/cyclelink_helper{
	dir = 1
	},
/turf/open/floor/mineral/titanium,
/area/shuttle/exploration)
"NZ" = (
/obj/machinery/atmospherics/pipe/simple/purple/visible{
	dir = 1
	},
/obj/effect/turf_decal/stripes/corner{
	dir = 1
	},
/obj/machinery/power/apc/auto_name/east{
	locked = 0;
	pixel_x = 24
	},
/obj/structure/cable/yellow{
	icon_state = "0-2"
	},
/turf/open/floor/mineral/titanium,
/area/shuttle/exploration)
"Of" = (
/obj/machinery/atmospherics/pipe/simple/scrubbers/hidden{
	dir = 1
	},
/obj/effect/turf_decal/stripes/corner{
	dir = 8
	},
/turf/open/floor/mineral/titanium,
/area/shuttle/exploration)
"PF" = (
/obj/structure/table{
	dir = 1
	},
/obj/item/toy/cards/deck/cas{
	dir = 1
	},
/obj/item/toy/cards/deck/cas/black{
	pixel_y = -3;
	dir = 1
	},
/obj/item/storage/box/donkpockets{
	dir = 1
	},
/obj/item/storage/box/donkpockets{
	dir = 1
	},
/turf/open/floor/mineral/titanium/blue,
/area/shuttle/exploration)
"QG" = (
/obj/machinery/shuttle/engine/plasma{
	dir = 4
	},
/turf/open/floor/engine,
/area/shuttle/exploration)
"QT" = (
/obj/machinery/atmospherics/pipe/manifold/supply/hidden{
	dir = 4
	},
/obj/effect/turf_decal/stripes/corner{
	dir = 8
	},
/turf/open/floor/mineral/titanium,
/area/shuttle/exploration)
"SG" = (
/obj/machinery/atmospherics/pipe/simple/supply/hidden{
	dir = 4
	},
/obj/item/beacon{
	dir = 1
	},
/turf/open/floor/mineral/titanium,
/area/shuttle/exploration)
"SO" = (
/obj/effect/turf_decal/stripes/corner{
	dir = 2
	},
/turf/open/floor/mineral/titanium,
/area/shuttle/exploration)
"SR" = (
/obj/structure/extinguisher_cabinet{
	pixel_x = 25;
	dir = 1
	},
/obj/machinery/atmospherics/pipe/simple/supply/hidden{
	dir = 1
	},
/obj/machinery/atmospherics/components/unary/vent_scrubber/on{
	dir = 8
	},
/obj/effect/turf_decal/stripes/line{
	dir = 4
	},
/turf/open/floor/mineral/titanium,
/area/shuttle/exploration)
"Tz" = (
/obj/structure/table{
	dir = 1
	},
/obj/machinery/microwave{
	dir = 1
	},
/turf/open/floor/mineral/titanium/blue,
/area/shuttle/exploration)
"TU" = (
/obj/machinery/atmospherics/pipe/simple/supply/hidden{
	dir = 9
	},
/turf/open/floor/mineral/titanium,
/area/shuttle/exploration)
"TV" = (
/obj/machinery/atmospherics/components/unary/vent_scrubber/on{
	dir = 4
	},
/turf/open/floor/mineral/titanium,
/area/shuttle/exploration)
"Up" = (
/obj/structure/chair/comfy/shuttle{
	dir = 1
	},
/obj/effect/turf_decal/stripes/line{
	dir = 2
	},
/turf/open/floor/mineral/titanium/blue,
/area/shuttle/exploration)
"Vw" = (
/obj/structure/table{
	dir = 1
	},
/obj/machinery/recharger{
	dir = 1
	},
/obj/effect/turf_decal/bot{
	dir = 4
	},
/turf/open/floor/mineral/plastitanium,
/area/shuttle/exploration)
"VA" = (
/obj/machinery/atmospherics/pipe/simple/purple/visible{
	dir = 9
	},
/obj/effect/turf_decal/stripes/corner{
	dir = 1
	},
/obj/machinery/power/terminal{
	dir = 4
	},
/turf/open/floor/mineral/titanium,
/area/shuttle/exploration)
"VO" = (
/obj/machinery/atmospherics/pipe/simple/supply/hidden{
	dir = 10
	},
/turf/open/floor/mineral/plastitanium,
/area/shuttle/exploration)
"VV" = (
/obj/effect/turf_decal/bot{
	dir = 4
	},
/obj/machinery/portable_atmospherics/canister/air{
	dir = 1
	},
/obj/item/analyzer{
	dir = 1
	},
/turf/open/floor/mineral/plastitanium,
/area/shuttle/exploration)
"Wd" = (
/obj/machinery/atmospherics/pipe/simple/supply/hidden{
	dir = 1
	},
/obj/effect/turf_decal/stripes/line{
	dir = 8
	},
/turf/open/floor/mineral/titanium,
/area/shuttle/exploration)
"Wh" = (
/obj/machinery/atmospherics/pipe/simple/purple/visible{
	dir = 1
	},
/obj/effect/turf_decal/stripes/corner{
	dir = 8
	},
/obj/effect/turf_decal/stripes/line{
	dir = 4
	},
/turf/open/floor/mineral/titanium,
/area/shuttle/exploration)
"Xp" = (
/obj/machinery/requests_console{
	announcementConsole = 1;
	department = "Exploration Shuttle";
	departmentType = 5;
	pixel_x = -32;
	dir = 1
	},
/obj/machinery/atmospherics/components/unary/vent_scrubber/on{
	dir = 2
	},
/turf/open/floor/mineral/plastitanium,
/area/shuttle/exploration)
"XG" = (
/obj/effect/spawner/structure/window/shuttle{
	dir = 1
	},
/obj/machinery/atmospherics/pipe/simple/supply/hidden{
	dir = 4
	},
/turf/open/floor/plating,
/area/shuttle/exploration)
"XI" = (
/obj/machinery/atmospherics/components/binary/dp_vent_pump{
	dir = 1
	},
/obj/effect/turf_decal/stripes/line{
	dir = 2
	},
/obj/effect/turf_decal/stripes/line{
	dir = 1
	},
/turf/open/floor/mineral/titanium,
/area/shuttle/exploration)
"YE" = (
/obj/machinery/door/airlock/shuttle{
	dir = 1
	},
/obj/effect/turf_decal/delivery{
	dir = 4
	},
/turf/open/floor/mineral/plastitanium,
/area/shuttle/exploration)
"YF" = (
/obj/machinery/door/airlock/shuttle{
	dir = 1
	},
/obj/effect/turf_decal/delivery{
	dir = 4
	},
/turf/open/floor/mineral/titanium,
/area/shuttle/exploration)
"YO" = (
/obj/machinery/light{
	dir = 2
	},
/obj/machinery/atmospherics/components/unary/vent_pump/on{
	dir = 1
	},
/turf/open/floor/mineral/titanium,
/area/shuttle/exploration)
"YR" = (
/obj/machinery/atmospherics/pipe/simple/scrubbers/visible{
	dir = 1
	},
/obj/machinery/atmospherics/pipe/simple/dark/visible{
	dir = 4
	},
/obj/effect/turf_decal/stripes/line{
	dir = 2
	},
/turf/open/floor/mineral/titanium,
/area/shuttle/exploration)
"ZB" = (
/obj/machinery/atmospherics/components/trinary/filter/atmos/o2{
	dir = 2
	},
/turf/open/floor/mineral/titanium,
/area/shuttle/exploration)
"ZM" = (
/turf/template_noop,
/area/template_noop)
"ZT" = (
/obj/structure/table{
	dir = 1
	},
/obj/item/paper_bin{
	dir = 1
	},
/obj/item/pen{
	dir = 1
	},
/turf/open/floor/mineral/titanium/blue,
/area/shuttle/exploration)

(1,1,1) = {"
ZM
Ay
QG
QG
QG
yh
ZM
ZM
ZM
yh
QG
QG
QG
Ay
ZM"}(2,1,1) = {"
Ay
Ay
mb
mb
mb
yh
yh
yh
yh
yh
mb
mb
mb
Ay
Ay"}(3,1,1) = {"
yh
yh
ym
up
Lc
AU
aA
hP
aA
gS
JG
Cc
VA
yh
yh"}(4,1,1) = {"
df
df
fO
jS
Wh
dv
zN
zN
zN
vx
NZ
qJ
um
df
df"}(5,1,1) = {"
gJ
gJ
df
df
kI
df
fO
fO
fO
df
df
df
df
gJ
gJ"}(6,1,1) = {"
pT
jB
jt
dq
vb
df
df
YF
df
df
pi
jO
pi
jB
ka"}(7,1,1) = {"
pT
jB
kH
lY
jt
df
eN
fO
nu
df
Dn
Dn
Dn
jB
ka"}(8,1,1) = {"
pT
jB
VV
jR
kH
df
TV
fU
YO
df
Dn
Dn
ml
jB
ka"}(9,1,1) = {"
gJ
gJ
gJ
df
df
df
Az
te
fO
YE
Dn
Dn
bA
gJ
gJ"}(10,1,1) = {"
gJ
gJ
fO
fO
fO
SO
Az
te
fO
df
HU
kH
GI
gJ
gJ"}(11,1,1) = {"
gJ
gJ
Af
ZT
KX
Up
Az
te
fO
df
df
df
df
gJ
gJ"}(12,1,1) = {"
pT
jB
LR
pR
Tz
Up
Az
SG
fO
Nl
lc
sY
Hm
jB
ka"}(13,1,1) = {"
pT
jB
LR
JP
PF
Up
Az
te
fO
wc
wc
nF
aP
jB
ka"}(14,1,1) = {"
pT
jB
fO
xl
fy
Of
cr
bS
ve
yz
ZB
YR
Ls
sh
yM"}(15,1,1) = {"
gJ
gJ
df
Kc
fO
MF
SR
hc
Gt
cG
fO
dS
df
gJ
gJ"}(16,1,1) = {"
mR
XI
mk
tD
lg
XG
df
df
df
jB
fU
pd
dN
bb
Ac"}(17,1,1) = {"
AN
wo
CU
uQ
JV
QT
Wd
mr
Wd
HG
TU
sO
Cu
gM
NO"}(18,1,1) = {"
gJ
gJ
df
om
fy
fy
Fr
gW
fy
fy
fy
nK
df
gJ
gJ"}(19,1,1) = {"
ZM
gJ
gJ
df
df
df
hW
ce
df
df
df
df
gJ
gJ
ZM"}(20,1,1) = {"
ZM
ZM
gJ
jB
mL
Xp
LA
VO
My
aV
iT
jB
gJ
ZM
ZM"}(21,1,1) = {"
ZM
ZM
ZM
jB
tt
iG
Dn
nY
Dn
kO
kx
jB
ZM
ZM
ZM"}(22,1,1) = {"
ZM
ZM
ZM
jB
jB
Vw
kH
sD
kH
Gb
jB
jB
ZM
ZM
ZM"}(23,1,1) = {"
ZM
ZM
ZM
ZM
jB
jB
jB
jB
jB
jB
jB
ZM
ZM
ZM
ZM"}