//MAP CONVERTED BY dmm2tgm.py THIS HEADER COMMENT PREVENTS RECONVERSION, DO NOT REMOVE
"a" = (
/obj/machinery/door/airlock/shuttle{
	dir = 1
	},
/obj/effect/turf_decal/stripes/line{
	dir = 1
	},
/obj/effect/turf_decal/stripes/line{
	dir = 2
	},
/obj/machinery/door/firedoor/border_only{
	dir = 1
	},
/obj/machinery/door/firedoor/border_only{
	dir = 2
	},
/turf/open/floor/mineral/titanium,
/area/shuttle/exploration)
"b" = (
/obj/effect/turf_decal/delivery{
	dir = 4
	},
/obj/machinery/atmospherics/pipe/manifold/purple/visible{
	dir = 2
	},
/obj/structure/closet/crate{
	dir = 1
	},
/obj/item/radio/headset/headset_exploration{
	dir = 1
	},
/obj/item/radio/headset/headset_exploration{
	dir = 1
	},
/obj/item/wrench{
	dir = 1
	},
/obj/item/pickaxe{
	dir = 1
	},
/obj/item/mining_scanner{
	dir = 1
	},
/turf/open/floor/mineral/titanium,
/area/shuttle/exploration)
"c" = (
/obj/machinery/atmospherics/components/binary/dp_vent_pump{
	dir = 8
	},
/turf/open/floor/mineral/plastitanium,
/area/shuttle/exploration)
"d" = (
/turf/open/floor/mineral/plastitanium,
/area/shuttle/exploration)
"e" = (
/obj/structure/fans/tiny{
	dir = 1
	},
/obj/effect/turf_decal/stripes/line{
	dir = 8
	},
/obj/effect/turf_decal/stripes/line{
	dir = 4
	},
/obj/machinery/door/poddoor/shutters{
	id = "exploration";
	dir = 1
	},
/obj/machinery/button/door{
	desc = "A remote control switch.";
	id = "exploration";
	name = "Exploration Shuttle Shutters";
	normaldoorcontrol = 0;
	pixel_y = -24;
	dir = 1
	},
/turf/open/floor/mineral/titanium,
/area/shuttle/exploration)
"f" = (
/obj/machinery/atmospherics/pipe/simple/dark/hidden{
	dir = 4
	},
/turf/closed/wall/mineral/titanium/nodiagonal,
/area/shuttle/exploration)
"g" = (
/turf/open/floor/mineral/titanium,
/area/shuttle/exploration)
"i" = (
/obj/structure/chair/comfy/shuttle{
	dir = 8
	},
/obj/machinery/light/small{
	dir = 4
	},
/turf/open/floor/mineral/titanium,
/area/shuttle/exploration)
"j" = (
/obj/effect/turf_decal/delivery{
	dir = 4
	},
/obj/machinery/atmospherics/pipe/manifold/purple/visible{
	dir = 2
	},
/obj/machinery/power/port_gen/pacman{
	dir = 1
	},
/turf/open/floor/mineral/titanium,
/area/shuttle/exploration)
"k" = (
/obj/machinery/atmospherics/pipe/manifold/dark/hidden{
	dir = 4
	},
/turf/closed/wall/mineral/titanium/nodiagonal,
/area/shuttle/exploration)
"l" = (
/turf/template_noop,
/area/template_noop)
"m" = (
/obj/machinery/computer/objective{
	dir = 1
	},
/turf/open/floor/mineral/plastitanium,
/area/shuttle/exploration)
"n" = (
/obj/effect/turf_decal/delivery{
	dir = 4
	},
/obj/machinery/atmospherics/pipe/manifold/purple/visible{
	dir = 2
	},
/obj/structure/tank_dispenser/oxygen{
	dir = 1
	},
/turf/open/floor/mineral/titanium,
/area/shuttle/exploration)
"o" = (
/obj/effect/turf_decal/delivery{
	dir = 4
	},
/obj/machinery/atmospherics/components/unary/plasma_refiner{
	dir = 8
	},
/turf/open/floor/mineral/titanium,
/area/shuttle/exploration)
"p" = (
/obj/machinery/shuttle/engine/plasma{
	dir = 2
	},
/turf/open/floor/plating,
/area/shuttle/exploration)
"q" = (
/obj/machinery/holopad{
	dir = 1
	},
/turf/open/floor/mineral/titanium,
/area/shuttle/exploration)
"r" = (
/obj/effect/turf_decal/stripes/line{
	dir = 2
	},
/obj/machinery/light/small{
	dir = 2
	},
/turf/open/floor/mineral/titanium,
/area/shuttle/exploration)
"s" = (
/obj/machinery/atmospherics/pipe/simple/dark/hidden{
	dir = 1
	},
/turf/closed/wall/mineral/titanium,
/area/shuttle/exploration)
"t" = (
/obj/machinery/door/airlock/external/glass{
	dir = 1
	},
/obj/machinery/atmospherics/pipe/simple/dark/hidden{
	dir = 5
	},
/obj/docking_port/mobile{
	dir = 4;
	dwidth = 7;
	height = 7;
	id = "exploration";
	name = "Exploration Shuttle";
	port_direction = 8;
	shuttle_object_type = /datum/orbital_object/shuttle/custom_shuttle;
	width = 13
	},
/turf/open/floor/mineral/plastitanium,
/area/shuttle/exploration)
"u" = (
/obj/effect/turf_decal/stripes/line{
	dir = 2
	},
/obj/structure/cable/yellow{
	icon_state = "4-8"
	},
/turf/open/floor/mineral/titanium,
/area/shuttle/exploration)
"v" = (
/obj/machinery/atmospherics/pipe/simple/dark/hidden{
	dir = 10
	},
/turf/closed/wall/mineral/titanium/nodiagonal,
/area/shuttle/exploration)
"x" = (
/obj/machinery/door/airlock/external/glass{
	dir = 1
	},
/obj/machinery/atmospherics/pipe/simple/dark/hidden{
	dir = 9
	},
/turf/open/floor/mineral/plastitanium,
/area/shuttle/exploration)
"y" = (
/obj/machinery/atmospherics/components/unary/tank/air{
	dir = 4;
	initialize_directions = 4
	},
/turf/open/floor/mineral/plastitanium,
/area/shuttle/exploration)
"z" = (
/turf/closed/wall/mineral/titanium/nodiagonal,
/area/shuttle/exploration)
"A" = (
/obj/structure/fans/tiny{
	dir = 1
	},
/obj/effect/turf_decal/stripes/line{
	dir = 8
	},
/obj/effect/turf_decal/stripes/line{
	dir = 4
	},
/obj/machinery/door/poddoor/shutters{
	id = "exploration";
	dir = 1
	},
/turf/open/floor/mineral/titanium,
/area/shuttle/exploration)
"B" = (
/obj/effect/turf_decal/stripes/line{
	dir = 2
	},
/obj/machinery/power/apc/auto_name/south{
	pixel_y = -24
	},
/obj/structure/cable/yellow{
	icon_state = "0-4"
	},
/turf/open/floor/mineral/titanium,
/area/shuttle/exploration)
"C" = (
/obj/effect/turf_decal/bot{
	dir = 4
	},
/obj/structure/closet/crate/science{
	dir = 1
	},
/obj/item/circuitboard/computer/shuttle/exploration_shuttle{
	dir = 1
	},
/obj/item/stack/sheet/mineral/plasma/five{
	dir = 1
	},
/obj/item/gps/mining{
	dir = 1
	},
/obj/item/storage/toolbox/mechanical{
	dir = 1
	},
/obj/item/multitool{
	dir = 1
	},
/turf/open/floor/mineral/titanium,
/area/shuttle/exploration)
"D" = (
/obj/structure/table{
	dir = 1
	},
/obj/machinery/recharger{
	dir = 1
	},
/turf/open/floor/mineral/plastitanium,
/area/shuttle/exploration)
"E" = (
/obj/effect/turf_decal/bot{
	dir = 4
	},
/turf/open/floor/mineral/titanium,
/area/shuttle/exploration)
"F" = (
/obj/structure/table{
	dir = 1
	},
/obj/machinery/microwave{
	dir = 1
	},
/obj/item/storage/box/donkpockets{
	dir = 1
	},
/obj/item/storage/box/donkpockets{
	dir = 1
	},
/turf/open/floor/mineral/plastitanium,
/area/shuttle/exploration)
"G" = (
/obj/structure/cable/yellow{
	icon_state = "0-2"
	},
/obj/effect/turf_decal/bot{
	dir = 4
	},
/turf/open/floor/plating,
/area/shuttle/exploration)
"H" = (
/obj/machinery/atmospherics/pipe/simple/dark/hidden{
	dir = 6
	},
/turf/closed/wall/mineral/titanium/nodiagonal,
/area/shuttle/exploration)
"I" = (
/turf/closed/wall/mineral/plastitanium,
/area/shuttle/exploration)
"K" = (
/obj/structure/fans/tiny{
	dir = 1
	},
/obj/effect/turf_decal/stripes/line{
	dir = 4
	},
/obj/effect/turf_decal/stripes/line{
	dir = 8
	},
/obj/machinery/door/poddoor/shutters{
	id = "exploration";
	dir = 1
	},
/turf/open/floor/mineral/titanium,
/area/shuttle/exploration)
"L" = (
/obj/structure/window/reinforced/survival_pod{
	dir = 2
	},
/obj/machinery/atmospherics/components/unary/shuttle/heater{
	dir = 2
	},
/turf/open/floor/plating,
/area/shuttle/exploration)
"M" = (
/obj/machinery/computer/shuttle_flight/custom_shuttle/exploration{
	dir = 1
	},
/turf/open/floor/mineral/plastitanium,
/area/shuttle/exploration)
"N" = (
/obj/effect/turf_decal/stripes/line{
	dir = 2
	},
/obj/structure/cable/yellow{
	icon_state = "1-8"
	},
/turf/open/floor/mineral/titanium,
/area/shuttle/exploration)
"O" = (
/mob/living/simple_animal/chicken/turkey{
	atmos_requirements = list("min_oxy" = 0, "max_oxy" = 0, "min_tox" = 0, "max_tox" = 0, "min_co2" = 0, "max_co2" = 0, "min_n2" = 0, "max_n2" = 0);
	desc = "A veteran of Nanotrasen's Animal Experimentation Program that attempted to replicate the organic space suit that some hostile entities are known to have exhibited, Tom now serves Nanotrasen as the mascot of the Exploration Crew.";
	health = 200;
	maxHealth = 200;
	melee_damage = 5;
	minbodytemp = 2.7;
	name = "Tom"
	},
/turf/open/floor/mineral/titanium,
/area/shuttle/exploration)
"P" = (
/obj/structure/chair/comfy/shuttle{
	dir = 2
	},
/turf/open/floor/mineral/plastitanium,
/area/shuttle/exploration)
"Q" = (
/turf/closed/wall/mineral/titanium,
/area/shuttle/exploration)
"R" = (
/obj/effect/spawner/structure/window/shuttle{
	dir = 1
	},
/turf/open/floor/plating,
/area/shuttle/exploration)
"S" = (
/obj/machinery/door/airlock/shuttle{
	dir = 1
	},
/obj/effect/turf_decal/stripes/line{
	dir = 1
	},
/obj/effect/turf_decal/stripes/line{
	dir = 2
	},
/obj/machinery/door/firedoor/border_only{
	dir = 1
	},
/obj/machinery/door/firedoor/border_only{
	dir = 2
	},
/turf/open/floor/mineral/plastitanium,
/area/shuttle/exploration)
"T" = (
/obj/effect/turf_decal/bot{
	dir = 4
	},
/obj/machinery/portable_atmospherics/canister/toxins{
	dir = 1
	},
/turf/open/floor/mineral/titanium,
/area/shuttle/exploration)
"U" = (
/obj/effect/turf_decal/delivery{
	dir = 4
	},
/obj/machinery/atmospherics/components/unary/portables_connector/visible{
	dir = 4
	},
/turf/open/floor/mineral/titanium,
/area/shuttle/exploration)
"V" = (
/obj/effect/turf_decal/stripes/line{
	dir = 2
	},
/turf/open/floor/mineral/titanium,
/area/shuttle/exploration)
"W" = (
/turf/closed/wall/mineral/plastitanium/nodiagonal,
/area/shuttle/exploration)
"X" = (
/obj/structure/chair/comfy/shuttle{
	dir = 8
	},
/turf/open/floor/mineral/titanium,
/area/shuttle/exploration)
"Y" = (
/obj/effect/turf_decal/delivery{
	dir = 4
	},
/obj/machinery/telecomms/relay/preset/exploration{
	dir = 1
	},
/turf/open/floor/mineral/titanium,
/area/shuttle/exploration)
"Z" = (
/obj/structure/closet/emcloset/anchored{
	dir = 1
	},
/obj/machinery/advanced_airlock_controller/directional/east,
/obj/machinery/light/small{
	dir = 2
	},
/turf/open/floor/mineral/plastitanium,
/area/shuttle/exploration)

(1,1,1) = {"
l
I
Q
K
e
H
s
t
Q
Q
R
R
l"}(2,1,1) = {"
I
W
U
C
B
f
y
c
Z
z
D
R
R"}(3,1,1) = {"
p
L
n
E
u
v
k
x
z
z
P
M
R"}(4,1,1) = {"
p
L
j
G
N
R
Y
g
g
S
d
d
R"}(5,1,1) = {"
p
L
b
E
V
a
g
q
O
z
P
m
R"}(6,1,1) = {"
I
W
o
T
r
z
i
X
i
z
F
R
R"}(7,1,1) = {"
l
I
Q
A
e
z
Q
R
Q
Q
R
R
l"}