//MAP CONVERTED BY dmm2tgm.py THIS HEADER COMMENT PREVENTS RECONVERSION, DO NOT REMOVE
"cr" = (
/obj/effect/turf_decal/tile/neutral{
	dir = 4
	},
/obj/effect/turf_decal/tile/neutral{
	dir = 8
	},
/turf/open/floor/mineral/plastitanium,
/area/shuttle/exploration)
"dp" = (
/obj/effect/turf_decal/tile/blue{
	dir = 4
	},
/obj/effect/turf_decal/tile/blue{
	dir = 8
	},
/obj/effect/turf_decal/stripes/line{
	dir = 8
	},
/obj/effect/turf_decal/caution/red{
	dir = 2
	},
/obj/effect/turf_decal/box/corners{
	dir = 4
	},
/turf/open/floor/mineral/titanium/white,
/area/shuttle/exploration)
"ff" = (
/obj/effect/turf_decal/tile/brown{
	dir = 4
	},
/obj/effect/turf_decal/tile/brown{
	dir = 8
	},
/obj/machinery/power/apc/auto_name/east,
/obj/structure/cable/yellow{
	icon_state = "0-8"
	},
/obj/effect/turf_decal/loading_area{
	dir = 4
	},
/turf/open/floor/mineral/titanium/yellow,
/area/shuttle/exploration)
"gl" = (
/obj/machinery/door/poddoor/shutters{
	id = "exploration";
	dir = 1
	},
/obj/effect/turf_decal/stripes/line{
	dir = 8
	},
/obj/effect/turf_decal/stripes/line{
	dir = 4
	},
/obj/effect/turf_decal/delivery{
	dir = 4
	},
/obj/structure/fans/tiny{
	dir = 1
	},
/turf/open/floor/plating,
/area/shuttle/exploration)
"gm" = (
/obj/effect/turf_decal/delivery{
	dir = 4
	},
/obj/structure/table/reinforced{
	dir = 1
	},
/obj/effect/turf_decal/tile/neutral{
	dir = 8
	},
/obj/effect/turf_decal/stripes/line{
	dir = 10
	},
/obj/effect/turf_decal/tile/neutral{
	dir = 4
	},
/obj/effect/turf_decal/tile/neutral{
	dir = 8
	},
/obj/item/storage/box/donkpockets{
	dir = 1
	},
/obj/item/storage/box/donkpockets/donkpockethonk{
	pixel_x = 5;
	pixel_y = -5;
	dir = 1
	},
/turf/open/floor/mineral/plastitanium,
/area/shuttle/exploration)
"gz" = (
/obj/effect/turf_decal/tile/blue{
	dir = 4
	},
/obj/effect/turf_decal/tile/blue{
	dir = 8
	},
/obj/effect/turf_decal/stripes/line{
	dir = 8
	},
/obj/effect/turf_decal/caution/red{
	dir = 2
	},
/obj/effect/turf_decal/box/corners{
	dir = 2;
	icon_state = "box_corners"
	},
/turf/open/floor/mineral/titanium/white,
/area/shuttle/exploration)
"is" = (
/obj/effect/turf_decal/tile/brown{
	dir = 4
	},
/obj/effect/turf_decal/tile/brown{
	dir = 8
	},
/obj/effect/turf_decal/stripes/corner{
	dir = 8
	},
/obj/machinery/atmospherics/components/unary/portables_connector/visible{
	dir = 4
	},
/obj/effect/turf_decal/delivery{
	dir = 4
	},
/obj/machinery/light{
	dir = 8;
	light_color = "#e8eaff"
	},
/turf/open/floor/mineral/titanium/yellow,
/area/shuttle/exploration)
"jI" = (
/obj/effect/turf_decal/stripes/line{
	dir = 2
	},
/obj/effect/turf_decal/tile/blue{
	dir = 4
	},
/obj/effect/turf_decal/tile/blue{
	dir = 8
	},
/obj/effect/decal/cleanable/blood/old{
	dir = 4
	},
/turf/open/floor/mineral/titanium/white,
/area/shuttle/exploration)
"kt" = (
/obj/machinery/microwave{
	pixel_y = -6;
	dir = 1
	},
/obj/structure/table/reinforced{
	dir = 1
	},
/obj/effect/turf_decal/tile/blue{
	dir = 4
	},
/obj/effect/turf_decal/tile/blue{
	dir = 8
	},
/turf/open/floor/mineral/titanium/white,
/area/shuttle/exploration)
"kH" = (
/obj/effect/turf_decal/tile/brown{
	dir = 4
	},
/obj/effect/turf_decal/tile/brown{
	dir = 8
	},
/turf/open/floor/mineral/titanium/yellow,
/area/shuttle/exploration)
"kJ" = (
/obj/effect/turf_decal/tile/neutral{
	dir = 4
	},
/obj/effect/turf_decal/tile/neutral{
	dir = 8
	},
/obj/effect/decal/remains/human{
	dir = 4
	},
/obj/effect/decal/cleanable/blood/old{
	dir = 4
	},
/turf/open/floor/mineral/plastitanium,
/area/shuttle/exploration)
"nU" = (
/obj/effect/turf_decal/tile/neutral{
	dir = 4
	},
/obj/effect/turf_decal/tile/neutral{
	dir = 8
	},
/obj/structure/chair/comfy/shuttle{
	dir = 2
	},
/turf/open/floor/mineral/plastitanium,
/area/shuttle/exploration)
"pJ" = (
/obj/machinery/atmospherics/pipe/manifold/purple/visible{
	dir = 2
	},
/obj/item/radio/headset/headset_exploration{
	dir = 1
	},
/obj/item/radio/headset/headset_exploration{
	dir = 1
	},
/obj/structure/closet/crate/science{
	dir = 1
	},
/obj/item/multitool{
	dir = 1
	},
/obj/item/wrench{
	dir = 1
	},
/obj/effect/turf_decal/tile/brown{
	dir = 4
	},
/obj/effect/turf_decal/tile/brown{
	dir = 8
	},
/obj/item/stack/sheet/mineral/plasma/twenty{
	dir = 1
	},
/obj/item/mining_scanner{
	dir = 1
	},
/obj/item/pickaxe{
	dir = 1
	},
/turf/open/floor/mineral/titanium/yellow,
/area/shuttle/exploration)
"pK" = (
/obj/machinery/atmospherics/pipe/manifold/purple/visible{
	dir = 2
	},
/obj/effect/turf_decal/tile/brown{
	dir = 8
	},
/obj/effect/turf_decal/tile/brown{
	dir = 4
	},
/turf/open/floor/mineral/titanium/yellow,
/area/shuttle/exploration)
"qt" = (
/obj/effect/turf_decal/delivery{
	dir = 4
	},
/obj/machinery/computer/shuttle_flight/custom_shuttle/exploration{
	dir = 1
	},
/obj/effect/turf_decal/tile/neutral{
	dir = 8
	},
/obj/effect/turf_decal/stripes/line{
	dir = 2
	},
/obj/effect/turf_decal/tile/neutral{
	dir = 4
	},
/obj/effect/turf_decal/tile/neutral{
	dir = 8
	},
/turf/open/floor/mineral/plastitanium,
/area/shuttle/exploration)
"qZ" = (
/obj/machinery/door/airlock/external/glass{
	dir = 1
	},
/obj/structure/fans/tiny{
	dir = 1
	},
/obj/docking_port/mobile{
	dir = 4;
	dwidth = 4;
	height = 9;
	id = "exploration";
	name = "Exploration Shuttle";
	port_direction = 8;
	shuttle_object_type = /datum/orbital_object/shuttle/custom_shuttle;
	width = 15
	},
/turf/open/floor/mineral/plastitanium,
/area/shuttle/exploration)
"rh" = (
/obj/machinery/button/door{
	desc = "A remote control switch.";
	id = "exploration";
	name = "Exploration Shuttle Shutters";
	pixel_y = -8;
	dir = 1
	},
/turf/closed/wall/mineral/titanium/nodiagonal,
/area/shuttle/exploration)
"si" = (
/obj/structure/sign/warning/fire{
	dir = 1
	},
/turf/closed/wall/mineral/plastitanium/nodiagonal,
/area/shuttle/exploration)
"tc" = (
/obj/effect/turf_decal/tile/blue{
	dir = 4
	},
/obj/effect/turf_decal/tile/blue{
	dir = 8
	},
/obj/effect/turf_decal/stripes/corner{
	dir = 1
	},
/turf/open/floor/mineral/titanium/white,
/area/shuttle/exploration)
"tu" = (
/obj/effect/turf_decal/tile/blue{
	dir = 4
	},
/obj/effect/turf_decal/tile/blue{
	dir = 8
	},
/obj/item/trash/pistachios{
	dir = 1
	},
/turf/open/floor/mineral/titanium/white,
/area/shuttle/exploration)
"uU" = (
/obj/structure/window/reinforced/survival_pod{
	dir = 2
	},
/obj/machinery/atmospherics/components/unary/shuttle/heater{
	dir = 2
	},
/turf/open/floor/plating,
/area/shuttle/exploration)
"vf" = (
/obj/structure/sign/nanotrasen{
	dir = 1
	},
/turf/closed/wall/mineral/titanium,
/area/shuttle/exploration)
"vp" = (
/obj/effect/turf_decal/tile/brown{
	dir = 4
	},
/obj/effect/turf_decal/tile/brown{
	dir = 8
	},
/obj/effect/turf_decal/stripes/line{
	dir = 8
	},
/obj/effect/turf_decal/caution/stand_clear{
	dir = 2
	},
/turf/open/floor/mineral/titanium/yellow,
/area/shuttle/exploration)
"vE" = (
/obj/machinery/holopad{
	pixel_x = 15;
	dir = 1
	},
/obj/effect/turf_decal/box/corners{
	dir = 8;
	icon_state = "box_corners"
	},
/obj/effect/turf_decal/box/corners{
	dir = 1;
	icon_state = "box_corners"
	},
/obj/effect/turf_decal/tile/neutral{
	dir = 8
	},
/obj/effect/turf_decal/tile/neutral{
	dir = 1
	},
/obj/effect/turf_decal/tile/neutral{
	dir = 4
	},
/obj/effect/turf_decal/tile/neutral{
	dir = 2
	},
/turf/open/floor/mineral/plastitanium,
/area/shuttle/exploration)
"wG" = (
/turf/closed/wall/mineral/titanium,
/area/shuttle/exploration)
"wH" = (
/obj/machinery/atmospherics/components/unary/plasma_refiner{
	dir = 8
	},
/obj/effect/turf_decal/delivery{
	dir = 4
	},
/obj/effect/turf_decal/tile/brown{
	dir = 4
	},
/obj/effect/turf_decal/tile/brown{
	dir = 8
	},
/turf/open/floor/mineral/titanium/yellow,
/area/shuttle/exploration)
"zs" = (
/obj/effect/turf_decal/stripes/line{
	dir = 8
	},
/obj/effect/turf_decal/tile/neutral{
	dir = 4
	},
/obj/effect/turf_decal/tile/neutral{
	dir = 8
	},
/turf/open/floor/mineral/plastitanium,
/area/shuttle/exploration)
"AE" = (
/turf/closed/wall/mineral/titanium/nodiagonal,
/area/shuttle/exploration)
"AY" = (
/obj/item/kirbyplants{
	icon_state = "applebush";
	dir = 1
	},
/obj/machinery/light{
	dir = 8
	},
/obj/effect/turf_decal/tile/blue{
	dir = 4
	},
/obj/effect/turf_decal/tile/blue{
	dir = 8
	},
/turf/open/floor/mineral/titanium/white,
/area/shuttle/exploration)
"AZ" = (
/obj/effect/spawner/structure/window/shuttle{
	dir = 1
	},
/turf/open/floor/plating,
/area/shuttle/exploration)
"BC" = (
/obj/effect/turf_decal/tile/neutral{
	dir = 4
	},
/obj/effect/turf_decal/tile/neutral{
	dir = 8
	},
/obj/structure/chair/comfy/shuttle{
	dir = 1
	},
/turf/open/floor/mineral/plastitanium,
/area/shuttle/exploration)
"BL" = (
/obj/effect/turf_decal/tile/blue{
	dir = 4
	},
/obj/effect/turf_decal/tile/blue{
	dir = 8
	},
/turf/open/floor/mineral/titanium/white,
/area/shuttle/exploration)
"FF" = (
/obj/effect/turf_decal/stripes/line{
	dir = 2
	},
/obj/effect/turf_decal/tile/blue{
	dir = 4
	},
/obj/effect/turf_decal/tile/blue{
	dir = 8
	},
/turf/open/floor/mineral/titanium/white,
/area/shuttle/exploration)
"GK" = (
/obj/effect/turf_decal/delivery{
	dir = 4
	},
/obj/structure/table/reinforced{
	dir = 1
	},
/obj/effect/turf_decal/tile/neutral{
	dir = 8
	},
/obj/item/tank/internals/emergency_oxygen/engi{
	pixel_x = -10;
	pixel_y = -3;
	dir = 4
	},
/obj/item/storage/toolbox/emergency{
	dir = 4
	},
/obj/item/radio{
	pixel_x = 7;
	pixel_y = -8;
	dir = 1
	},
/obj/effect/turf_decal/stripes/line{
	dir = 6
	},
/obj/effect/turf_decal/tile/neutral{
	dir = 4
	},
/obj/effect/turf_decal/tile/neutral{
	dir = 8
	},
/turf/open/floor/mineral/plastitanium,
/area/shuttle/exploration)
"Ht" = (
/obj/effect/turf_decal/tile/blue{
	dir = 4
	},
/obj/effect/turf_decal/tile/blue{
	dir = 8
	},
/obj/effect/turf_decal/stripes/line{
	dir = 8
	},
/obj/effect/turf_decal/caution/red{
	dir = 2
	},
/turf/open/floor/mineral/titanium/white,
/area/shuttle/exploration)
"Iv" = (
/obj/structure/table/reinforced{
	dir = 1
	},
/obj/item/flashlight/lamp/green{
	on = 0;
	pixel_x = -3;
	pixel_y = -8;
	dir = 1
	},
/obj/effect/turf_decal/tile/neutral{
	dir = 4
	},
/obj/effect/turf_decal/tile/neutral{
	dir = 8
	},
/turf/open/floor/mineral/plastitanium,
/area/shuttle/exploration)
"JB" = (
/obj/machinery/light{
	dir = 1
	},
/obj/effect/turf_decal/tile/blue{
	dir = 4
	},
/obj/effect/turf_decal/tile/blue{
	dir = 8
	},
/obj/item/kirbyplants{
	icon_state = "plant-03";
	dir = 1
	},
/turf/open/floor/mineral/titanium/white,
/area/shuttle/exploration)
"Lt" = (
/obj/effect/turf_decal/box/corners{
	dir = 2;
	icon_state = "box_corners"
	},
/obj/effect/turf_decal/box/corners{
	dir = 4
	},
/obj/effect/turf_decal/tile/neutral{
	dir = 8
	},
/obj/effect/turf_decal/tile/neutral{
	dir = 1
	},
/obj/effect/turf_decal/tile/neutral{
	dir = 4
	},
/obj/effect/turf_decal/tile/neutral{
	dir = 2
	},
/turf/open/floor/mineral/plastitanium,
/area/shuttle/exploration)
"Mj" = (
/obj/effect/turf_decal/tile/brown{
	dir = 8
	},
/obj/effect/turf_decal/tile/brown{
	dir = 4
	},
/turf/open/floor/mineral/titanium/yellow,
/area/shuttle/exploration)
"Np" = (
/obj/effect/turf_decal/tile/brown{
	dir = 4
	},
/obj/effect/turf_decal/tile/brown{
	dir = 8
	},
/obj/structure/cable/yellow{
	icon_state = "1-4"
	},
/turf/open/floor/mineral/titanium/yellow,
/area/shuttle/exploration)
"NL" = (
/obj/structure/lattice/catwalk{
	dir = 1
	},
/obj/item/stack/marker_beacon{
	anchored = 1;
	icon_state = "markerburgundy-on";
	light_color = "#FA644B";
	light_power = 3;
	light_range = 2;
	name = "landing marker";
	picked_color = "Burgundy";
	dir = 1
	},
/turf/template_noop,
/area/shuttle/exploration)
"NQ" = (
/obj/machinery/light{
	dir = 1
	},
/obj/effect/turf_decal/tile/blue{
	dir = 4
	},
/obj/effect/turf_decal/tile/blue{
	dir = 8
	},
/obj/item/kirbyplants{
	icon_state = "plant-10";
	dir = 1
	},
/obj/effect/turf_decal/stripes/corner{
	dir = 8
	},
/obj/structure/sign/warning/vacuum/external{
	pixel_y = 32;
	dir = 1
	},
/turf/open/floor/mineral/titanium/white,
/area/shuttle/exploration)
"PK" = (
/obj/machinery/shuttle/engine/plasma{
	dir = 2
	},
/turf/open/floor/plating,
/area/shuttle/exploration)
"Qj" = (
/obj/machinery/power/port_gen/pacman{
	dir = 1
	},
/obj/effect/turf_decal/tile/brown{
	dir = 4
	},
/obj/effect/turf_decal/tile/brown{
	dir = 8
	},
/obj/machinery/atmospherics/pipe/manifold/purple/visible{
	dir = 2
	},
/obj/structure/cable/yellow{
	icon_state = "0-2"
	},
/turf/open/floor/mineral/titanium/yellow,
/area/shuttle/exploration)
"Qu" = (
/obj/machinery/telecomms/relay/preset/exploration{
	dir = 1
	},
/obj/effect/turf_decal/delivery{
	dir = 4
	},
/turf/open/floor/mineral/plastitanium,
/area/shuttle/exploration)
"QP" = (
/obj/item/kirbyplants{
	icon_state = "plant-21";
	dir = 1
	},
/obj/machinery/light{
	dir = 4
	},
/obj/effect/turf_decal/tile/blue{
	dir = 4
	},
/obj/effect/turf_decal/tile/blue{
	dir = 8
	},
/turf/open/floor/mineral/titanium/white,
/area/shuttle/exploration)
"TY" = (
/obj/effect/turf_decal/stripes/line{
	dir = 1
	},
/obj/effect/turf_decal/tile/blue{
	dir = 4
	},
/obj/effect/turf_decal/tile/blue{
	dir = 8
	},
/turf/open/floor/mineral/titanium/white,
/area/shuttle/exploration)
"UH" = (
/obj/effect/turf_decal/tile/blue{
	dir = 4
	},
/obj/effect/turf_decal/tile/blue{
	dir = 8
	},
/obj/structure/closet/crate/bin{
	dir = 1
	},
/obj/effect/turf_decal/delivery{
	dir = 4
	},
/obj/item/toy/beach_ball{
	dir = 1
	},
/obj/item/bikehorn/rubberducky{
	dir = 1
	},
/turf/open/floor/mineral/titanium/white,
/area/shuttle/exploration)
"Vg" = (
/turf/closed/wall/mineral/plastitanium,
/area/shuttle/exploration)
"WK" = (
/obj/effect/turf_decal/tile/brown{
	dir = 4
	},
/obj/effect/turf_decal/tile/brown{
	dir = 8
	},
/obj/machinery/atmospherics/pipe/manifold/purple/visible{
	dir = 2
	},
/turf/open/floor/mineral/titanium/yellow,
/area/shuttle/exploration)
"Yd" = (
/obj/machinery/recharger{
	pixel_x = 6;
	dir = 1
	},
/obj/machinery/recharger{
	pixel_x = -6;
	dir = 1
	},
/obj/structure/table/reinforced{
	dir = 1
	},
/obj/effect/turf_decal/tile/neutral{
	dir = 4
	},
/obj/effect/turf_decal/tile/neutral{
	dir = 8
	},
/turf/open/floor/mineral/plastitanium,
/area/shuttle/exploration)
"Zk" = (
/obj/effect/turf_decal/delivery{
	dir = 4
	},
/obj/machinery/computer/objective{
	dir = 1
	},
/obj/effect/turf_decal/tile/neutral{
	dir = 8
	},
/obj/effect/turf_decal/stripes/line{
	dir = 2
	},
/obj/effect/turf_decal/tile/neutral{
	dir = 4
	},
/obj/effect/turf_decal/tile/neutral{
	dir = 8
	},
/turf/open/floor/mineral/plastitanium,
/area/shuttle/exploration)
"Zq" = (
/obj/effect/turf_decal/stripes/line{
	dir = 4
	},
/obj/effect/turf_decal/tile/neutral{
	dir = 4
	},
/obj/effect/turf_decal/tile/neutral{
	dir = 8
	},
/turf/open/floor/mineral/plastitanium,
/area/shuttle/exploration)

(1,1,1) = {"
NL
Vg
rh
qZ
wG
AZ
gl
gl
gl
vf
wG
wG
AZ
NL"}(2,1,1) = {"
Vg
si
is
vp
wG
NQ
dp
Ht
gz
tc
AY
kt
AZ
AZ"}(3,1,1) = {"
PK
uU
WK
kH
TY
BL
tu
FF
zs
zs
zs
zs
gm
AZ"}(4,1,1) = {"
PK
uU
pJ
kH
TY
BL
vE
FF
nU
Yd
BC
cr
qt
AZ"}(5,1,1) = {"
PK
uU
pK
Mj
TY
BL
Lt
FF
nU
Iv
BC
kJ
Zk
AZ"}(6,1,1) = {"
PK
uU
Qj
Np
TY
BL
BL
jI
Zq
Zq
Zq
Zq
GK
AZ"}(7,1,1) = {"
Vg
si
wH
ff
wG
JB
UH
BL
BL
BL
QP
Qu
AZ
AZ"}(8,1,1) = {"
NL
Vg
AE
wG
wG
wG
wG
AZ
AZ
vf
wG
AZ
AZ
NL"}