//MAP CONVERTED BY dmm2tgm.py THIS HEADER COMMENT PREVENTS RECONVERSION, DO NOT REMOVE
"a" = (
/turf/template_noop,
/area/template_noop)
"b" = (
/turf/closed/wall,
/area/shuttle/hunter)
"c" = (
/obj/structure/shuttle/engine/propulsion{
	dir = 8
	},
/turf/open/floor/plating/airless,
/area/shuttle/hunter)
"d" = (
/obj/structure/shuttle/engine/heater{
	dir = 8;
	icon_state = "heater"
	},
/obj/structure/window/reinforced{
	dir = 4
	},
/turf/open/floor/plating/airless,
/area/shuttle/hunter)
"e" = (
/obj/machinery/portable_atmospherics/scrubber/huge{
	dir = 1
	},
/turf/open/floor/plating,
/area/shuttle/hunter)
"f" = (
/obj/machinery/power/smes{
	dir = 1
	},
/turf/open/floor/plating,
/area/shuttle/hunter)
"g" = (
/turf/open/floor/plating,
/area/shuttle/hunter)
"j" = (
/obj/effect/turf_decal/bot{
	dir = 4
	},
/obj/effect/decal/cleanable/dirt{
	dir = 4
	},
/turf/open/floor/plating,
/area/shuttle/hunter)
"k" = (
/turf/open/floor/mineral/plastitanium/red,
/area/shuttle/hunter)
"m" = (
/obj/structure/reagent_dispensers/fueltank{
	dir = 1
	},
/obj/item/weldingtool/largetank{
	dir = 1
	},
/turf/open/floor/mineral/plastitanium,
/area/shuttle/hunter)
"n" = (
/obj/effect/decal/cleanable/dirt/dust{
	dir = 4
	},
/obj/structure/reagent_dispensers/watertank{
	dir = 1
	},
/obj/item/reagent_containers/glass/bucket{
	dir = 1
	},
/obj/item/mop{
	dir = 1
	},
/obj/item/storage/bag/trash{
	pixel_x = 6;
	dir = 1
	},
/turf/open/floor/mineral/plastitanium,
/area/shuttle/hunter)
"o" = (
/obj/effect/mob_spawn/human/fugitive/russian{
	dir = 4
	},
/turf/open/floor/mineral/plastitanium/red,
/area/shuttle/hunter)
"p" = (
/obj/effect/turf_decal/bot{
	dir = 4
	},
/obj/effect/decal/cleanable/dirt{
	dir = 4
	},
/obj/structure/closet/crate{
	opened = 1;
	dir = 1
	},
/turf/open/floor/plating,
/area/shuttle/hunter)
"q" = (
/turf/open/floor/mineral/plastitanium,
/area/shuttle/hunter)
"r" = (
/obj/effect/turf_decal/arrows{
	dir = 2;
	icon_state = "arrows"
	},
/turf/open/floor/mineral/plastitanium/red,
/area/shuttle/hunter)
"s" = (
/obj/structure/table{
	dir = 1
	},
/obj/item/storage/fancy/cigarettes/cigars/cohiba{
	pixel_y = -6;
	dir = 1
	},
/turf/open/floor/mineral/plastitanium,
/area/shuttle/hunter)
"t" = (
/obj/effect/turf_decal/bot{
	dir = 4
	},
/obj/effect/decal/cleanable/dirt{
	dir = 4
	},
/obj/structure/closet/crate/large{
	icon_state = "crittercrate";
	dir = 1
	},
/turf/open/floor/plating,
/area/shuttle/hunter)
"u" = (
/obj/effect/decal/cleanable/dirt{
	dir = 4
	},
/turf/open/floor/mineral/plastitanium,
/area/shuttle/hunter)
"v" = (
/obj/effect/spawner/structure/window/reinforced{
	dir = 1
	},
/turf/open/floor/plating,
/area/shuttle/hunter)
"w" = (
/obj/machinery/fugitive_capture{
	dir = 1
	},
/turf/open/floor/mineral/plastitanium,
/area/shuttle/hunter)
"x" = (
/obj/effect/turf_decal/bot{
	dir = 4
	},
/turf/open/floor/plating,
/area/shuttle/hunter)
"y" = (
/turf/template_noop,
/area/shuttle/hunter)
"z" = (
/obj/structure/chair{
	dir = 4;
	icon_state = "chair"
	},
/turf/open/floor/mineral/plastitanium/red,
/area/shuttle/hunter)
"A" = (
/obj/machinery/computer/shuttle_flight/hunter{
	dir = 8
	},
/turf/open/floor/mineral/plastitanium/red,
/area/shuttle/hunter)
"B" = (
/obj/effect/turf_decal/bot{
	dir = 4
	},
/obj/structure/closet/crate{
	opened = 1;
	dir = 1
	},
/turf/open/floor/plating,
/area/shuttle/hunter)
"C" = (
/obj/machinery/computer/camera_advanced{
	dir = 8
	},
/turf/open/floor/mineral/plastitanium/red,
/area/shuttle/hunter)
"D" = (
/obj/effect/decal/cleanable/dirt{
	dir = 4
	},
/turf/open/floor/mineral/plastitanium/red,
/area/shuttle/hunter)
"E" = (
/turf/open/floor/mineral/plastitanium,
/area/shuttle/hunter)
"F" = (
/obj/effect/turf_decal/bot{
	dir = 4
	},
/obj/effect/decal/cleanable/dirt{
	dir = 4
	},
/obj/structure/closet/crate/engineering{
	icon_state = "engi_crateopen";
	dir = 1
	},
/turf/open/floor/plating,
/area/shuttle/hunter)
"G" = (
/obj/structure/table{
	dir = 1
	},
/obj/item/reagent_containers/food/drinks/bottle/vodka{
	dir = 1
	},
/turf/open/floor/mineral/plastitanium,
/area/shuttle/hunter)
"H" = (
/obj/effect/turf_decal/bot{
	dir = 4
	},
/obj/structure/closet/crate/coffin{
	icon_state = "coffinopen";
	dir = 1
	},
/turf/open/floor/plating,
/area/shuttle/hunter)
"I" = (
/obj/effect/turf_decal/bot{
	dir = 4
	},
/obj/structure/mecha_wreckage/ripley{
	dir = 1
	},
/turf/open/floor/plating,
/area/shuttle/hunter)
"J" = (
/obj/machinery/portable_atmospherics/canister/oxygen{
	dir = 1
	},
/turf/open/floor/mineral/plastitanium,
/area/shuttle/hunter)
"L" = (
/obj/effect/mob_spawn/human/fugitive/russian{
	dir = 2
	},
/turf/open/floor/plating,
/area/shuttle/hunter)
"M" = (
/obj/machinery/door/airlock/security/glass{
	req_access_txt = "181";
	dir = 1
	},
/obj/structure/fans/tiny{
	dir = 1
	},
/obj/docking_port/stationary{
	dir = 2;
	dwidth = 5;
	height = 16;
	id = "pirateship_home";
	name = "Deep Space";
	width = 17
	},
/obj/docking_port/mobile{
	dheight = -3;
	dir = 2;
	dwidth = 11;
	height = 13;
	id = "huntership";
	movement_force = list("KNOCKDOWN" = 0, "THROW" = 0);
	name = "hunter shuttle";
	rechargeTime = 1800;
	width = 15
	},
/turf/open/floor/mineral/plastitanium/red,
/area/shuttle/hunter)
"N" = (
/obj/machinery/suit_storage_unit/standard_unit{
	dir = 1
	},
/obj/effect/turf_decal/stripes/line{
	dir = 1
	},
/turf/open/floor/mineral/plastitanium,
/area/shuttle/hunter)
"O" = (
/obj/machinery/door/airlock/security/glass{
	req_access_txt = "181";
	dir = 1
	},
/turf/open/floor/mineral/plastitanium/red,
/area/shuttle/hunter)
"Q" = (
/obj/item/book/manual/ripley_build_and_repair{
	dir = 1
	},
/turf/open/floor/mineral/plastitanium/red,
/area/shuttle/hunter)
"X" = (
/obj/structure/fans/tiny{
	dir = 1
	},
/obj/machinery/door/airlock/security/glass{
	req_access_txt = "181";
	dir = 1
	},
/turf/open/floor/mineral/plastitanium/red,
/area/shuttle/hunter)
"Y" = (
/obj/machinery/suit_storage_unit/standard_unit{
	dir = 1
	},
/turf/open/floor/mineral/plastitanium,
/area/shuttle/hunter)

(1,1,1) = {"
a
a
a
a
a
a
a
a
a
a
a
a
a
a
a
a"}(2,1,1) = {"
a
a
a
a
a
a
b
c
c
b
a
a
a
a
a
a"}(3,1,1) = {"
a
c
c
a
b
b
b
d
d
b
b
b
a
c
c
a"}(4,1,1) = {"
b
d
d
b
b
F
B
B
x
t
p
b
b
d
d
b"}(5,1,1) = {"
b
L
g
b
H
u
u
q
q
u
q
j
b
g
e
b"}(6,1,1) = {"
b
L
g
O
k
k
D
k
k
k
k
k
O
g
e
b"}(7,1,1) = {"
b
L
g
b
I
Q
Y
Y
Y
Y
k
x
b
g
f
b"}(8,1,1) = {"
b
b
b
b
b
O
b
b
b
b
O
b
b
b
b
b"}(9,1,1) = {"
a
b
b
b
N
k
b
y
y
b
k
m
b
b
b
a"}(10,1,1) = {"
a
a
a
M
k
k
v
y
y
v
k
k
X
a
a
a"}(11,1,1) = {"
a
a
a
b
J
r
b
y
y
b
r
n
b
a
a
a"}(12,1,1) = {"
a
a
a
b
b
O
b
b
b
b
O
b
b
a
a
a"}(13,1,1) = {"
a
a
a
b
o
k
k
z
z
r
k
o
b
a
a
a"}(14,1,1) = {"
a
a
a
b
b
G
E
C
A
w
s
b
b
a
a
a"}(15,1,1) = {"
a
a
a
a
b
b
v
v
v
v
b
b
a
a
a
a"}