//MAP CONVERTED BY dmm2tgm.py THIS HEADER COMMENT PREVENTS RECONVERSION, DO NOT REMOVE
"a" = (
/turf/closed/wall/mineral/titanium,
/area/shuttle/labor)
"b" = (
/obj/effect/spawner/structure/window/shuttle{
	dir = 1
	},
/turf/open/floor/plating,
/area/shuttle/labor)
"c" = (
/obj/machinery/computer/shuttle_flight/labor{
	dir = 4
	},
/obj/structure/reagent_dispensers/peppertank{
	pixel_x = -31;
	dir = 1
	},
/obj/effect/turf_decal/bot{
	dir = 4
	},
/turf/open/floor/mineral/plastitanium,
/area/shuttle/labor)
"d" = (
/obj/structure/chair/comfy/shuttle{
	dir = 2
	},
/turf/open/floor/mineral/plastitanium,
/area/shuttle/labor)
"e" = (
/obj/structure/table{
	dir = 1
	},
/obj/item/folder/red{
	dir = 1
	},
/obj/item/restraints/handcuffs{
	dir = 1
	},
/turf/open/floor/mineral/plastitanium,
/area/shuttle/labor)
"f" = (
/obj/effect/turf_decal/tile/neutral{
	dir = 4
	},
/obj/effect/turf_decal/tile/neutral{
	dir = 8
	},
/obj/effect/turf_decal/stripes/line{
	dir = 10
	},
/obj/effect/turf_decal/stripes/corner{
	dir = 4
	},
/turf/open/floor/mineral/plastitanium/red,
/area/shuttle/labor)
"g" = (
/obj/machinery/button/flasher{
	id = "gulagshuttleflasher";
	name = "Flash Control";
	pixel_y = 26;
	req_access_txt = "1";
	dir = 1
	},
/obj/machinery/light{
	dir = 1
	},
/obj/effect/turf_decal/tile/neutral{
	dir = 4
	},
/obj/effect/turf_decal/tile/neutral{
	dir = 8
	},
/obj/effect/turf_decal/stripes/line{
	dir = 2
	},
/obj/effect/turf_decal/stripes/line{
	dir = 1
	},
/turf/open/floor/mineral/plastitanium/red,
/area/shuttle/labor)
"h" = (
/obj/machinery/mineral/stacking_unit_console{
	machinedir = 2;
	pixel_x = 30;
	pixel_y = -30;
	dir = 1
	},
/obj/effect/turf_decal/tile/neutral{
	dir = 4
	},
/obj/effect/turf_decal/tile/neutral{
	dir = 8
	},
/obj/effect/turf_decal/stripes/line{
	dir = 2
	},
/obj/effect/turf_decal/stripes/line{
	dir = 1
	},
/turf/open/floor/mineral/plastitanium/red,
/area/shuttle/labor)
"i" = (
/obj/machinery/door/airlock/titanium{
	name = "Labor Shuttle Airlock";
	req_access_txt = "2";
	dir = 1
	},
/obj/effect/turf_decal/stripes/line{
	dir = 4
	},
/obj/effect/turf_decal/stripes/line{
	dir = 8
	},
/turf/open/floor/mineral/plastitanium,
/area/shuttle/labor)
"j" = (
/obj/machinery/door/airlock/titanium{
	name = "Labor Shuttle Airlock";
	req_access_txt = "2";
	dir = 1
	},
/obj/effect/turf_decal/stripes/line{
	dir = 1
	},
/obj/effect/turf_decal/stripes/line{
	dir = 2
	},
/turf/open/floor/mineral/plastitanium,
/area/shuttle/labor)
"k" = (
/obj/machinery/mineral/stacking_machine/laborstacker{
	input_dir = 2;
	output_dir = 1;
	dir = 1
	},
/obj/effect/turf_decal/stripes/line{
	dir = 8
	},
/obj/effect/turf_decal/stripes/line{
	dir = 4
	},
/turf/open/floor/mineral/plastitanium,
/area/shuttle/labor)
"l" = (
/obj/effect/turf_decal/tile/neutral{
	dir = 4
	},
/obj/effect/turf_decal/tile/neutral{
	dir = 8
	},
/obj/effect/turf_decal/stripes/line{
	dir = 8
	},
/obj/effect/turf_decal/stripes/corner{
	dir = 2
	},
/turf/open/floor/mineral/plastitanium/red,
/area/shuttle/labor)
"m" = (
/obj/machinery/light{
	dir = 2
	},
/obj/effect/turf_decal/tile/neutral{
	dir = 4
	},
/obj/effect/turf_decal/tile/neutral{
	dir = 8
	},
/obj/effect/turf_decal/stripes/line{
	dir = 2
	},
/turf/open/floor/mineral/plastitanium/red,
/area/shuttle/labor)
"n" = (
/obj/machinery/mineral/labor_claim_console{
	machinedir = 1;
	pixel_x = 30;
	dir = 1
	},
/obj/effect/turf_decal/tile/neutral{
	dir = 4
	},
/obj/effect/turf_decal/tile/neutral{
	dir = 8
	},
/obj/effect/turf_decal/stripes/line{
	dir = 6
	},
/turf/open/floor/mineral/plastitanium/red,
/area/shuttle/labor)
"o" = (
/obj/effect/turf_decal/tile/neutral{
	dir = 4
	},
/obj/effect/turf_decal/tile/neutral{
	dir = 8
	},
/obj/structure/chair/comfy/shuttle{
	dir = 4
	},
/obj/effect/turf_decal/stripes/line{
	dir = 9
	},
/turf/open/floor/mineral/plastitanium/red,
/area/shuttle/labor)
"p" = (
/obj/effect/turf_decal/tile/neutral{
	dir = 4
	},
/obj/effect/turf_decal/tile/neutral{
	dir = 8
	},
/obj/effect/turf_decal/stripes/line{
	dir = 1
	},
/turf/open/floor/mineral/plastitanium/red,
/area/shuttle/labor)
"q" = (
/obj/machinery/flasher{
	id = "gulagshuttleflasher";
	pixel_x = 25;
	dir = 1
	},
/obj/effect/turf_decal/tile/neutral{
	dir = 4
	},
/obj/effect/turf_decal/tile/neutral{
	dir = 8
	},
/obj/structure/chair/comfy/shuttle{
	dir = 8
	},
/obj/effect/turf_decal/stripes/line{
	dir = 5
	},
/turf/open/floor/mineral/plastitanium/red,
/area/shuttle/labor)
"r" = (
/obj/effect/turf_decal/tile/brown{
	dir = 4
	},
/obj/effect/turf_decal/tile/brown{
	dir = 8
	},
/obj/structure/closet/crate{
	dir = 1
	},
/obj/effect/turf_decal/delivery{
	dir = 4
	},
/obj/effect/turf_decal/stripes/line{
	dir = 1
	},
/turf/open/floor/mineral/titanium/yellow,
/area/shuttle/labor)
"s" = (
/obj/effect/turf_decal/tile/brown{
	dir = 4
	},
/obj/effect/turf_decal/tile/brown{
	dir = 8
	},
/obj/effect/turf_decal/loading_area{
	dir = 2
	},
/obj/effect/turf_decal/stripes/line{
	dir = 1
	},
/turf/open/floor/mineral/titanium/yellow,
/area/shuttle/labor)
"t" = (
/obj/effect/turf_decal/tile/brown{
	dir = 4
	},
/obj/effect/turf_decal/tile/brown{
	dir = 8
	},
/obj/effect/turf_decal/stripes/line{
	dir = 1
	},
/turf/open/floor/mineral/titanium/yellow,
/area/shuttle/labor)
"u" = (
/obj/machinery/door/airlock/titanium{
	id_tag = "prisonshuttle";
	name = "Labor Shuttle Airlock";
	dir = 1
	},
/obj/docking_port/mobile{
	dir = 8;
	dwidth = 6;
	height = 5;
	id = "laborcamp";
	name = "labor camp shuttle";
	port_direction = 4;
	width = 9
	},
/obj/effect/turf_decal/stripes/line{
	dir = 4
	},
/obj/effect/turf_decal/stripes/line{
	dir = 8
	},
/turf/open/floor/mineral/plastitanium,
/area/shuttle/labor)
"v" = (
/turf/closed/wall/mineral/titanium/nodiagonal,
/area/shuttle/labor)
"w" = (
/obj/effect/spawner/structure/window/shuttle{
	dir = 1
	},
/obj/structure/shuttle/engine/heater{
	dir = 1
	},
/turf/open/floor/plating,
/area/shuttle/labor)
"x" = (
/turf/closed/wall/mineral/plastitanium,
/area/shuttle/labor)
"y" = (
/obj/structure/shuttle/engine/propulsion{
	dir = 1
	},
/turf/open/floor/plating/airless,
/area/shuttle/labor)

(1,1,1) = {"
x
v
b
a
b
a
b
a
a"}(2,1,1) = {"
y
w
r
o
l
j
f
c
b"}(3,1,1) = {"
y
w
s
p
m
a
g
d
b"}(4,1,1) = {"
y
w
t
q
n
k
h
e
b"}(5,1,1) = {"
x
v
u
a
a
a
i
a
a"}