//MAP CONVERTED BY dmm2tgm.py THIS HEADER COMMENT PREVENTS RECONVERSION, DO NOT REMOVE
"a" = (
/turf/closed/wall/mineral/titanium/survival,
/area/shuttle/mining)
"b" = (
/obj/effect/spawner/structure/window/hollow/survival_pod/directional{
	dir = 2
	},
/turf/open/floor/plating,
/area/shuttle/mining)
"c" = (
/obj/structure/table/reinforced{
	dir = 1
	},
/obj/item/storage/toolbox/emergency{
	dir = 1
	},
/obj/effect/turf_decal/stripes/line{
	dir = 10
	},
/obj/machinery/light/small{
	dir = 8
	},
/turf/open/floor/pod/dark,
/area/shuttle/mining)
"d" = (
/obj/machinery/computer/shuttle_flight/mining{
	dir = 1
	},
/obj/effect/decal/cleanable/dirt{
	dir = 4
	},
/obj/effect/turf_decal/stripes/line{
	dir = 2
	},
/turf/open/floor/pod/dark,
/area/shuttle/mining)
"e" = (
/obj/structure/table/reinforced{
	dir = 1
	},
/obj/effect/decal/cleanable/dirt{
	dir = 4
	},
/obj/item/crowbar/red{
	dir = 1
	},
/obj/item/wrench{
	dir = 1
	},
/obj/item/tank/internals/emergency_oxygen{
	dir = 1
	},
/obj/item/clothing/mask/gas{
	dir = 1
	},
/obj/effect/turf_decal/stripes/line{
	dir = 6
	},
/obj/machinery/light/small{
	dir = 4
	},
/turf/open/floor/pod/dark,
/area/shuttle/mining)
"f" = (
/obj/effect/turf_decal/stripes/line{
	dir = 8
	},
/turf/open/floor/pod/dark,
/area/shuttle/mining)
"g" = (
/obj/structure/chair/comfy/shuttle{
	dir = 2
	},
/obj/effect/turf_decal/tile/neutral{
	dir = 8
	},
/obj/effect/turf_decal/tile/neutral{
	dir = 4
	},
/obj/effect/turf_decal/tile/neutral{
	dir = 2
	},
/obj/effect/turf_decal/tile/neutral{
	dir = 1
	},
/turf/open/floor/pod/dark,
/area/shuttle/mining)
"h" = (
/obj/effect/decal/cleanable/dirt{
	dir = 4
	},
/obj/effect/decal/cleanable/blood/old{
	dir = 4
	},
/obj/effect/turf_decal/stripes/line{
	dir = 4
	},
/turf/open/floor/pod/dark,
/area/shuttle/mining)
"i" = (
/obj/effect/turf_decal/stripes/line{
	dir = 8
	},
/obj/effect/turf_decal/stripes/line{
	dir = 4
	},
/obj/docking_port/mobile{
	dir = 4;
	dwidth = 3;
	height = 5;
	id = "mining";
	name = "mining shuttle";
	port_direction = 8;
	width = 7
	},
/obj/effect/mapping_helpers/airlock/cyclelink_helper{
	dir = 4
	},
/obj/machinery/door/airlock/survival_pod/glass{
	dir = 1
	},
/obj/structure/fans/tiny{
	dir = 1
	},
/turf/open/floor/pod/light,
/area/shuttle/mining)
"j" = (
/obj/effect/decal/cleanable/dirt{
	dir = 4
	},
/obj/effect/turf_decal/stripes/line{
	dir = 8
	},
/turf/open/floor/pod/dark,
/area/shuttle/mining)
"k" = (
/obj/effect/turf_decal/tile/neutral{
	dir = 8
	},
/obj/effect/turf_decal/tile/neutral{
	dir = 4
	},
/obj/effect/turf_decal/tile/neutral{
	dir = 2
	},
/obj/effect/turf_decal/tile/neutral{
	dir = 1
	},
/turf/open/floor/pod/dark,
/area/shuttle/mining)
"l" = (
/obj/effect/turf_decal/stripes/line{
	dir = 4
	},
/turf/open/floor/pod/dark,
/area/shuttle/mining)
"m" = (
/obj/effect/turf_decal/stripes/line{
	dir = 8
	},
/obj/effect/turf_decal/stripes/line{
	dir = 4
	},
/obj/effect/mapping_helpers/airlock/cyclelink_helper{
	dir = 8
	},
/obj/machinery/door/airlock/survival_pod/glass{
	dir = 1
	},
/obj/structure/fans/tiny{
	dir = 1
	},
/turf/open/floor/pod/light,
/area/shuttle/mining)
"n" = (
/obj/structure/chair/comfy/shuttle{
	dir = 2
	},
/obj/effect/decal/cleanable/dirt{
	dir = 4
	},
/obj/effect/turf_decal/stripes/end{
	dir = 1
	},
/turf/open/floor/pod/dark,
/area/shuttle/mining)
"o" = (
/obj/structure/chair/comfy/shuttle{
	dir = 2
	},
/obj/effect/decal/cleanable/dirt{
	dir = 4
	},
/obj/effect/turf_decal/stripes/line{
	dir = 1
	},
/obj/effect/turf_decal/stripes/line{
	dir = 2
	},
/turf/open/floor/pod/dark,
/area/shuttle/mining)
"p" = (
/obj/structure/chair/comfy/shuttle{
	dir = 2
	},
/obj/effect/decal/cleanable/dirt{
	dir = 4
	},
/obj/effect/turf_decal/stripes/end{
	dir = 2
	},
/turf/open/floor/pod/dark,
/area/shuttle/mining)
"q" = (
/obj/item/clothing/suit/hazardvest{
	desc = "A high-visibility lifejacket complete with whistle and slot for oxygen tanks.";
	name = "emergency lifejacket";
	dir = 1
	},
/obj/item/clothing/suit/hazardvest{
	desc = "A high-visibility lifejacket complete with whistle and slot for oxygen tanks.";
	name = "emergency lifejacket";
	dir = 1
	},
/obj/item/clothing/suit/hazardvest{
	desc = "A high-visibility lifejacket complete with whistle and slot for oxygen tanks.";
	name = "emergency lifejacket";
	dir = 1
	},
/obj/item/clothing/suit/hazardvest{
	desc = "A high-visibility lifejacket complete with whistle and slot for oxygen tanks.";
	name = "emergency lifejacket";
	dir = 1
	},
/obj/item/clothing/suit/hazardvest{
	desc = "A high-visibility lifejacket complete with whistle and slot for oxygen tanks.";
	name = "emergency lifejacket";
	dir = 1
	},
/obj/item/tank/internals/emergency_oxygen{
	pixel_x = 3;
	dir = 1
	},
/obj/item/tank/internals/emergency_oxygen{
	pixel_x = 3;
	dir = 1
	},
/obj/item/tank/internals/emergency_oxygen{
	pixel_x = 3;
	dir = 1
	},
/obj/item/tank/internals/emergency_oxygen{
	pixel_x = 3;
	dir = 1
	},
/obj/item/tank/internals/emergency_oxygen{
	pixel_x = 3;
	dir = 1
	},
/obj/item/clothing/mask/breath{
	pixel_x = -3;
	pixel_y = 3;
	dir = 1
	},
/obj/item/clothing/mask/breath{
	pixel_x = -3;
	pixel_y = 3;
	dir = 1
	},
/obj/item/clothing/mask/breath{
	pixel_x = -3;
	pixel_y = 3;
	dir = 1
	},
/obj/item/clothing/mask/breath{
	pixel_x = -3;
	pixel_y = 3;
	dir = 1
	},
/obj/item/clothing/mask/breath{
	pixel_x = -3;
	pixel_y = 3;
	dir = 1
	},
/obj/item/clothing/head/hardhat/orange{
	name = "protective hat";
	pixel_y = -9;
	dir = 1
	},
/obj/item/clothing/head/hardhat/orange{
	name = "protective hat";
	pixel_y = -9;
	dir = 1
	},
/obj/item/clothing/head/hardhat/orange{
	name = "protective hat";
	pixel_y = -9;
	dir = 1
	},
/obj/item/clothing/head/hardhat/orange{
	name = "protective hat";
	pixel_y = -9;
	dir = 1
	},
/obj/item/clothing/head/hardhat/orange{
	name = "protective hat";
	pixel_y = -9;
	dir = 1
	},
/obj/structure/closet/crate/internals{
	dir = 1
	},
/obj/effect/decal/cleanable/dirt{
	dir = 4
	},
/obj/item/pickaxe/emergency{
	dir = 1
	},
/obj/item/pickaxe/emergency{
	dir = 1
	},
/obj/effect/turf_decal/delivery{
	dir = 4
	},
/obj/machinery/light/small{
	dir = 8
	},
/turf/open/floor/pod/dark,
/area/shuttle/mining)
"r" = (
/obj/structure/shuttle/engine/heater{
	dir = 1
	},
/obj/structure/window/reinforced{
	dir = 4
	},
/obj/structure/window/reinforced{
	dir = 2
	},
/obj/structure/window/reinforced{
	dir = 8
	},
/obj/effect/turf_decal/stripes/line{
	dir = 1
	},
/turf/open/floor/plating/airless,
/area/shuttle/mining)
"s" = (
/obj/structure/ore_box{
	dir = 1
	},
/obj/effect/decal/cleanable/dirt{
	dir = 4
	},
/obj/effect/turf_decal/delivery{
	dir = 4
	},
/obj/machinery/light/small{
	dir = 4
	},
/turf/open/floor/pod/dark,
/area/shuttle/mining)
"t" = (
/obj/structure/shuttle/engine/propulsion/burst{
	dir = 1
	},
/obj/structure/window/reinforced{
	dir = 2;
	layer = 2.9
	},
/obj/effect/turf_decal/stripes/line{
	dir = 1
	},
/turf/open/floor/plating/airless,
/area/shuttle/mining)
"J" = (
/obj/effect/spawner/structure/window/hollow/survival_pod/directional{
	dir = 4
	},
/turf/open/floor/plating,
/area/shuttle/mining)
"Q" = (
/obj/effect/spawner/structure/window/hollow/survival_pod/directional{
	dir = 8
	},
/turf/open/floor/plating,
/area/shuttle/mining)
"S" = (
/turf/closed/wall/mineral/titanium/survival/nodiagonal,
/area/shuttle/mining)

(1,1,1) = {"
a
S
Q
i
Q
S
a"}(2,1,1) = {"
S
q
n
j
f
c
S"}(3,1,1) = {"
t
r
o
k
g
d
b"}(4,1,1) = {"
S
s
p
l
h
e
S"}(5,1,1) = {"
a
S
J
m
J
S
a"}