//MAP CONVERTED BY dmm2tgm.py THIS HEADER COMMENT PREVENTS RECONVERSION, DO NOT REMOVE
"a" = (
/obj/structure/shuttle/engine/propulsion,
/turf/closed/wall/mineral/titanium,
/area/shuttle/science)
"c" = (
/obj/machinery/button/door{
	id = "sciencecargo";
	name = "Cargo Blast Door Toggle";
	pixel_x = -24
	},
/obj/structure/table/reinforced,
/obj/machinery/light{
	dir = 8;
	light_color = "#e8eaff"
	},
/obj/item/storage/toolbox/mechanical,
/obj/item/clothing/glasses/science,
/turf/open/floor/mineral/titanium/purple,
/area/shuttle/science)
"d" = (
/obj/effect/spawner/structure/window/shuttle,
/turf/open/floor/plating,
/area/shuttle/science)
"g" = (
/obj/machinery/computer/shuttle/science,
/turf/open/floor/mineral/titanium/white,
/area/shuttle/science)
"h" = (
/obj/machinery/light{
	dir = 8;
	light_color = "#e8eaff"
	},
/obj/effect/turf_decal/box,
/turf/open/floor/mineral/titanium/white,
/area/shuttle/science)
"i" = (
/obj/structure/closet/crate/science,
/obj/item/circuitboard/computer/science_shuttle,
/obj/item/stack/sheet/glass,
/obj/item/stack/sheet/glass,
/obj/item/stack/cable_coil/orange,
/obj/item/storage/toolbox/electrical,
/turf/open/floor/mineral/titanium/white,
/area/shuttle/science)
"n" = (
/obj/structure/table/reinforced,
/obj/machinery/light{
	dir = 4
	},
/turf/open/floor/mineral/titanium/purple,
/area/shuttle/science)
"o" = (
/obj/effect/turf_decal/box,
/turf/open/floor/mineral/titanium/purple,
/area/shuttle/science)
"r" = (
/obj/machinery/door/airlock/titanium,
/obj/docking_port/mobile{
	dir = 8;
	dwidth = 6;
	height = 6;
	id = "science";
	name = "science shuttle";
	port_direction = 4;
	width = 9
	},
/obj/structure/cable/yellow{
	icon_state = "4-8"
	},
/turf/open/floor/mineral/titanium/white,
/area/shuttle/science)
"s" = (
/obj/structure/cable/yellow,
/obj/machinery/power/apc/auto_name/east,
/obj/effect/mapping_helpers/apc/discharged,
/obj/structure/janitorialcart,
/obj/item/mop,
/turf/open/floor/mineral/titanium/purple,
/area/shuttle/science)
"t" = (
/turf/closed/wall/mineral/titanium/nodiagonal,
/area/shuttle/science)
"x" = (
/obj/structure/cable/yellow{
	icon_state = "2-4"
	},
/turf/open/floor/mineral/titanium/white,
/area/shuttle/science)
"y" = (
/turf/closed/wall/mineral/titanium,
/area/shuttle/science)
"z" = (
/obj/effect/spawner/structure/window/plasma/reinforced,
/turf/open/floor/mineral/titanium/white,
/area/shuttle/science)
"A" = (
/obj/machinery/modular_computer/console/preset/research,
/turf/open/floor/mineral/titanium/white,
/area/shuttle/science)
"H" = (
/obj/machinery/door/poddoor{
	id = "sciencecargo"
	},
/turf/open/floor/mineral/titanium/white,
/area/shuttle/science)
"I" = (
/obj/structure/shuttle/engine/heater,
/turf/closed/wall/mineral/titanium,
/area/shuttle/science)
"J" = (
/obj/effect/turf_decal/box,
/turf/open/floor/mineral/titanium/white,
/area/shuttle/science)
"K" = (
/turf/open/floor/mineral/titanium/purple,
/area/shuttle/science)
"N" = (
/obj/structure/tank_dispenser,
/turf/open/floor/mineral/titanium/purple,
/area/shuttle/science)
"Q" = (
/obj/structure/chair/comfy/shuttle{
	dir = 1
	},
/turf/open/floor/mineral/titanium/white,
/area/shuttle/science)
"S" = (
/turf/open/floor/mineral/titanium/white,
/area/shuttle/science)
"U" = (
/obj/machinery/portable_atmospherics/canister/air,
/turf/open/floor/mineral/titanium/white,
/area/shuttle/science)

(1,1,1) = {"
y
y
y
y
y
y
y
I
a
"}
(2,1,1) = {"
d
c
i
N
y
K
h
o
y
"}
(3,1,1) = {"
d
g
Q
U
z
S
J
J
y
"}
(4,1,1) = {"
d
A
Q
S
z
S
J
J
y
"}
(5,1,1) = {"
d
n
x
s
y
K
J
o
y
"}
(6,1,1) = {"
y
y
r
y
t
H
H
I
a
"}
