//MAP CONVERTED BY dmm2tgm.py THIS HEADER COMMENT PREVENTS RECONVERSION, DO NOT REMOVE
"a" = (
/obj/structure/shuttle/engine/propulsion{
	dir = 1
	},
/turf/closed/wall/mineral/titanium,
/area/shuttle/science)
"c" = (
/obj/machinery/button/door{
	id = "sciencecargo";
	name = "Cargo Blast Door Toggle";
	pixel_x = -24;
	dir = 1
	},
/obj/structure/table/reinforced{
	dir = 1
	},
/obj/machinery/light{
	dir = 8;
	light_color = "#e8eaff"
	},
/obj/item/storage/toolbox/mechanical{
	dir = 1
	},
/obj/item/clothing/glasses/science{
	dir = 1
	},
/turf/open/floor/mineral/titanium/purple,
/area/shuttle/science)
"d" = (
/obj/effect/spawner/structure/window/shuttle{
	dir = 1
	},
/turf/open/floor/plating,
/area/shuttle/science)
"g" = (
/obj/machinery/computer/shuttle_flight/science{
	dir = 1
	},
/turf/open/floor/mineral/titanium/white,
/area/shuttle/science)
"h" = (
/obj/machinery/light{
	dir = 8;
	light_color = "#e8eaff"
	},
/obj/effect/turf_decal/box{
	dir = 4
	},
/turf/open/floor/mineral/titanium/white,
/area/shuttle/science)
"i" = (
/obj/structure/closet/crate/science{
	dir = 1
	},
/obj/item/circuitboard/computer/shuttle/science_shuttle{
	dir = 1
	},
/obj/item/stack/sheet/glass{
	dir = 1
	},
/obj/item/stack/sheet/glass{
	dir = 1
	},
/obj/item/stack/cable_coil/orange,
/obj/item/storage/toolbox/electrical{
	dir = 1
	},
/turf/open/floor/mineral/titanium/white,
/area/shuttle/science)
"n" = (
/obj/structure/table/reinforced{
	dir = 1
	},
/obj/machinery/light{
	dir = 4
	},
/turf/open/floor/mineral/titanium/purple,
/area/shuttle/science)
"o" = (
/obj/effect/turf_decal/box{
	dir = 4
	},
/turf/open/floor/mineral/titanium/purple,
/area/shuttle/science)
"r" = (
/obj/machinery/door/airlock/titanium{
	dir = 1
	},
/obj/docking_port/mobile{
	dir = 8;
	dwidth = 2;
	height = 6;
	id = "science";
	name = "science shuttle";
	port_direction = 4;
	width = 9
	},
/obj/structure/cable/yellow{
	icon_state = "4-8"
	},
/obj/structure/fans/tiny{
	dir = 1
	},
/turf/open/floor/mineral/titanium/white,
/area/shuttle/science)
"s" = (
/obj/structure/cable/yellow{
	icon_state = "0-2"
	},
/obj/machinery/power/apc/auto_name/east,
/obj/structure/janitorialcart{
	dir = 1
	},
/obj/item/mop{
	dir = 1
	},
/turf/open/floor/mineral/titanium/purple,
/area/shuttle/science)
"t" = (
/turf/closed/wall/mineral/titanium/nodiagonal,
/area/shuttle/science)
"x" = (
/obj/structure/cable/yellow{
	icon_state = "1-4"
	},
/turf/open/floor/mineral/titanium/white,
/area/shuttle/science)
"y" = (
/turf/closed/wall/mineral/titanium,
/area/shuttle/science)
"z" = (
/obj/effect/spawner/structure/window/plasma/reinforced{
	dir = 1
	},
/turf/open/floor/mineral/titanium/white,
/area/shuttle/science)
"A" = (
/obj/machinery/modular_computer/console/preset/research{
	dir = 1
	},
/turf/open/floor/mineral/titanium/white,
/area/shuttle/science)
"H" = (
/obj/machinery/door/poddoor{
	id = "sciencecargo";
	dir = 1
	},
/obj/structure/fans/tiny{
	dir = 1
	},
/turf/open/floor/mineral/titanium/white,
/area/shuttle/science)
"I" = (
/obj/structure/shuttle/engine/heater{
	dir = 1
	},
/turf/closed/wall/mineral/titanium,
/area/shuttle/science)
"J" = (
/obj/effect/turf_decal/box{
	dir = 4
	},
/turf/open/floor/mineral/titanium/white,
/area/shuttle/science)
"K" = (
/turf/open/floor/mineral/titanium/purple,
/area/shuttle/science)
"N" = (
/obj/structure/tank_dispenser{
	dir = 1
	},
/turf/open/floor/mineral/titanium/purple,
/area/shuttle/science)
"Q" = (
/obj/structure/chair/comfy/shuttle{
	dir = 2
	},
/turf/open/floor/mineral/titanium/white,
/area/shuttle/science)
"S" = (
/turf/open/floor/mineral/titanium/white,
/area/shuttle/science)
"U" = (
/obj/machinery/portable_atmospherics/canister/air{
	dir = 1
	},
/turf/open/floor/mineral/titanium/white,
/area/shuttle/science)

(1,1,1) = {"
a
I
y
y
y
y
y
y
y"}(2,1,1) = {"
y
o
h
K
y
N
i
c
d"}(3,1,1) = {"
y
J
J
S
z
U
Q
g
d"}(4,1,1) = {"
y
J
J
S
z
S
Q
A
d"}(5,1,1) = {"
y
o
J
K
y
s
x
n
d"}(6,1,1) = {"
a
I
H
H
t
y
r
y
y"}