//MAP CONVERTED BY dmm2tgm.py THIS HEADER COMMENT PREVENTS RECONVERSION, DO NOT REMOVE
"d" = (
/obj/effect/spawner/structure/window/shuttle,
/turf/open/floor/plating,
/area/shuttle/science)
"g" = (
/obj/machinery/computer/shuttle_flight/science,
/turf/open/floor/mineral/titanium/white,
/area/shuttle/science)
"i" = (
/obj/structure/closet/crate/science,
/obj/item/circuitboard/computer/science_shuttle,
/obj/item/stack/sheet/glass,
/obj/item/stack/sheet/glass,
/obj/item/stack/cable_coil/orange,
/obj/item/storage/toolbox/electrical,
/turf/open/floor/mineral/titanium/white,
/area/shuttle/science)
"j" = (
/obj/effect/turf_decal/box,
/obj/machinery/light{
	dir = 8;
	light_color = "#e8eaff"
	},
/turf/open/floor/mineral/titanium/purple,
/area/shuttle/science)
"l" = (
/obj/effect/spawner/structure/window,
/turf/open/floor/plating,
/area/shuttle/science)
"m" = (
/turf/open/space/basic,
/area/shuttle/science)
"n" = (
/obj/structure/table/reinforced,
/obj/machinery/light{
	dir = 4
	},
/turf/open/floor/mineral/titanium/purple,
/area/shuttle/science)
"o" = (
/obj/effect/turf_decal/box,
/turf/open/floor/mineral/titanium/purple,
/area/shuttle/science)
"r" = (
/obj/machinery/door/airlock/titanium,
/obj/docking_port/mobile{
	dir = 8;
	dwidth = 6;
	height = 6;
	id = "science";
	name = "science shuttle";
	port_direction = 4;
	width = 9
	},
/obj/structure/cable/yellow{
	icon_state = "4-8"
	},
/obj/structure/fans/tiny,
/turf/open/floor/mineral/titanium/white,
/area/shuttle/science)
"s" = (
/obj/structure/cable/yellow,
/obj/machinery/power/apc/auto_name/east{
	pixel_x = 24
	},
/obj/structure/janitorialcart,
/obj/item/mop,
/turf/open/floor/mineral/titanium/purple,
/area/shuttle/science)
"t" = (
/turf/closed/wall/mineral/titanium/nodiagonal,
/area/shuttle/science)
"x" = (
/obj/structure/cable/yellow{
	icon_state = "2-4"
	},
/turf/open/floor/mineral/titanium/white,
/area/shuttle/science)
"y" = (
/turf/closed/wall/mineral/titanium,
/area/shuttle/science)
"D" = (
/obj/structure/shuttle/engine/propulsion,
/turf/open/floor/plating,
/area/shuttle/science)
"G" = (
/turf/closed/wall/mineral/plastitanium,
/area/shuttle/science)
"H" = (
/obj/machinery/door/poddoor{
	id = "sciencecargo"
	},
/obj/structure/fans/tiny,
/turf/open/floor/mineral/titanium/white,
/area/shuttle/science)
"J" = (
/obj/effect/turf_decal/box,
/turf/open/floor/mineral/titanium/white,
/area/shuttle/science)
"K" = (
/obj/structure/table/reinforced,
/obj/machinery/light{
	dir = 8;
	light_color = "#e8eaff"
	},
/obj/item/storage/toolbox/mechanical,
/obj/item/clothing/glasses/science,
/obj/machinery/button/door{
	id = "sciencecargo";
	name = "Cargo Blast Door Toggle";
	pixel_x = -24
	},
/turf/open/floor/mineral/titanium/purple,
/area/shuttle/science)
"L" = (
/obj/machinery/computer/objective,
/turf/open/floor/mineral/titanium/white,
/area/shuttle/science)
"N" = (
/obj/structure/tank_dispenser,
/turf/open/floor/mineral/titanium/purple,
/area/shuttle/science)
"P" = (
/turf/closed/wall/mineral/plastitanium/nodiagonal,
/area/shuttle/science)
"Q" = (
/obj/structure/chair/comfy/shuttle{
	dir = 1
	},
/turf/open/floor/mineral/titanium/white,
/area/shuttle/science)
"S" = (
/turf/open/floor/mineral/titanium/white,
/area/shuttle/science)
"U" = (
/obj/machinery/portable_atmospherics/canister/air,
/turf/open/floor/mineral/titanium/white,
/area/shuttle/science)
"W" = (
/obj/structure/shuttle/engine/heater,
/obj/structure/window/reinforced/spawner/north,
/turf/open/floor/plating,
/area/shuttle/science)

(1,1,1) = {"
y
y
y
y
y
y
t
G
m
"}
(2,1,1) = {"
d
K
i
N
y
j
J
P
G
"}
(3,1,1) = {"
d
g
Q
U
l
J
J
W
D
"}
(4,1,1) = {"
d
L
Q
S
l
J
J
W
D
"}
(5,1,1) = {"
d
n
x
s
y
o
J
P
G
"}
(6,1,1) = {"
y
y
r
y
t
H
H
G
m
"}
