"aa" = (/turf/template_noop,/area/template_noop)
"ab" = (/turf/open/floor/plating/asteroid/basalt,/area/template_noop)
"ac" = (/obj/machinery/light,/turf/open/floor/plating/asteroid/basalt,/area/survivalpod)
"ad" = (/obj/machinery/light{dir = 4},/turf/open/floor/plating/asteroid/basalt,/area/survivalpod)
"ae" = (/turf/closed/wall/mineral/titanium/survival/pod,/area/survivalpod)
"af" = (/obj/structure/sink,/turf/closed/wall/mineral/titanium/survival/pod,/area/survivalpod)
"ag" = (/turf/closed/wall/mineral/titanium/survival,/area/survivalpod)
"ah" = (/obj/item/gps/computer,/turf/closed/wall/mineral/titanium/survival/nodiagonal,/area/survivalpod)
"ai" = (/turf/closed/wall/mineral/titanium/survival/nodiagonal,/area/survivalpod)
"aj" = (/obj/structure/sign/mining/survival{dir = 8},/turf/closed/wall/mineral/titanium/survival/pod,/area/survivalpod)
"ak" = (/turf/open/floor/pod/light,/area/survivalpod)
"al" = (/obj/structure/toilet/secret,/turf/open/floor/pod/light,/area/survivalpod)
"am" = (/obj/structure/fence{dir = 4},/turf/open/floor/plating/asteroid/basalt,/area/template_noop)
"an" = (/obj/structure/fence/door,/turf/open/floor/plating/asteroid/basalt,/area/template_noop)
"ao" = (/obj/structure/closet/crate,/obj/effect/decal/cleanable/cobweb,/obj/item/mecha_parts/mecha_equipment/drill,/turf/open/floor/pod/dark,/area/survivalpod)
"ap" = (/turf/open/floor/pod/dark,/area/survivalpod)
"aq" = (/obj/machinery/mineral/equipment_vendor,/turf/open/floor/pod/dark,/area/survivalpod)
"ar" = (/obj/structure/sign/poster/official/random,/turf/closed/wall/mineral/titanium/survival/pod,/area/survivalpod)
"as" = (/obj/machinery/light/small,/turf/open/floor/pod/light,/area/survivalpod)
"at" = (/obj/effect/decal/cleanable/dirt/dust,/obj/structure/fans/tiny,/turf/open/floor/pod/light,/area/survivalpod)
"au" = (/obj/machinery/door/airlock/survival_pod,/turf/open/floor/pod/light,/area/survivalpod)
"av" = (/obj/structure/barricade/sandbags,/turf/open/floor/plating/asteroid/basalt,/area/template_noop)
"aw" = (/obj/structure/closet/crate,/obj/item/storage/toolbox/mechanical,/obj/item/stack/sheet/iron/ten,/turf/open/floor/pod/dark,/area/survivalpod)
"ax" = (/obj/structure/extinguisher_cabinet,/turf/closed/wall/mineral/titanium/survival,/area/survivalpod)
"ay" = (/obj/structure/mirror,/turf/closed/wall/mineral/titanium/survival/pod,/area/survivalpod)
"az" = (/obj/effect/turf_decal/box,/obj/structure/safe/floor,/turf/open/floor/pod/dark,/area/survivalpod)
"aA" = (/obj/effect/decal/cleanable/dirt,/obj/structure/fans/tiny,/turf/open/floor/pod/dark,/area/survivalpod)
"aB" = (/obj/structure/rack,/obj/item/mop,/obj/item/reagent_containers/glass/bucket,/obj/machinery/light/small,/obj/item/paper/fluff/itemnotice,/turf/open/floor/pod/dark,/area/survivalpod)
"aC" = (/obj/structure/fence,/turf/open/floor/plating/asteroid/basalt,/area/template_noop)
"aD" = (/obj/structure/chair/stool,/turf/open/floor/plating/asteroid/basalt,/area/template_noop)
"aE" = (/obj/effect/decal/cleanable/dirt,/obj/machinery/door/airlock/survival_pod,/turf/open/floor/pod/dark,/area/survivalpod)
"aF" = (/obj/structure/table,/obj/item/storage/bag/tray,/obj/item/kitchen/fork,/turf/open/floor/plating/asteroid/basalt,/area/template_noop)
"aG" = (/obj/structure/fence/door{dir = 4},/turf/open/floor/plating/asteroid/basalt,/area/template_noop)
"aH" = (/obj/structure/bonfire,/turf/open/floor/plating/asteroid/basalt,/area/template_noop)
"aI" = (/obj/structure/table,/obj/item/trash/coal,/turf/open/floor/plating/asteroid/basalt,/area/template_noop)
"aJ" = (/obj/structure/sign/poster/official/random,/turf/closed/wall/mineral/titanium/survival,/area/survivalpod)
"aK" = (/obj/machinery/door/airlock/survival_pod/glass,/turf/open/floor/pod/light,/area/survivalpod)
"aL" = (/obj/structure/chair{dir = 4},/turf/open/floor/pod/light,/area/survivalpod)
"aM" = (/obj/structure/table,/obj/item/lighter/greyscale,/obj/item/toy/cards/deck/cas,/turf/open/floor/pod/light,/area/survivalpod)
"aN" = (/obj/structure/sign/mining/survival{dir = 4},/turf/closed/wall/mineral/titanium/survival,/area/survivalpod)
"aO" = (/obj/structure/fans,/turf/open/floor/pod/light,/area/survivalpod)
"aP" = (/obj/machinery/suit_storage_unit,/turf/open/floor/pod/light,/area/survivalpod)
"aQ" = (/obj/effect/decal/cleanable/generic,/turf/open/floor/plating/asteroid/basalt,/area/template_noop)
"aR" = (/obj/structure/fans/tiny,/turf/open/floor/pod/light,/area/survivalpod)
"aS" = (/obj/structure/sign/mining/survival{dir = 8},/turf/closed/wall/mineral/titanium/survival,/area/survivalpod)
"aT" = (/obj/structure/closet,/obj/item/clothing/shoes/workboots/mining,/obj/item/clothing/under/rank/miner,/obj/item/clothing/gloves/fingerless,/obj/item/reagent_containers/food/drinks/beer,/obj/machinery/light{dir = 8},/obj/item/pickaxe/mini,/turf/open/floor/pod/light,/area/survivalpod)
"aU" = (/obj/structure/bed/pod,/turf/open/floor/pod/light,/area/survivalpod)
"aV" = (/obj/structure/closet/crate/bin,/obj/machinery/light{dir = 8},/turf/open/floor/pod/light,/area/survivalpod)
"aW" = (/obj/machinery/vending/mining,/turf/open/floor/pod/light,/area/survivalpod)
"aX" = (/obj/structure/closet,/obj/item/clothing/shoes/workboots/mining,/obj/item/clothing/under/rank/miner,/obj/item/clothing/gloves/fingerless,/obj/item/reagent_containers/food/drinks/beer,/obj/item/pickaxe/mini,/turf/open/floor/pod/light,/area/survivalpod)
"aY" = (/obj/structure/ore_box,/turf/open/floor/plating/asteroid/basalt,/area/template_noop)
"aZ" = (/obj/structure/sign/mining,/turf/closed/wall/mineral/titanium/survival,/area/survivalpod)
"ba" = (/obj/machinery/vending/wallmed/survival_pod,/turf/closed/wall/mineral/titanium/survival,/area/survivalpod)
"bb" = (/obj/structure/table,/obj/item/healthanalyzer,/obj/item/gps/mining,/obj/item/paper/fluff/encampmentwelcome,/turf/open/floor/pod/light,/area/survivalpod)
"bc" = (/obj/item/trash/raisins,/turf/open/floor/plating/asteroid/basalt,/area/template_noop)
"bd" = (/obj/effect/decal/cleanable/dirt,/turf/open/floor/plating/asteroid/basalt,/area/template_noop)
"be" = (/obj/machinery/sleeper/survival_pod,/turf/open/floor/pod/light,/area/survivalpod)
"bf" = (/obj/structure/noticeboard{dir = 1; pixel_y = -32},/turf/open/floor/pod/light,/area/survivalpod)
"bg" = (/obj/structure/table,/obj/machinery/light{dir = 4},/obj/structure/bedsheetbin,/turf/open/floor/pod/light,/area/survivalpod)
"bh" = (/obj/structure/fence/corner,/turf/open/floor/plating/asteroid/basalt,/area/template_noop)
"bi" = (/obj/item/clothing/head/kitty/genuine,/turf/open/floor/plating/asteroid/basalt,/area/template_noop)
"bj" = (/obj/effect/decal/cleanable/ash,/turf/open/floor/plating/asteroid/basalt,/area/template_noop)
"bk" = (/obj/machinery/light{dir = 8},/turf/open/floor/plating/asteroid/basalt,/area/survivalpod)
"bl" = (/obj/item/trash/sosjerky,/turf/open/floor/plating/asteroid/basalt,/area/template_noop)
"bm" = (/obj/machinery/light/floor,/turf/open/floor/plating/asteroid/basalt,/area/survivalpod)
"bn" = (/obj/machinery/light{dir = 1},/turf/open/floor/plating/asteroid/basalt,/area/survivalpod)
"bo" = (/obj/item/roller,/turf/open/floor/pod/dark,/area/survivalpod)
"bp" = (/obj/structure/chair{dir = 1},/turf/open/floor/pod/light,/area/survivalpod)

(1,1,1) = {"
aaaaaaaaaaaaababaaacaaaaaaaa
aaaeafaeaeabababagagahaiagaa
adajakalaeamanamagaoapaqagaa
aaarasatauababavagawapazaxaa
aaaeaeayaeababavagboaAaBagbk
aaabaCaFaIabaDabagagaEagagaa
ababaGababaDaHababababaCabaa
abbmaCababababababagaJagagaa
aaagagaKagagabababagaLaMaNaa
aaagaOakaPagababaQaKaRbpagaa
aaaSaTakaUagabababagaVaWagaa
aaagaXakaUagaYababagagagaZaa
adagbaakbbagaYabavavaCbcbdaa
aaagbebfbgagamanamambhbdabbi
aaagagagaZagabababababbjabbd
aaaaaaaabnababababababababbl
"}
