//MAP CONVERTED BY dmm2tgm.py THIS HEADER COMMENT PREVENTS RECONVERSION, DO NOT REMOVE
"an" = (
/obj/structure/chair/comfy/teal{
	dir = 2
	},
/obj/effect/decal/cleanable/dirt{
	dir = 4
	},
/obj/machinery/light{
	dir = 4
	},
/turf/open/floor/wood,
/area/shuttle/abandoned)
"bl" = (
/obj/machinery/door/airlock/titanium{
	name = "Medbay";
	dir = 1
	},
/obj/effect/decal/cleanable/dirt/dust{
	dir = 4
	},
/obj/effect/decal/cleanable/dirt{
	dir = 4
	},
/obj/effect/decal/cleanable/dirt{
	dir = 4
	},
/obj/effect/turf_decal/stripes/line{
	dir = 1
	},
/obj/effect/turf_decal/stripes/line{
	dir = 2
	},
/obj/machinery/atmospherics/pipe/simple/dark/hidden{
	dir = 4
	},
/obj/machinery/door/firedoor{
	dir = 1
	},
/obj/structure/sign/departments/medbay/alt2{
	pixel_y = -32;
	dir = 1
	},
/turf/open/floor/pod/dark,
/area/shuttle/abandoned)
"bm" = (
/obj/structure/closet/crate{
	name = "food crate";
	dir = 1
	},
/obj/item/reagent_containers/glass/waterbottle/large{
	pixel_x = -5;
	pixel_y = -3;
	dir = 1
	},
/obj/item/reagent_containers/glass/waterbottle/large{
	pixel_x = 2;
	pixel_y = -3;
	dir = 1
	},
/obj/item/reagent_containers/glass/waterbottle/large{
	pixel_x = -2;
	dir = 1
	},
/obj/item/reagent_containers/glass/waterbottle/large{
	pixel_x = 5;
	dir = 1
	},
/obj/item/reagent_containers/glass/waterbottle/large{
	pixel_x = 1;
	pixel_y = 3;
	dir = 1
	},
/obj/item/reagent_containers/glass/waterbottle/large{
	pixel_x = 8;
	pixel_y = 3;
	dir = 1
	},
/obj/item/storage/box/donkpockets{
	pixel_x = -3;
	pixel_y = -3;
	dir = 1
	},
/obj/item/storage/box/donkpockets{
	dir = 1
	},
/obj/structure/sign/warning/nosmoking{
	pixel_x = -28;
	dir = 1
	},
/turf/open/floor/mineral/titanium,
/area/shuttle/abandoned)
"bx" = (
/obj/effect/decal/cleanable/dirt{
	dir = 4
	},
/turf/open/floor/wood,
/area/shuttle/abandoned)
"cc" = (
/obj/effect/decal/cleanable/dirt{
	dir = 4
	},
/obj/machinery/vending/medical{
	req_access = null;
	dir = 1
	},
/turf/open/floor/mineral/titanium/blue,
/area/shuttle/abandoned)
"cS" = (
/turf/template_noop,
/area/template_noop)
"dc" = (
/obj/effect/turf_decal/bot{
	dir = 4
	},
/obj/structure/reagent_dispensers/fueltank{
	dir = 1
	},
/obj/item/weldingtool/largetank{
	dir = 1
	},
/turf/open/floor/mineral/titanium/yellow,
/area/shuttle/abandoned)
"dB" = (
/obj/effect/spawner/structure/window/plastitanium{
	dir = 1
	},
/turf/open/floor/plating,
/area/shuttle/abandoned)
"ec" = (
/obj/effect/decal/cleanable/dirt{
	dir = 4
	},
/obj/structure/bed{
	dir = 1
	},
/obj/item/bedsheet/random{
	dir = 1
	},
/turf/open/floor/mineral/titanium,
/area/shuttle/abandoned)
"eg" = (
/obj/machinery/door/airlock/titanium{
	name = "Restroom";
	dir = 1
	},
/obj/machinery/door/firedoor{
	dir = 1
	},
/obj/effect/decal/cleanable/dirt{
	dir = 4
	},
/turf/open/floor/plasteel/freezer,
/area/shuttle/abandoned)
"eJ" = (
/obj/effect/turf_decal/stripes/full{
	dir = 1
	},
/obj/machinery/door/poddoor{
	id = "botanyShipR";
	dir = 1
	},
/turf/open/floor/pod/dark,
/area/shuttle/abandoned)
"eO" = (
/obj/effect/decal/cleanable/dirt/dust{
	dir = 4
	},
/obj/effect/decal/cleanable/dirt/dust{
	dir = 4
	},
/obj/structure/table{
	dir = 1
	},
/obj/item/storage/box/gloves{
	pixel_x = 5;
	pixel_y = -8;
	dir = 1
	},
/obj/item/storage/box/masks{
	pixel_x = -6;
	pixel_y = -6;
	dir = 1
	},
/obj/machinery/airalarm/all_access{
	pixel_y = -22;
	dir = 1
	},
/obj/item/storage/backpack/duffelbag/med/surgery{
	pixel_y = -4;
	dir = 1
	},
/obj/item/clothing/suit/apron/surgical{
	dir = 1
	},
/obj/item/storage/firstaid/brute{
	pixel_x = 3;
	pixel_y = -3;
	dir = 1
	},
/obj/item/storage/firstaid/fire{
	dir = 1
	},
/obj/item/storage/firstaid/toxin{
	pixel_x = -3;
	pixel_y = 3;
	dir = 1
	},
/obj/item/reagent_containers/spray/cleaner{
	pixel_x = -3;
	pixel_y = -6;
	dir = 1
	},
/obj/item/clothing/glasses/hud/health{
	pixel_x = 3;
	dir = 1
	},
/turf/open/floor/mineral/titanium/blue,
/area/shuttle/abandoned)
"fy" = (
/obj/structure/shuttle/engine/heater{
	dir = 1
	},
/obj/effect/spawner/structure/window/plastitanium{
	dir = 1
	},
/turf/open/floor/plating,
/area/shuttle/abandoned)
"gk" = (
/obj/effect/turf_decal/bot{
	dir = 4
	},
/obj/structure/closet/emcloset/anchored{
	dir = 1
	},
/turf/open/floor/mineral/titanium/yellow,
/area/shuttle/abandoned)
"gT" = (
/obj/effect/decal/cleanable/dirt{
	dir = 4
	},
/obj/structure/cable/yellow{
	icon_state = "2-4"
	},
/obj/machinery/atmospherics/components/unary/vent_pump/on{
	dir = 4
	},
/obj/effect/turf_decal/bot{
	dir = 4
	},
/turf/open/floor/pod/dark,
/area/shuttle/abandoned)
"hL" = (
/turf/closed/wall/mineral/titanium,
/area/shuttle/abandoned)
"hQ" = (
/obj/machinery/door/airlock/titanium{
	name = "Cockpit";
	dir = 1
	},
/obj/effect/decal/cleanable/dirt/dust{
	dir = 4
	},
/obj/effect/decal/cleanable/dirt{
	dir = 4
	},
/obj/effect/decal/cleanable/dirt{
	dir = 4
	},
/obj/effect/turf_decal/stripes/line{
	dir = 1
	},
/obj/effect/turf_decal/stripes/line{
	dir = 2
	},
/obj/machinery/atmospherics/pipe/simple/dark/hidden{
	dir = 1
	},
/obj/machinery/door/firedoor{
	dir = 1
	},
/turf/open/floor/pod/dark,
/area/shuttle/abandoned)
"il" = (
/obj/machinery/atmospherics/pipe/simple/dark/hidden{
	dir = 1
	},
/turf/open/floor/grass,
/area/shuttle/abandoned)
"iM" = (
/obj/machinery/power/port_gen/pacman{
	anchored = 1;
	dir = 1
	},
/obj/effect/decal/cleanable/dirt/dust{
	dir = 4
	},
/obj/effect/decal/cleanable/dirt/dust{
	dir = 4
	},
/obj/effect/turf_decal/bot{
	dir = 4
	},
/obj/item/wrench{
	dir = 1
	},
/obj/structure/cable{
	icon_state = "0-4"
	},
/turf/open/floor/plating,
/area/shuttle/abandoned)
"iV" = (
/obj/effect/decal/cleanable/dirt/dust{
	dir = 4
	},
/obj/effect/decal/cleanable/dirt/dust{
	dir = 4
	},
/obj/machinery/shower{
	pixel_y = -15;
	dir = 1
	},
/obj/structure/curtain{
	dir = 1
	},
/turf/open/floor/plasteel/freezer,
/area/shuttle/abandoned)
"jb" = (
/obj/effect/decal/cleanable/dirt{
	dir = 4
	},
/obj/structure/closet/firecloset{
	anchored = 1;
	dir = 1
	},
/obj/effect/decal/cleanable/dirt{
	dir = 4
	},
/obj/machinery/atmospherics/components/unary/vent_pump/on{
	dir = 2
	},
/obj/effect/turf_decal/bot{
	dir = 4
	},
/turf/open/floor/mineral/titanium/yellow,
/area/shuttle/abandoned)
"jR" = (
/obj/machinery/door/airlock/titanium{
	name = "Power unit";
	dir = 1
	},
/obj/effect/decal/cleanable/dirt/dust{
	dir = 4
	},
/obj/effect/decal/cleanable/dirt{
	dir = 4
	},
/obj/effect/decal/cleanable/dirt{
	dir = 4
	},
/obj/effect/turf_decal/stripes/line{
	dir = 8
	},
/obj/effect/turf_decal/stripes/line{
	dir = 4
	},
/obj/structure/cable/yellow{
	icon_state = "4-8"
	},
/obj/machinery/atmospherics/pipe/simple/dark/hidden{
	dir = 4
	},
/obj/machinery/door/firedoor{
	dir = 1
	},
/turf/open/floor/pod/dark,
/area/shuttle/abandoned)
"kH" = (
/obj/structure/bed{
	dir = 1
	},
/obj/item/bedsheet/random{
	dir = 1
	},
/obj/structure/glowshroom/single{
	dir = 1
	},
/obj/effect/decal/cleanable/dirt{
	dir = 4
	},
/turf/open/floor/mineral/titanium,
/area/shuttle/abandoned)
"la" = (
/obj/effect/decal/cleanable/dirt{
	dir = 4
	},
/obj/machinery/atmospherics/pipe/manifold/dark/hidden{
	dir = 4
	},
/turf/open/floor/mineral/titanium/blue,
/area/shuttle/abandoned)
"lA" = (
/obj/effect/decal/cleanable/dirt{
	dir = 4
	},
/obj/effect/decal/cleanable/dirt{
	dir = 4
	},
/obj/machinery/suit_storage_unit/standard_unit{
	dir = 1
	},
/obj/effect/turf_decal/bot{
	dir = 4
	},
/obj/structure/sign/warning/vacuum/external{
	pixel_y = 32;
	dir = 1
	},
/turf/open/floor/pod/dark,
/area/shuttle/abandoned)
"lE" = (
/turf/closed/wall/mineral/titanium/nodiagonal,
/area/shuttle/abandoned)
"lF" = (
/turf/closed/wall/mineral/plastitanium/nodiagonal,
/area/shuttle/abandoned)
"mg" = (
/obj/machinery/firealarm{
	pixel_y = -26;
	dir = 1
	},
/turf/open/floor/grass,
/area/shuttle/abandoned)
"mt" = (
/obj/effect/turf_decal/stripes/line{
	dir = 2
	},
/obj/structure/shuttle/engine/propulsion/right{
	dir = 1
	},
/turf/open/floor/plating/airless,
/area/shuttle/abandoned)
"nN" = (
/obj/machinery/smartfridge{
	dir = 1
	},
/turf/closed/wall/mineral/titanium,
/area/shuttle/abandoned)
"nT" = (
/obj/effect/decal/cleanable/dirt/dust{
	dir = 4
	},
/obj/machinery/computer/shuttle_flight/white_ship{
	dir = 1
	},
/turf/open/floor/mineral/titanium/blue,
/area/shuttle/abandoned)
"nV" = (
/obj/machinery/atmospherics/pipe/simple/dark/hidden{
	dir = 5
	},
/turf/open/floor/grass,
/area/shuttle/abandoned)
"op" = (
/obj/machinery/door/airlock/external{
	dir = 1
	},
/obj/effect/mapping_helpers/airlock/cyclelink_helper{
	dir = 8
	},
/obj/effect/turf_decal/stripes/line{
	dir = 4
	},
/obj/effect/turf_decal/stripes/line{
	dir = 8
	},
/obj/machinery/atmospherics/pipe/simple/dark/hidden{
	dir = 9
	},
/obj/docking_port/mobile{
	callTime = 250;
	dir = 8;
	dwidth = 7;
	height = 11;
	id = "whiteship";
	launch_status = 0;
	movement_force = list("KNOCKDOWN" = 0, "THROW" = 0);
	name = "Eden Whiteship";
	preferred_direction = 4;
	width = 18
	},
/turf/open/floor/pod/dark,
/area/shuttle/abandoned)
"pO" = (
/obj/effect/decal/cleanable/dirt{
	dir = 4
	},
/obj/effect/turf_decal/bot{
	dir = 4
	},
/obj/machinery/power/terminal{
	dir = 8
	},
/obj/structure/cable{
	icon_state = "0-1"
	},
/turf/open/floor/pod/dark,
/area/shuttle/abandoned)
"pU" = (
/obj/effect/decal/cleanable/dirt/dust{
	dir = 4
	},
/obj/machinery/computer/operating{
	dir = 4
	},
/obj/effect/turf_decal/bot{
	dir = 4
	},
/obj/effect/decal/cleanable/dirt{
	dir = 4
	},
/turf/open/floor/mineral/titanium/blue,
/area/shuttle/abandoned)
"qb" = (
/obj/effect/turf_decal/bot{
	dir = 4
	},
/obj/structure/reagent_dispensers/watertank/high{
	dir = 1
	},
/obj/item/reagent_containers/glass/bucket{
	pixel_x = -4;
	dir = 1
	},
/obj/item/reagent_containers/glass/bucket{
	pixel_x = 4;
	dir = 1
	},
/turf/open/floor/wood,
/area/shuttle/abandoned)
"qE" = (
/obj/effect/turf_decal/bot{
	dir = 4
	},
/obj/machinery/vending/hydroseeds{
	dir = 1
	},
/turf/open/floor/wood,
/area/shuttle/abandoned)
"qX" = (
/obj/effect/decal/cleanable/dirt{
	dir = 4
	},
/obj/machinery/firealarm{
	dir = 2;
	pixel_y = 26
	},
/turf/open/floor/mineral/titanium,
/area/shuttle/abandoned)
"qZ" = (
/obj/effect/decal/cleanable/dirt/dust{
	dir = 4
	},
/obj/effect/decal/cleanable/dirt/dust{
	dir = 4
	},
/obj/structure/table/optable{
	dir = 1
	},
/obj/effect/turf_decal/delivery{
	dir = 4
	},
/obj/effect/decal/cleanable/blood/gibs/old{
	dir = 4
	},
/turf/open/floor/mineral/titanium/blue,
/area/shuttle/abandoned)
"rz" = (
/obj/effect/decal/cleanable/dirt{
	dir = 4
	},
/turf/open/floor/mineral/titanium/blue,
/area/shuttle/abandoned)
"rG" = (
/obj/effect/decal/cleanable/dirt/dust{
	dir = 4
	},
/obj/effect/decal/cleanable/dirt/dust{
	dir = 4
	},
/obj/effect/decal/cleanable/dirt/dust{
	dir = 4
	},
/obj/structure/chair/comfy/shuttle{
	dir = 2
	},
/obj/machinery/atmospherics/pipe/simple/dark/hidden{
	dir = 9
	},
/turf/open/floor/mineral/titanium/blue,
/area/shuttle/abandoned)
"rI" = (
/obj/effect/decal/cleanable/dirt{
	dir = 4
	},
/obj/effect/decal/cleanable/dirt{
	dir = 4
	},
/obj/structure/cable/yellow{
	icon_state = "4-8"
	},
/obj/machinery/atmospherics/pipe/simple/dark/hidden{
	dir = 4
	},
/obj/structure/cable{
	icon_state = "1-2"
	},
/turf/open/floor/pod/dark,
/area/shuttle/abandoned)
"rR" = (
/obj/effect/spawner/structure/window/shuttle{
	dir = 1
	},
/obj/machinery/atmospherics/pipe/simple/dark/hidden{
	dir = 10
	},
/turf/open/floor/plating,
/area/shuttle/abandoned)
"tv" = (
/obj/effect/decal/cleanable/dirt/dust{
	dir = 4
	},
/obj/effect/decal/cleanable/dirt{
	dir = 4
	},
/obj/effect/decal/cleanable/dirt{
	dir = 4
	},
/obj/effect/turf_decal/stripes/line{
	dir = 1
	},
/obj/effect/turf_decal/stripes/line{
	dir = 2
	},
/obj/machinery/door/airlock/titanium{
	name = "Sleeping Cabin";
	dir = 1
	},
/obj/machinery/atmospherics/pipe/simple/dark/hidden{
	dir = 1
	},
/obj/machinery/door/firedoor{
	dir = 1
	},
/turf/open/floor/pod/dark,
/area/shuttle/abandoned)
"vc" = (
/obj/effect/decal/cleanable/dirt{
	dir = 4
	},
/obj/machinery/atmospherics/pipe/simple/dark/hidden{
	dir = 6
	},
/obj/machinery/firealarm{
	dir = 2;
	pixel_y = 26
	},
/turf/open/floor/mineral/titanium/blue,
/area/shuttle/abandoned)
"vd" = (
/obj/effect/decal/cleanable/dirt{
	dir = 4
	},
/obj/machinery/atmospherics/pipe/simple/dark/hidden{
	dir = 1
	},
/turf/open/floor/mineral/titanium/yellow,
/area/shuttle/abandoned)
"vf" = (
/obj/effect/decal/cleanable/dirt{
	dir = 4
	},
/obj/structure/cable/yellow{
	icon_state = "2-8"
	},
/obj/machinery/atmospherics/pipe/manifold/dark/hidden{
	dir = 2
	},
/turf/open/floor/mineral/titanium/yellow,
/area/shuttle/abandoned)
"vL" = (
/obj/effect/decal/cleanable/dirt{
	dir = 4
	},
/obj/machinery/atmospherics/pipe/simple/dark/hidden{
	dir = 1
	},
/turf/open/floor/mineral/titanium/blue,
/area/shuttle/abandoned)
"wF" = (
/obj/effect/decal/cleanable/dirt{
	dir = 4
	},
/obj/machinery/atmospherics/pipe/manifold/dark/hidden{
	dir = 4
	},
/turf/open/floor/mineral/titanium/yellow,
/area/shuttle/abandoned)
"xr" = (
/obj/effect/decal/cleanable/dirt{
	dir = 4
	},
/obj/machinery/atmospherics/pipe/simple/dark/hidden{
	dir = 4
	},
/turf/open/floor/mineral/titanium/blue,
/area/shuttle/abandoned)
"xK" = (
/obj/machinery/light{
	dir = 1
	},
/turf/open/floor/grass,
/area/shuttle/abandoned)
"yo" = (
/obj/effect/decal/cleanable/dirt{
	dir = 4
	},
/obj/structure/cable/yellow{
	icon_state = "0-1"
	},
/obj/effect/turf_decal/bot{
	dir = 4
	},
/obj/machinery/power/apc{
	dir = 2;
	name = "Eden Whiteship APC";
	pixel_y = -23
	},
/turf/open/floor/mineral/titanium/yellow,
/area/shuttle/abandoned)
"zf" = (
/obj/machinery/door/airlock/external{
	dir = 1
	},
/obj/effect/mapping_helpers/airlock/cyclelink_helper{
	dir = 4
	},
/obj/effect/decal/cleanable/dirt{
	dir = 4
	},
/obj/effect/turf_decal/stripes/line{
	dir = 4
	},
/obj/effect/turf_decal/stripes/line{
	dir = 8
	},
/obj/machinery/atmospherics/pipe/simple/dark/hidden{
	dir = 4
	},
/turf/open/floor/pod/dark,
/area/shuttle/abandoned)
"zB" = (
/obj/effect/decal/cleanable/dirt{
	dir = 4
	},
/obj/machinery/atmospherics/components/unary/vent_pump/on{
	dir = 1
	},
/obj/machinery/airalarm/all_access{
	dir = 4;
	pixel_x = -22
	},
/turf/open/floor/mineral/titanium,
/area/shuttle/abandoned)
"Ab" = (
/obj/machinery/atmospherics/components/unary/vent_pump/on{
	dir = 2
	},
/obj/structure/lattice/catwalk{
	dir = 1
	},
/turf/open/floor/plating,
/area/shuttle/abandoned)
"Cd" = (
/obj/effect/turf_decal/bot{
	dir = 4
	},
/obj/machinery/seed_extractor{
	dir = 1
	},
/turf/open/floor/wood,
/area/shuttle/abandoned)
"Cy" = (
/obj/effect/decal/cleanable/dirt/dust{
	dir = 4
	},
/obj/machinery/sleeper{
	dir = 1
	},
/obj/effect/turf_decal/delivery{
	dir = 4
	},
/obj/machinery/light/small/built{
	dir = 8
	},
/obj/effect/decal/cleanable/dirt{
	dir = 4
	},
/turf/open/floor/mineral/titanium/blue,
/area/shuttle/abandoned)
"DI" = (
/obj/structure/table{
	dir = 1
	},
/obj/item/phone{
	pixel_x = -3;
	pixel_y = -3;
	dir = 1
	},
/obj/effect/decal/cleanable/dirt/dust{
	dir = 4
	},
/obj/item/assembly/flash/handheld{
	dir = 1
	},
/obj/item/melee/classic_baton/police/telescopic{
	dir = 1
	},
/obj/item/storage/toolbox/emergency{
	dir = 1
	},
/obj/item/wrench{
	dir = 1
	},
/turf/open/floor/mineral/titanium/blue,
/area/shuttle/abandoned)
"Eb" = (
/obj/machinery/atmospherics/pipe/manifold/dark/hidden{
	dir = 2
	},
/obj/effect/decal/cleanable/dirt{
	dir = 4
	},
/turf/open/floor/pod/dark,
/area/shuttle/abandoned)
"Fj" = (
/obj/effect/decal/cleanable/dirt/dust{
	dir = 4
	},
/obj/effect/decal/cleanable/dirt/dust{
	dir = 4
	},
/obj/structure/glowshroom/single{
	dir = 1
	},
/obj/item/storage/box/zipties{
	dir = 1
	},
/obj/machinery/firealarm{
	dir = 8;
	pixel_x = 26
	},
/turf/open/floor/mineral/titanium/blue,
/area/shuttle/abandoned)
"Fm" = (
/obj/effect/decal/cleanable/dirt{
	dir = 4
	},
/obj/machinery/power/smes/engineering{
	charge = 1e+006;
	dir = 1
	},
/obj/structure/cable/yellow{
	icon_state = "0-1"
	},
/obj/effect/turf_decal/bot{
	dir = 4
	},
/turf/open/floor/pod/dark,
/area/shuttle/abandoned)
"Hd" = (
/obj/effect/decal/cleanable/dirt{
	dir = 4
	},
/obj/machinery/atmospherics/components/unary/vent_pump/on{
	dir = 4
	},
/turf/open/floor/mineral/titanium/blue,
/area/shuttle/abandoned)
"Hf" = (
/obj/effect/decal/cleanable/dirt/dust{
	dir = 4
	},
/obj/structure/table{
	dir = 1
	},
/obj/machinery/microwave{
	dir = 1
	},
/obj/effect/decal/cleanable/dirt{
	dir = 4
	},
/turf/open/floor/mineral/titanium,
/area/shuttle/abandoned)
"HL" = (
/obj/structure/glowshroom/single{
	dir = 1
	},
/obj/machinery/atmospherics/pipe/manifold/dark/hidden{
	dir = 1
	},
/turf/open/floor/grass,
/area/shuttle/abandoned)
"Ig" = (
/obj/machinery/atmospherics/pipe/simple/dark/hidden{
	dir = 4
	},
/turf/open/floor/grass,
/area/shuttle/abandoned)
"Ih" = (
/obj/effect/spawner/structure/window/shuttle{
	dir = 1
	},
/turf/open/floor/plating,
/area/shuttle/abandoned)
"Iv" = (
/obj/structure/glowshroom/single{
	dir = 1
	},
/obj/machinery/button/door{
	id = "botanyShipR";
	name = "Cargo Blast Door Toggle";
	pixel_x = 24;
	dir = 1
	},
/turf/open/floor/grass,
/area/shuttle/abandoned)
"IH" = (
/obj/effect/turf_decal/stripes/line{
	dir = 2
	},
/obj/structure/shuttle/engine/propulsion/left{
	dir = 1
	},
/turf/open/floor/plating/airless,
/area/shuttle/abandoned)
"Jz" = (
/obj/effect/decal/cleanable/dirt{
	dir = 4
	},
/obj/machinery/atmospherics/pipe/manifold/dark/hidden{
	dir = 8
	},
/obj/machinery/firealarm{
	dir = 8;
	pixel_x = 26
	},
/turf/open/floor/mineral/titanium/yellow,
/area/shuttle/abandoned)
"KX" = (
/turf/open/floor/wood,
/area/shuttle/abandoned)
"LD" = (
/obj/machinery/button/door{
	id = "botanyShipL";
	name = "Cargo Blast Door Toggle";
	pixel_x = -24;
	dir = 1
	},
/turf/open/floor/grass,
/area/shuttle/abandoned)
"Mh" = (
/obj/effect/turf_decal/stripes/full{
	dir = 1
	},
/obj/machinery/door/poddoor{
	id = "botanyShipL";
	dir = 1
	},
/turf/open/floor/pod/dark,
/area/shuttle/abandoned)
"MR" = (
/obj/effect/decal/cleanable/dirt{
	dir = 4
	},
/obj/machinery/light/built{
	dir = 1
	},
/turf/open/floor/mineral/titanium,
/area/shuttle/abandoned)
"NE" = (
/obj/structure/glowshroom/single{
	dir = 1
	},
/obj/machinery/light{
	dir = 1
	},
/turf/open/floor/grass,
/area/shuttle/abandoned)
"Oz" = (
/obj/effect/decal/cleanable/dirt/dust{
	dir = 4
	},
/obj/effect/decal/cleanable/dirt/dust{
	dir = 4
	},
/obj/structure/toilet{
	pixel_y = -16;
	dir = 1
	},
/obj/structure/sink{
	dir = 4;
	pixel_x = 11
	},
/obj/structure/mirror{
	pixel_x = 28;
	dir = 1
	},
/obj/item/soap/homemade{
	dir = 1
	},
/obj/machinery/light/small/built{
	dir = 1
	},
/turf/open/floor/plasteel/freezer,
/area/shuttle/abandoned)
"QS" = (
/obj/machinery/atmospherics/pipe/simple/dark/hidden{
	dir = 1
	},
/turf/closed/wall/mineral/titanium/nodiagonal,
/area/shuttle/abandoned)
"Ri" = (
/obj/effect/decal/cleanable/dirt{
	dir = 4
	},
/obj/machinery/airalarm/all_access{
	dir = 8;
	pixel_x = 22
	},
/obj/machinery/atmospherics/pipe/manifold/dark/hidden{
	dir = 4
	},
/turf/open/floor/mineral/titanium/yellow,
/area/shuttle/abandoned)
"Rl" = (
/obj/machinery/hydroponics/constructable{
	dir = 1
	},
/obj/effect/turf_decal/bot{
	dir = 4
	},
/turf/open/floor/monotile/steel,
/area/shuttle/abandoned)
"RH" = (
/obj/machinery/atmospherics/pipe/simple/dark/hidden{
	dir = 4
	},
/obj/structure/cable/yellow{
	icon_state = "4-8"
	},
/turf/open/floor/mineral/titanium/yellow,
/area/shuttle/abandoned)
"Su" = (
/obj/effect/decal/cleanable/dirt/dust{
	dir = 4
	},
/obj/effect/decal/cleanable/dirt/dust{
	dir = 4
	},
/obj/effect/decal/cleanable/dirt/dust{
	dir = 4
	},
/obj/machinery/light/broken{
	dir = 8
	},
/obj/machinery/atmospherics/components/unary/vent_pump/on{
	dir = 4
	},
/obj/machinery/airalarm/all_access{
	dir = 4;
	pixel_x = -22
	},
/turf/open/floor/mineral/titanium/blue,
/area/shuttle/abandoned)
"Tq" = (
/obj/structure/glowshroom/single{
	dir = 1
	},
/obj/machinery/light{
	dir = 2
	},
/turf/open/floor/grass,
/area/shuttle/abandoned)
"Tw" = (
/obj/effect/decal/cleanable/dirt{
	dir = 4
	},
/obj/effect/decal/cleanable/dirt{
	dir = 4
	},
/turf/open/floor/mineral/titanium,
/area/shuttle/abandoned)
"Tz" = (
/obj/effect/turf_decal/bot{
	dir = 4
	},
/obj/machinery/biogenerator{
	dir = 1
	},
/turf/open/floor/wood,
/area/shuttle/abandoned)
"TH" = (
/obj/structure/glowshroom/single{
	dir = 1
	},
/obj/effect/decal/cleanable/dirt{
	dir = 4
	},
/obj/effect/decal/cleanable/dirt{
	dir = 4
	},
/obj/machinery/atmospherics/components/binary/dp_vent_pump{
	dir = 4
	},
/obj/machinery/light/small{
	dir = 2
	},
/obj/machinery/advanced_airlock_controller/directional/south,
/turf/open/floor/pod/dark,
/area/shuttle/abandoned)
"Uo" = (
/obj/effect/decal/cleanable/dirt{
	dir = 4
	},
/obj/effect/decal/cleanable/dirt{
	dir = 4
	},
/obj/machinery/atmospherics/components/unary/tank/air{
	dir = 8
	},
/obj/effect/turf_decal/bot{
	dir = 4
	},
/turf/open/floor/pod/dark,
/area/shuttle/abandoned)
"Us" = (
/obj/machinery/airalarm/all_access{
	pixel_y = -22;
	dir = 1
	},
/obj/machinery/atmospherics/pipe/simple/dark/hidden{
	dir = 4
	},
/turf/open/floor/grass,
/area/shuttle/abandoned)
"Vx" = (
/turf/open/floor/grass,
/area/shuttle/abandoned)
"Wr" = (
/obj/effect/turf_decal/bot{
	dir = 4
	},
/obj/machinery/vending/hydronutrients{
	dir = 1
	},
/turf/open/floor/wood,
/area/shuttle/abandoned)
"XJ" = (
/obj/effect/decal/cleanable/dirt/dust{
	dir = 4
	},
/obj/machinery/computer/crew{
	dir = 1
	},
/turf/open/floor/mineral/titanium/blue,
/area/shuttle/abandoned)
"XW" = (
/obj/structure/glowshroom/single{
	dir = 1
	},
/turf/open/floor/grass,
/area/shuttle/abandoned)
"Yf" = (
/obj/machinery/atmospherics/pipe/simple/dark/hidden{
	dir = 1
	},
/turf/closed/wall/mineral/titanium,
/area/shuttle/abandoned)
"YG" = (
/obj/effect/decal/cleanable/dirt{
	dir = 4
	},
/obj/effect/decal/cleanable/dirt{
	dir = 4
	},
/obj/effect/turf_decal/stripes/line{
	dir = 1
	},
/obj/effect/turf_decal/stripes/line{
	dir = 2
	},
/obj/machinery/door/airlock/titanium/glass{
	name = "Botany Lab";
	dir = 1
	},
/obj/machinery/atmospherics/pipe/simple/dark/hidden{
	dir = 1
	},
/obj/machinery/door/firedoor{
	dir = 1
	},
/turf/open/floor/pod/dark,
/area/shuttle/abandoned)
"YN" = (
/obj/structure/table{
	dir = 1
	},
/turf/open/floor/wood,
/area/shuttle/abandoned)
"Zd" = (
/obj/effect/decal/cleanable/dirt{
	dir = 4
	},
/obj/effect/decal/cleanable/dirt{
	dir = 4
	},
/obj/structure/cable{
	icon_state = "2-8"
	},
/obj/machinery/space_heater{
	dir = 1
	},
/obj/effect/turf_decal/bot{
	dir = 4
	},
/turf/open/floor/pod/dark,
/area/shuttle/abandoned)

(1,1,1) = {"
cS
lF
Mh
Mh
hL
Ih
hL
hL
lE
hL
hL
Ih
Ih
hL
hL
cS
cS
cS"}(2,1,1) = {"
IH
fy
XW
Vx
LD
Vx
hL
iM
gT
Fm
hL
pU
qZ
Cy
hL
hL
Ih
hL"}(3,1,1) = {"
lF
lF
xK
Rl
Rl
Tq
hL
Zd
rI
pO
hL
rz
rz
Hd
hL
Su
DI
Ih"}(4,1,1) = {"
dB
Tz
Vx
Rl
Vx
mg
hL
hL
jR
hL
hL
vc
vL
la
hQ
rG
nT
Ih"}(5,1,1) = {"
lF
Cd
Vx
Rl
Vx
Vx
hL
gk
RH
dc
hL
xr
cc
eO
hL
Fj
XJ
Ih"}(6,1,1) = {"
dB
qb
Vx
Ab
il
nV
hL
jb
vf
yo
lE
bl
hL
hL
hL
hL
hL
hL"}(7,1,1) = {"
lF
Wr
Vx
Rl
Vx
HL
YG
vd
Ri
Jz
vd
wF
vd
tv
zB
bm
hL
cS"}(8,1,1) = {"
dB
qE
Vx
Rl
Vx
Us
lE
nN
hL
hL
zf
hL
eg
lE
Tw
Hf
Ih
cS"}(9,1,1) = {"
lF
lF
NE
Rl
Rl
Ig
KX
bx
hL
Uo
Eb
hL
iV
lE
MR
ec
Ih
cS"}(10,1,1) = {"
mt
fy
Vx
Vx
Iv
Ig
an
YN
hL
lA
TH
hL
Oz
lE
qX
kH
hL
cS"}(11,1,1) = {"
cS
lF
eJ
eJ
hL
rR
Yf
Yf
QS
Yf
op
hL
hL
hL
hL
hL
hL
cS"}