//MAP CONVERTED BY dmm2tgm.py THIS HEADER COMMENT PREVENTS RECONVERSION, DO NOT REMOVE
"a" = (
/turf/open/indestructible/reebe_void,
/area/reebe)
"b" = (
/obj/structure/mirror/magic/lesser{
	pixel_x = 32
	},
/turf/open/floor/clockwork/reebe,
/area/reebe/city_of_cogs)
"c" = (
/obj/structure/window/reinforced/clockwork/fulltile,
/obj/structure/grille/ratvar,
/turf/open/floor/clockwork/reebe,
/area/reebe/city_of_cogs)
"d" = (
/obj/machinery/computer/camera_advanced/ratvar{
	dir = 8
	},
/turf/open/floor/clockwork/reebe,
/area/reebe/city_of_cogs)
"e" = (
/obj/structure/table/brass,
/obj/item/clockwork/clockwork_slab,
/turf/open/floor/clockwork/reebe,
/area/reebe/city_of_cogs)
"f" = (
/obj/machinery/door/airlock/clockwork/glass{
	name = "Listening Station"
	},
/turf/open/floor/clockwork/reebe,
/area/reebe/city_of_cogs)
"g" = (
/obj/structure/chair/fancy/brass{
	dir = 1
	},
/turf/open/floor/clockwork/reebe,
/area/reebe/city_of_cogs)
"h" = (
/obj/structure/table/brass,
/obj/item/toy/plush/plushvar,
/turf/open/floor/clockwork/reebe,
/area/reebe/city_of_cogs)
"i" = (
/obj/structure/table/brass,
/obj/item/clockwork/clockwork_slab,
/obj/item/clockwork/clockwork_slab,
/turf/open/floor/clockwork/reebe,
/area/reebe/city_of_cogs)
"k" = (
/obj/machinery/computer/camera_advanced/ratvar{
	dir = 4
	},
/turf/open/floor/clockwork/reebe,
/area/reebe/city_of_cogs)
"l" = (
/turf/open/floor/clockwork/reebe,
/area/reebe/city_of_cogs)
"m" = (
/obj/machinery/door/airlock/clockwork/glass,
/turf/open/floor/clockwork/reebe,
/area/reebe/city_of_cogs)
"o" = (
/obj/machinery/door/airlock/clockwork/glass{
	name = "Observation Room"
	},
/turf/open/floor/clockwork/reebe,
/area/reebe/city_of_cogs)
"q" = (
/obj/machinery/door/airlock/clockwork/glass{
	name = "Ark Chamber"
	},
/turf/open/floor/clockwork/reebe,
/area/reebe/city_of_cogs)
"s" = (
/obj/structure/table/brass,
/obj/item/radio/intercom,
/turf/open/floor/clockwork/reebe,
/area/reebe/city_of_cogs)
"u" = (
/obj/structure/destructible/clockwork/massive/celestial_gateway,
/turf/open/floor/clockwork/reebe,
/area/reebe/city_of_cogs)
"w" = (
/obj/structure/chair/fancy/brass,
/turf/open/floor/clockwork/reebe,
/area/reebe/city_of_cogs)
"x" = (
/obj/effect/landmark/servant_of_ratvar,
/turf/open/floor/clockwork/reebe,
/area/reebe/city_of_cogs)
"y" = (
/obj/structure/table/brass,
/obj/item/clockwork/replica_fabricator,
/turf/open/floor/clockwork/reebe,
/area/reebe/city_of_cogs)
"z" = (
/obj/structure/table/brass,
/obj/item/storage/firstaid/regular,
/turf/open/floor/clockwork/reebe,
/area/reebe/city_of_cogs)
"A" = (
/obj/machinery/telecomms/relay/preset/reebe,
/turf/open/floor/clockwork/reebe,
/area/reebe/city_of_cogs)
"B" = (
/obj/structure/table/brass,
/obj/item/clockwork/clockwork_slab,
/obj/item/clockwork/clockwork_slab,
/obj/item/clockwork/clockwork_slab,
/turf/open/floor/clockwork/reebe,
/area/reebe/city_of_cogs)
"D" = (
/obj/machinery/sleeper/clockwork,
/turf/open/floor/clockwork/reebe,
/area/reebe/city_of_cogs)
"G" = (
/obj/effect/clockwork/servant_blocker,
/turf/closed/wall/clockwork,
/area/reebe/city_of_cogs)
"I" = (
/obj/machinery/computer/camera_advanced/ratvar,
/turf/open/floor/clockwork/reebe,
/area/reebe/city_of_cogs)
"J" = (
/obj/structure/grille/ratvar,
/obj/structure/window/reinforced/clockwork/fulltile,
/turf/open/floor/clockwork/reebe,
/area/reebe/city_of_cogs)
"K" = (
/turf/open/indestructible/reebe_void/lattices,
/area/reebe)
"M" = (
/turf/closed/wall/clockwork,
/area/reebe/city_of_cogs)
"N" = (
/obj/structure/dresser,
/turf/open/floor/clockwork/reebe,
/area/reebe/city_of_cogs)
"O" = (
/obj/machinery/door/airlock/clockwork/glass{
	name = "Infirmary"
	},
/turf/open/floor/clockwork/reebe,
/area/reebe/city_of_cogs)
"P" = (
/obj/structure/chair/fancy/brass{
	dir = 8
	},
/turf/open/floor/clockwork/reebe,
/area/reebe/city_of_cogs)
"Q" = (
/obj/structure/table/brass,
/obj/effect/mob_spawn/drone/cogscarab,
/turf/open/floor/clockwork/reebe,
/area/reebe/city_of_cogs)
"R" = (
/obj/structure/lattice/catwalk/clockwork,
/obj/effect/clockwork/servant_blocker,
/turf/open/indestructible/reebe_void,
/area/reebe/city_of_cogs)
"T" = (
/obj/effect/landmark/city_of_cogs,
/turf/open/floor/clockwork/reebe,
/area/reebe/city_of_cogs)
"V" = (
/obj/machinery/sleeper/clockwork{
	dir = 4
	},
/turf/open/floor/clockwork/reebe,
/area/reebe/city_of_cogs)
"W" = (
/obj/structure/chair/fancy/brass{
	dir = 4
	},
/turf/open/floor/clockwork/reebe,
/area/reebe/city_of_cogs)
"X" = (
/obj/structure/table/brass,
/turf/open/floor/clockwork/reebe,
/area/reebe/city_of_cogs)
"Y" = (
/obj/machinery/door/airlock/clockwork/glass{
	name = "Summoning Chamber"
	},
/turf/open/floor/clockwork/reebe,
/area/reebe/city_of_cogs)
"Z" = (
/obj/structure/destructible/clockwork/eminence_beacon,
/turf/open/floor/clockwork/reebe,
/area/reebe/city_of_cogs)

(1,1,1) = {"
a
a
a
a
a
a
a
a
a
a
a
a
a
a
a
a
a
a
a
a
a
a
a
a
a
a
a
a
a
a
a
a
a
a
a
a
a
a
a
a
a
a
a
a
a
a
a
a
a
a
a
a
a
a
a
a
a
a
a
a
a
a
a
a
a
a
a
a
a
a
a
a
a
a
"}
(2,1,1) = {"
a
a
a
a
a
a
a
a
a
a
a
a
a
a
a
a
a
a
a
a
a
a
a
a
a
a
a
a
a
a
a
a
a
a
a
a
a
a
a
a
a
a
a
a
a
a
a
a
a
a
a
a
a
a
a
a
a
a
a
a
a
a
a
a
a
a
a
a
a
a
a
a
a
a
"}
(3,1,1) = {"
a
a
a
a
a
a
a
a
a
a
a
a
a
a
a
a
a
a
a
a
a
a
a
a
a
a
a
a
a
a
a
a
a
a
a
a
a
a
a
a
a
a
a
a
a
a
a
a
a
a
a
a
a
a
a
a
a
a
a
a
a
a
a
a
a
a
a
a
a
a
a
a
a
a
"}
(4,1,1) = {"
a
a
a
a
a
a
a
a
a
a
a
a
a
a
a
a
a
a
a
a
a
a
a
a
a
a
a
a
a
a
a
a
a
a
a
a
a
a
a
a
a
a
a
a
a
a
a
a
a
a
a
a
a
a
a
a
a
a
a
a
a
a
a
a
a
a
a
a
a
a
a
a
a
a
"}
(5,1,1) = {"
a
a
a
a
a
a
a
a
a
a
a
a
a
a
a
a
a
a
a
a
a
a
a
a
a
a
a
K
K
K
K
K
a
a
a
a
a
a
a
a
a
a
a
a
a
a
a
a
a
a
a
a
a
a
a
a
a
a
a
a
a
a
a
a
a
a
a
a
a
a
a
a
a
a
"}
(6,1,1) = {"
a
a
a
a
a
a
a
a
a
a
a
a
a
a
a
a
a
a
a
a
a
a
a
a
a
a
K
K
K
K
K
K
K
a
a
a
a
a
a
a
a
a
a
a
a
a
a
a
a
a
a
a
a
a
a
a
a
a
a
a
a
a
a
a
a
a
a
a
a
a
a
a
a
a
"}
(7,1,1) = {"
a
a
a
a
a
a
a
a
a
a
a
a
a
a
a
a
a
a
a
a
a
a
a
a
a
K
K
K
K
K
K
K
K
K
a
a
a
a
a
a
a
a
a
a
a
a
a
a
a
a
a
a
a
a
a
a
a
a
a
a
a
a
a
a
a
a
a
a
a
a
a
a
a
a
"}
(8,1,1) = {"
a
a
a
a
a
a
a
a
a
a
a
a
a
a
a
a
a
a
a
a
a
a
a
a
K
K
K
K
K
K
K
K
K
K
K
a
a
a
a
a
a
a
a
a
a
a
a
a
a
a
a
a
a
a
a
a
a
a
a
a
a
a
a
a
a
a
a
a
a
a
a
a
a
a
"}
(9,1,1) = {"
a
a
a
a
a
a
a
a
a
a
a
a
a
a
a
a
a
a
a
a
a
a
a
K
K
K
K
J
J
J
J
J
K
K
K
K
a
a
a
a
a
a
a
a
a
a
a
a
a
a
a
a
a
a
a
a
a
a
a
a
a
a
a
a
a
a
a
a
a
a
a
a
a
a
"}
(10,1,1) = {"
a
a
a
a
a
a
a
a
a
a
a
a
a
a
a
a
a
a
a
a
a
a
K
K
K
K
J
J
T
l
T
J
J
K
K
K
K
a
a
a
a
a
a
a
a
a
a
a
a
a
a
a
a
a
a
a
a
a
a
a
a
a
a
a
a
a
a
a
a
a
a
a
a
a
"}
(11,1,1) = {"
a
a
a
a
a
a
a
a
a
a
a
a
a
a
a
a
a
a
a
a
a
K
K
K
K
J
J
l
l
l
l
l
J
J
K
K
K
K
a
a
a
a
a
a
a
a
a
a
a
a
a
a
a
a
a
a
a
a
a
a
a
a
a
a
a
a
a
a
a
a
a
a
a
a
"}
(12,1,1) = {"
a
a
a
a
a
a
a
a
a
a
a
a
a
a
a
a
a
a
a
a
a
K
K
K
K
J
T
l
l
l
l
l
T
J
K
K
K
K
a
a
a
a
a
a
a
a
a
a
a
a
a
a
a
a
a
a
a
a
a
a
a
a
a
a
a
a
a
a
a
a
a
a
a
a
"}
(13,1,1) = {"
a
a
a
a
a
a
a
a
a
a
a
a
a
a
a
a
a
a
a
a
a
K
K
K
K
J
l
l
l
l
l
l
l
J
K
K
K
K
a
a
a
a
a
a
a
a
a
a
a
a
a
a
a
a
a
a
a
a
a
a
a
a
a
a
a
a
a
a
a
a
a
a
a
a
"}
(14,1,1) = {"
a
a
a
a
a
a
a
a
a
a
a
a
a
a
a
a
a
a
a
a
a
K
K
K
K
J
T
l
l
l
l
l
T
J
K
K
K
K
a
a
a
a
a
a
a
a
a
a
a
a
a
a
a
a
a
a
a
a
a
a
a
a
a
a
a
a
a
a
a
a
a
a
a
a
"}
(15,1,1) = {"
a
a
a
a
a
a
a
a
a
a
a
a
a
a
a
a
a
a
a
a
a
K
K
K
K
J
J
l
l
l
l
l
J
J
K
K
K
K
a
a
a
a
a
a
a
a
a
a
a
a
a
a
a
a
a
a
a
a
a
a
a
a
a
a
a
a
a
a
a
a
a
a
a
a
"}
(16,1,1) = {"
a
a
a
a
a
a
a
a
a
a
a
a
a
a
a
a
a
a
a
a
a
a
K
K
K
K
J
J
l
l
l
J
J
K
K
K
K
a
a
a
a
a
a
a
a
a
a
a
a
a
a
a
a
a
a
a
a
a
a
a
a
a
a
a
a
a
a
a
a
a
a
a
a
a
"}
(17,1,1) = {"
a
a
a
a
a
a
a
a
a
a
a
a
a
a
a
a
a
a
a
a
a
a
a
K
K
K
K
J
c
m
c
J
K
K
K
K
a
a
a
a
a
a
a
a
a
a
a
a
a
a
a
a
a
a
a
a
a
a
a
a
a
a
a
a
a
a
a
a
a
a
a
a
a
a
"}
(18,1,1) = {"
a
a
a
a
a
a
a
a
a
a
a
a
a
a
a
a
a
a
a
a
a
a
a
K
K
K
K
J
l
l
l
J
K
K
K
K
K
a
a
a
a
a
a
a
a
a
a
a
a
a
a
a
a
a
a
a
a
a
a
a
a
a
a
a
a
a
a
a
a
a
a
a
a
a
"}
(19,1,1) = {"
a
a
a
a
a
a
a
a
a
a
a
a
a
a
a
a
a
a
a
a
a
a
a
K
K
K
K
J
l
l
l
J
K
K
K
K
K
K
K
K
a
a
a
a
a
a
a
a
a
a
a
a
a
a
a
a
a
a
a
a
a
a
a
a
a
a
a
a
a
a
a
a
a
a
"}
(20,1,1) = {"
a
a
a
a
a
a
a
a
a
a
a
a
a
a
a
a
a
a
a
a
a
a
a
K
K
K
K
J
l
l
l
J
K
K
K
K
K
K
K
K
K
K
K
a
a
a
a
a
a
a
a
a
a
a
a
a
a
a
a
a
a
a
a
a
a
a
a
a
a
a
a
a
a
a
"}
(21,1,1) = {"
a
a
a
a
a
a
a
a
a
a
a
a
a
a
a
a
a
a
a
a
a
a
a
K
K
K
K
J
l
l
l
J
K
K
K
K
K
K
K
K
K
K
K
K
K
a
a
a
a
a
a
a
a
a
a
a
a
a
a
a
a
a
a
a
a
a
a
a
a
a
a
a
a
a
"}
(22,1,1) = {"
a
a
a
a
a
a
a
a
a
a
a
a
a
a
a
a
a
a
a
a
a
a
K
K
K
K
J
J
l
l
l
J
J
J
J
J
J
K
K
K
K
K
K
K
K
K
K
a
a
a
a
a
a
a
a
a
a
a
a
a
a
a
a
a
a
a
a
a
a
a
a
a
a
a
"}
(23,1,1) = {"
a
a
a
a
a
a
a
a
a
a
a
a
a
a
a
a
a
a
a
a
a
a
K
K
K
K
J
l
l
l
l
l
l
l
l
l
J
J
J
J
K
K
K
K
K
K
K
K
a
a
a
a
a
a
a
a
a
a
a
a
a
a
a
a
a
a
a
a
a
a
a
a
a
a
"}
(24,1,1) = {"
a
a
a
a
a
a
a
a
a
a
a
a
a
a
a
a
a
a
a
a
a
a
K
K
K
K
J
l
l
l
l
l
l
l
l
l
l
l
l
J
J
J
J
K
K
K
K
K
K
a
a
a
a
a
a
a
a
a
a
a
a
a
a
a
a
a
a
a
a
a
a
a
a
a
"}
(25,1,1) = {"
a
a
a
a
a
a
a
a
a
a
a
a
a
a
a
a
a
a
a
a
a
a
K
K
K
K
M
M
M
m
M
M
M
M
l
l
l
l
l
l
l
l
J
J
J
K
K
K
K
K
a
a
a
a
a
a
a
a
a
a
a
a
a
a
a
a
a
a
a
a
a
a
a
a
"}
(26,1,1) = {"
a
a
a
a
a
a
a
a
a
a
a
a
a
a
a
a
a
a
a
a
a
a
K
K
K
K
M
l
l
l
l
l
l
M
M
M
M
l
l
l
l
l
l
l
J
J
J
K
K
K
K
a
a
a
a
a
a
a
a
a
a
a
a
a
a
a
a
a
a
a
a
a
a
a
"}
(27,1,1) = {"
a
a
a
a
a
a
a
a
a
a
a
a
a
a
a
a
a
a
a
a
a
a
K
K
K
K
M
l
l
l
l
l
l
l
l
l
M
M
M
M
l
l
l
l
l
l
J
J
K
K
K
K
a
a
a
a
a
a
a
a
a
a
a
a
a
a
a
a
a
a
a
a
a
a
"}
(28,1,1) = {"
a
a
a
a
a
a
a
a
a
a
a
a
a
a
a
a
a
a
a
a
a
a
K
K
K
K
M
l
l
l
l
l
l
l
l
l
l
l
l
M
M
M
M
l
l
l
l
J
J
K
K
K
K
a
a
a
a
a
a
a
a
a
a
a
a
a
a
a
a
a
a
a
a
a
"}
(29,1,1) = {"
a
a
a
a
a
a
a
a
a
a
a
a
a
a
a
a
a
a
a
a
a
a
a
a
a
a
G
R
R
R
R
R
R
l
l
l
l
l
l
l
l
l
M
M
l
l
l
l
J
J
K
K
K
K
a
a
a
a
a
a
a
a
a
a
a
a
a
a
a
a
a
a
a
a
"}
(30,1,1) = {"
a
a
a
a
a
a
a
a
a
a
a
a
a
a
a
a
a
a
a
a
a
a
K
K
K
K
M
l
l
l
l
l
R
R
R
R
l
l
l
l
l
l
l
M
M
l
l
l
l
J
K
K
K
K
a
a
a
a
a
a
a
a
a
a
a
a
a
a
a
a
a
a
a
a
"}
(31,1,1) = {"
a
a
a
a
a
a
a
a
a
a
a
a
a
a
a
a
a
a
a
a
a
a
K
K
K
K
J
l
l
l
l
l
l
l
l
R
R
R
R
l
l
l
l
l
M
M
l
l
l
J
J
K
K
K
K
a
a
a
a
a
a
a
a
a
a
a
a
a
a
a
a
a
a
a
"}
(32,1,1) = {"
a
a
a
a
a
a
a
a
a
a
a
a
a
a
a
a
a
a
a
a
a
K
K
K
K
K
J
l
l
l
l
l
l
l
l
l
l
l
R
R
R
l
l
l
l
M
M
l
l
l
J
K
K
K
K
a
a
a
a
a
a
a
a
a
a
a
a
a
a
a
a
a
a
a
"}
(33,1,1) = {"
a
a
a
a
a
a
a
a
a
a
a
a
a
a
a
a
a
a
a
a
K
K
K
K
K
K
J
l
l
l
l
l
l
l
l
l
l
l
l
l
R
R
l
l
l
l
M
M
l
l
J
J
K
K
K
K
a
a
a
a
a
a
a
a
a
a
a
a
a
a
a
a
a
a
"}
(34,1,1) = {"
a
a
a
a
a
a
a
a
a
a
a
a
a
a
a
K
K
K
K
K
K
K
K
K
K
K
J
l
l
l
l
l
l
l
l
l
l
l
l
l
l
R
R
l
l
l
l
M
l
l
l
J
K
K
K
K
a
a
a
a
a
a
a
a
a
a
a
a
a
a
a
a
a
a
"}
(35,1,1) = {"
a
a
a
a
a
a
a
a
a
a
a
a
a
a
K
K
K
K
K
K
K
K
K
K
K
K
J
l
l
l
l
l
l
l
l
l
l
l
l
l
l
l
R
R
l
l
l
M
l
l
l
J
K
K
K
K
a
a
a
a
a
a
a
a
a
a
a
a
a
a
a
a
a
a
"}
(36,1,1) = {"
a
a
a
a
a
a
a
a
a
a
a
a
a
K
K
K
K
K
K
K
K
K
K
K
K
K
J
l
l
l
l
l
l
l
l
l
l
l
l
l
l
l
l
R
l
l
l
M
M
l
l
J
J
K
K
K
K
a
a
a
a
a
a
a
a
a
a
a
a
a
a
a
a
a
"}
(37,1,1) = {"
a
a
a
a
a
a
a
a
a
a
a
a
K
K
K
K
K
K
K
K
K
K
K
K
K
K
M
l
l
l
l
l
l
l
l
l
l
l
l
l
l
l
l
R
R
l
l
l
M
l
l
l
J
K
K
K
K
a
a
a
a
a
a
a
a
a
a
a
a
a
a
a
a
a
"}
(38,1,1) = {"
a
a
a
a
a
a
a
a
a
a
a
K
K
K
K
M
J
J
M
M
M
M
J
J
M
M
M
l
l
l
l
l
l
l
l
l
l
l
l
l
l
l
l
l
R
l
l
l
M
l
l
l
J
K
K
K
K
a
a
a
a
a
a
a
a
a
a
a
a
a
a
a
a
a
"}
(39,1,1) = {"
a
a
a
a
a
a
a
a
a
a
K
K
K
K
M
M
D
l
X
z
M
s
l
l
s
M
M
l
l
l
l
l
l
l
l
l
l
l
l
l
l
l
l
l
R
l
l
l
M
M
l
l
J
J
K
K
K
K
a
a
a
a
a
a
a
a
a
a
a
a
a
a
a
a
"}
(40,1,1) = {"
a
a
a
a
a
a
a
a
a
K
K
K
K
M
M
X
D
l
l
l
J
P
l
l
P
s
M
M
l
l
l
l
l
l
l
l
l
l
l
l
l
l
l
l
R
R
l
l
l
M
l
l
l
J
K
K
K
K
a
a
K
K
K
K
K
a
a
a
a
a
a
a
a
a
"}
(41,1,1) = {"
a
a
a
K
K
K
K
K
K
K
K
K
K
J
V
V
l
l
l
l
O
l
l
l
l
w
s
M
l
l
l
l
l
l
l
l
l
l
l
l
l
l
l
l
l
R
l
l
l
M
l
l
l
J
K
K
K
K
a
K
K
K
K
K
K
K
a
a
a
a
a
a
a
a
"}
(42,1,1) = {"
a
a
a
K
K
K
K
K
K
K
K
K
K
J
l
l
l
l
l
l
J
W
l
W
l
l
l
M
l
l
l
l
l
l
l
l
l
l
l
l
l
l
l
l
l
R
l
l
l
M
M
l
l
J
K
K
K
K
K
K
K
K
K
K
K
K
K
a
a
a
a
a
a
a
"}
(43,1,1) = {"
a
a
a
K
K
K
K
K
K
K
K
K
K
M
b
l
l
l
N
z
M
s
A
s
l
l
l
M
l
l
l
l
l
l
l
l
l
l
l
l
l
l
l
l
l
R
R
l
l
l
M
l
l
J
K
K
K
K
K
K
K
K
K
K
K
K
K
K
a
a
a
a
a
a
"}
(44,1,1) = {"
a
a
a
K
K
K
K
K
K
K
K
K
K
M
M
J
O
J
M
M
M
M
M
M
J
f
J
M
l
l
l
l
l
l
l
l
l
l
l
l
l
l
l
l
l
l
R
l
l
l
M
l
l
J
K
K
K
K
K
K
J
J
J
J
J
K
K
K
K
a
a
a
a
a
"}
(45,1,1) = {"
a
a
a
K
K
K
K
M
M
J
J
J
M
M
l
l
l
l
l
l
l
l
l
M
Q
l
l
l
l
l
l
l
l
l
l
l
l
l
l
l
l
l
l
l
l
l
R
l
l
l
M
l
l
J
K
K
K
K
K
J
J
T
l
T
J
J
K
K
K
K
a
a
a
a
"}
(46,1,1) = {"
a
a
a
K
K
K
K
M
x
x
l
x
x
M
l
l
l
g
l
g
l
g
l
J
i
l
l
l
l
l
l
l
l
l
l
l
l
l
l
l
l
l
l
l
l
l
R
l
l
l
M
l
l
J
J
J
J
J
J
J
l
l
l
l
l
J
J
K
K
K
K
a
a
a
"}
(47,1,1) = {"
a
a
a
K
K
K
K
J
x
l
l
l
x
J
l
e
l
g
l
g
l
g
l
J
l
l
l
l
l
l
l
l
l
l
l
l
l
l
l
l
l
l
l
l
l
l
R
l
l
l
M
l
l
l
l
l
l
l
J
l
l
l
l
l
l
T
J
K
K
K
K
a
a
a
"}
(48,1,1) = {"
a
a
a
K
K
K
K
J
l
l
u
l
l
Y
l
h
l
l
l
l
l
l
l
q
l
l
l
l
l
l
l
l
l
l
l
l
l
l
l
l
l
l
l
l
l
l
R
l
l
l
m
l
l
l
l
l
l
l
m
l
l
l
l
l
l
l
J
K
K
K
K
a
a
a
"}
(49,1,1) = {"
a
a
a
K
K
K
K
J
x
l
l
l
x
J
l
Z
l
g
l
g
l
g
l
J
l
l
l
l
l
l
l
l
l
l
l
l
l
l
l
l
l
l
l
l
l
l
R
l
l
l
M
l
l
l
l
l
l
l
J
l
l
l
l
l
l
T
J
K
K
K
K
a
a
a
"}
(50,1,1) = {"
a
a
a
K
K
K
K
M
x
x
l
x
x
M
l
l
l
g
l
g
l
g
l
J
i
l
l
l
l
l
l
l
l
l
l
l
l
l
l
l
l
l
l
l
l
l
R
l
l
l
M
l
l
J
J
J
J
J
J
J
l
l
l
l
l
J
J
K
K
K
K
a
a
a
"}
(51,1,1) = {"
a
a
a
K
K
K
K
M
M
J
J
J
M
M
l
l
l
l
l
l
l
l
l
M
Q
l
l
l
l
l
l
l
l
l
l
l
l
l
l
l
l
l
l
l
l
l
R
l
l
l
M
l
l
J
K
K
K
K
K
J
J
T
l
T
J
J
K
K
K
K
a
a
a
a
"}
(52,1,1) = {"
a
a
a
K
K
K
K
K
K
K
K
K
K
M
M
J
o
J
M
M
M
M
M
M
J
q
J
M
l
l
l
l
l
l
l
l
l
l
l
l
l
l
l
l
l
l
R
l
l
l
M
l
l
J
K
K
K
K
K
K
J
J
J
J
J
K
K
K
K
a
a
a
a
a
"}
(53,1,1) = {"
a
a
a
K
K
K
K
K
K
K
K
K
K
M
I
g
l
l
k
X
M
B
X
B
l
l
l
M
l
l
l
l
l
l
l
l
l
l
l
l
l
l
l
l
l
R
R
l
l
l
M
l
l
J
K
K
K
K
K
K
K
K
K
K
K
K
K
K
a
a
a
a
a
a
"}
(54,1,1) = {"
a
a
a
K
K
K
K
K
K
K
K
K
K
J
X
l
l
l
P
l
J
l
l
l
l
l
l
M
l
l
l
l
l
l
l
l
l
l
l
l
l
l
l
l
l
R
l
l
l
M
M
l
l
J
K
K
K
K
K
K
K
K
K
K
K
K
K
a
a
a
a
a
a
a
"}
(55,1,1) = {"
a
a
a
K
K
K
K
K
K
K
K
K
K
J
I
g
l
l
l
l
o
l
l
l
l
l
y
M
l
l
l
l
l
l
l
l
l
l
l
l
l
l
l
l
l
R
l
l
l
M
l
l
l
J
K
K
K
K
a
K
K
K
K
K
K
K
a
a
a
a
a
a
a
a
"}
(56,1,1) = {"
a
a
a
a
a
a
a
a
a
K
K
K
K
M
M
X
W
l
W
l
J
l
l
l
l
X
M
M
l
l
l
l
l
l
l
l
l
l
l
l
l
l
l
l
R
R
l
l
l
M
l
l
l
J
K
K
K
K
a
a
K
K
K
K
K
a
a
a
a
a
a
a
a
a
"}
(57,1,1) = {"
a
a
a
a
a
a
a
a
a
a
K
K
K
K
M
M
d
X
d
X
M
X
l
l
y
M
M
l
l
l
l
l
l
l
l
l
l
l
l
l
l
l
l
l
R
l
l
l
M
M
l
l
J
J
K
K
K
K
a
a
a
a
a
a
a
a
a
a
a
a
a
a
a
a
"}
(58,1,1) = {"
a
a
a
a
a
a
a
a
a
a
a
K
K
K
K
M
J
J
M
M
M
M
J
J
M
M
M
l
l
l
l
l
l
l
l
l
l
l
l
l
l
l
l
l
R
l
l
l
M
l
l
l
J
K
K
K
K
a
a
a
a
a
a
a
a
a
a
a
a
a
a
a
a
a
"}
(59,1,1) = {"
a
a
a
a
a
a
a
a
a
a
a
a
K
K
K
K
K
K
K
K
K
K
K
K
K
K
M
l
l
l
l
l
l
l
l
l
l
l
l
l
l
l
l
R
R
l
l
l
M
l
l
l
J
K
K
K
K
a
a
a
a
a
a
a
a
a
a
a
a
a
a
a
a
a
"}
(60,1,1) = {"
a
a
a
a
a
a
a
a
a
a
a
a
a
K
K
K
K
K
K
K
K
K
K
K
K
K
J
l
l
l
l
l
l
l
l
l
l
l
l
l
l
l
l
R
l
l
l
M
M
l
l
J
J
K
K
K
K
a
a
a
a
a
a
a
a
a
a
a
a
a
a
a
a
a
"}
(61,1,1) = {"
a
a
a
a
a
a
a
a
a
a
a
a
a
a
K
K
K
K
K
K
K
K
K
K
K
K
J
l
l
l
l
l
l
l
l
l
l
l
l
l
l
l
R
R
l
l
l
M
l
l
l
J
K
K
K
K
a
a
a
a
a
a
a
a
a
a
a
a
a
a
a
a
a
a
"}
(62,1,1) = {"
a
a
a
a
a
a
a
a
a
a
a
a
a
a
a
K
K
K
K
K
K
K
K
K
K
K
J
l
l
l
l
l
l
l
l
l
l
l
l
l
l
R
R
l
l
l
l
M
l
l
l
J
K
K
K
K
a
a
a
a
a
a
a
a
a
a
a
a
a
a
a
a
a
a
"}
(63,1,1) = {"
a
a
a
a
a
a
a
a
a
a
a
a
a
a
a
a
a
a
a
a
K
K
K
K
K
K
J
l
l
l
l
l
l
l
l
l
l
l
l
l
R
R
l
l
l
l
M
M
l
l
J
J
K
K
K
K
a
a
a
a
a
a
a
a
a
a
a
a
a
a
a
a
a
a
"}
(64,1,1) = {"
a
a
a
a
a
a
a
a
a
a
a
a
a
a
a
a
a
a
a
a
a
K
K
K
K
K
J
l
l
l
l
l
l
l
l
l
l
l
R
R
R
l
l
l
l
M
M
l
l
l
J
K
K
K
K
a
a
a
a
a
a
a
a
a
a
a
a
a
a
a
a
a
a
a
"}
(65,1,1) = {"
a
a
a
a
a
a
a
a
a
a
a
a
a
a
a
a
a
a
a
a
a
a
K
K
K
K
J
l
l
l
l
l
l
l
l
R
R
R
R
l
l
l
l
l
M
M
l
l
l
J
J
K
K
K
K
a
a
a
a
a
a
a
a
a
a
a
a
a
a
a
a
a
a
a
"}
(66,1,1) = {"
a
a
a
a
a
a
a
a
a
a
a
a
a
a
a
a
a
a
a
a
a
a
K
K
K
K
M
l
l
l
l
l
R
R
R
R
l
l
l
l
l
l
l
M
M
l
l
l
l
J
K
K
K
K
a
a
a
a
a
a
a
a
a
a
a
a
a
a
a
a
a
a
a
a
"}
(67,1,1) = {"
a
a
a
a
a
a
a
a
a
a
a
a
a
a
a
a
a
a
a
a
a
a
a
a
a
a
G
R
R
R
R
R
R
l
l
l
l
l
l
l
l
l
M
M
l
l
l
l
J
J
K
K
K
K
a
a
a
a
a
a
a
a
a
a
a
a
a
a
a
a
a
a
a
a
"}
(68,1,1) = {"
a
a
a
a
a
a
a
a
a
a
a
a
a
a
a
a
a
a
a
a
a
a
K
K
K
K
M
l
l
l
l
l
l
l
l
l
l
l
l
M
M
M
M
l
l
l
l
J
J
K
K
K
K
a
a
a
a
a
a
a
a
a
a
a
a
a
a
a
a
a
a
a
a
a
"}
(69,1,1) = {"
a
a
a
a
a
a
a
a
a
a
a
a
a
a
a
a
a
a
a
a
a
a
K
K
K
K
M
l
l
l
l
l
l
l
l
l
M
M
M
M
l
l
l
l
l
l
J
J
K
K
K
K
a
a
a
a
a
a
a
a
a
a
a
a
a
a
a
a
a
a
a
a
a
a
"}
(70,1,1) = {"
a
a
a
a
a
a
a
a
a
a
a
a
a
a
a
a
a
a
a
a
a
a
K
K
K
K
M
l
l
l
l
l
l
M
M
M
M
l
l
l
l
l
l
l
J
J
J
K
K
K
K
a
a
a
a
a
a
a
a
a
a
a
a
a
a
a
a
a
a
a
a
a
a
a
"}
(71,1,1) = {"
a
a
a
a
a
a
a
a
a
a
a
a
a
a
a
a
a
a
a
a
a
a
K
K
K
K
M
M
M
m
M
M
M
M
l
l
l
l
l
l
l
l
J
J
J
K
K
K
K
K
a
a
a
a
a
a
a
a
a
a
a
a
a
a
a
a
a
a
a
a
a
a
a
a
"}
(72,1,1) = {"
a
a
a
a
a
a
a
a
a
a
a
a
a
a
a
a
a
a
a
a
a
a
K
K
K
K
J
l
l
l
l
l
l
l
l
l
l
l
l
J
J
J
J
K
K
K
K
K
K
a
a
a
a
a
a
a
a
a
a
a
a
a
a
a
a
a
a
a
a
a
a
a
a
a
"}
(73,1,1) = {"
a
a
a
a
a
a
a
a
a
a
a
a
a
a
a
a
a
a
a
a
a
a
K
K
K
K
J
l
l
l
l
l
l
l
l
l
J
J
J
J
K
K
K
K
K
K
K
K
a
a
a
a
a
a
a
a
a
a
a
a
a
a
a
a
a
a
a
a
a
a
a
a
a
a
"}
(74,1,1) = {"
a
a
a
a
a
a
a
a
a
a
a
a
a
a
a
a
a
a
a
a
a
a
K
K
K
K
J
J
l
l
l
J
J
J
J
J
J
K
K
K
K
K
K
K
K
K
K
a
a
a
a
a
a
a
a
a
a
a
a
a
a
a
a
a
a
a
a
a
a
a
a
a
a
a
"}
(75,1,1) = {"
a
a
a
a
a
a
a
a
a
a
a
a
a
a
a
a
a
a
a
a
a
a
a
K
K
K
K
J
l
l
l
J
K
K
K
K
K
K
K
K
K
K
K
K
K
a
a
a
a
a
a
a
a
a
a
a
a
a
a
a
a
a
a
a
a
a
a
a
a
a
a
a
a
a
"}
(76,1,1) = {"
a
a
a
a
a
a
a
a
a
a
a
a
a
a
a
a
a
a
a
a
a
a
a
K
K
K
K
J
l
l
l
J
K
K
K
K
K
K
K
K
K
K
K
a
a
a
a
a
a
a
a
a
a
a
a
a
a
a
a
a
a
a
a
a
a
a
a
a
a
a
a
a
a
a
"}
(77,1,1) = {"
a
a
a
a
a
a
a
a
a
a
a
a
a
a
a
a
a
a
a
a
a
a
a
K
K
K
K
J
l
l
l
J
K
K
K
K
K
K
K
K
a
a
a
a
a
a
a
a
a
a
a
a
a
a
a
a
a
a
a
a
a
a
a
a
a
a
a
a
a
a
a
a
a
a
"}
(78,1,1) = {"
a
a
a
a
a
a
a
a
a
a
a
a
a
a
a
a
a
a
a
a
a
a
a
K
K
K
K
J
l
l
l
J
K
K
K
K
K
a
a
a
a
a
a
a
a
a
a
a
a
a
a
a
a
a
a
a
a
a
a
a
a
a
a
a
a
a
a
a
a
a
a
a
a
a
"}
(79,1,1) = {"
a
a
a
a
a
a
a
a
a
a
a
a
a
a
a
a
a
a
a
a
a
a
a
K
K
K
K
J
c
m
c
J
K
K
K
K
a
a
a
a
a
a
a
a
a
a
a
a
a
a
a
a
a
a
a
a
a
a
a
a
a
a
a
a
a
a
a
a
a
a
a
a
a
a
"}
(80,1,1) = {"
a
a
a
a
a
a
a
a
a
a
a
a
a
a
a
a
a
a
a
a
a
a
K
K
K
K
J
J
l
l
l
J
J
K
K
K
K
a
a
a
a
a
a
a
a
a
a
a
a
a
a
a
a
a
a
a
a
a
a
a
a
a
a
a
a
a
a
a
a
a
a
a
a
a
"}
(81,1,1) = {"
a
a
a
a
a
a
a
a
a
a
a
a
a
a
a
a
a
a
a
a
a
K
K
K
K
J
J
l
l
l
l
l
J
J
K
K
K
K
a
a
a
a
a
a
a
a
a
a
a
a
a
a
a
a
a
a
a
a
a
a
a
a
a
a
a
a
a
a
a
a
a
a
a
a
"}
(82,1,1) = {"
a
a
a
a
a
a
a
a
a
a
a
a
a
a
a
a
a
a
a
a
a
K
K
K
K
J
T
l
l
l
l
l
T
J
K
K
K
K
a
a
a
a
a
a
a
a
a
a
a
a
a
a
a
a
a
a
a
a
a
a
a
a
a
a
a
a
a
a
a
a
a
a
a
a
"}
(83,1,1) = {"
a
a
a
a
a
a
a
a
a
a
a
a
a
a
a
a
a
a
a
a
a
K
K
K
K
J
l
l
l
l
l
l
l
J
K
K
K
K
a
a
a
a
a
a
a
a
a
a
a
a
a
a
a
a
a
a
a
a
a
a
a
a
a
a
a
a
a
a
a
a
a
a
a
a
"}
(84,1,1) = {"
a
a
a
a
a
a
a
a
a
a
a
a
a
a
a
a
a
a
a
a
a
K
K
K
K
J
T
l
l
l
l
l
T
J
K
K
K
K
a
a
a
a
a
a
a
a
a
a
a
a
a
a
a
a
a
a
a
a
a
a
a
a
a
a
a
a
a
a
a
a
a
a
a
a
"}
(85,1,1) = {"
a
a
a
a
a
a
a
a
a
a
a
a
a
a
a
a
a
a
a
a
a
K
K
K
K
J
J
l
l
l
l
l
J
J
K
K
K
K
a
a
a
a
a
a
a
a
a
a
a
a
a
a
a
a
a
a
a
a
a
a
a
a
a
a
a
a
a
a
a
a
a
a
a
a
"}
(86,1,1) = {"
a
a
a
a
a
a
a
a
a
a
a
a
a
a
a
a
a
a
a
a
a
a
K
K
K
K
J
J
T
l
T
J
J
K
K
K
K
a
a
a
a
a
a
a
a
a
a
a
a
a
a
a
a
a
a
a
a
a
a
a
a
a
a
a
a
a
a
a
a
a
a
a
a
a
"}
(87,1,1) = {"
a
a
a
a
a
a
a
a
a
a
a
a
a
a
a
a
a
a
a
a
a
a
a
K
K
K
K
J
J
J
J
J
K
K
K
K
a
a
a
a
a
a
a
a
a
a
a
a
a
a
a
a
a
a
a
a
a
a
a
a
a
a
a
a
a
a
a
a
a
a
a
a
a
a
"}
(88,1,1) = {"
a
a
a
a
a
a
a
a
a
a
a
a
a
a
a
a
a
a
a
a
a
a
a
a
K
K
K
K
K
K
K
K
K
K
K
a
a
a
a
a
a
a
a
a
a
a
a
a
a
a
a
a
a
a
a
a
a
a
a
a
a
a
a
a
a
a
a
a
a
a
a
a
a
a
"}
(89,1,1) = {"
a
a
a
a
a
a
a
a
a
a
a
a
a
a
a
a
a
a
a
a
a
a
a
a
a
K
K
K
K
K
K
K
K
K
a
a
a
a
a
a
a
a
a
a
a
a
a
a
a
a
a
a
a
a
a
a
a
a
a
a
a
a
a
a
a
a
a
a
a
a
a
a
a
a
"}
(90,1,1) = {"
a
a
a
a
a
a
a
a
a
a
a
a
a
a
a
a
a
a
a
a
a
a
a
a
a
a
K
K
K
K
K
K
K
a
a
a
a
a
a
a
a
a
a
a
a
a
a
a
a
a
a
a
a
a
a
a
a
a
a
a
a
a
a
a
a
a
a
a
a
a
a
a
a
a
"}
(91,1,1) = {"
a
a
a
a
a
a
a
a
a
a
a
a
a
a
a
a
a
a
a
a
a
a
a
a
a
a
a
K
K
K
K
K
a
a
a
a
a
a
a
a
a
a
a
a
a
a
a
a
a
a
a
a
a
a
a
a
a
a
a
a
a
a
a
a
a
a
a
a
a
a
a
a
a
a
"}
(92,1,1) = {"
a
a
a
a
a
a
a
a
a
a
a
a
a
a
a
a
a
a
a
a
a
a
a
a
a
a
a
a
a
a
a
a
a
a
a
a
a
a
a
a
a
a
a
a
a
a
a
a
a
a
a
a
a
a
a
a
a
a
a
a
a
a
a
a
a
a
a
a
a
a
a
a
a
a
"}
(93,1,1) = {"
a
a
a
a
a
a
a
a
a
a
a
a
a
a
a
a
a
a
a
a
a
a
a
a
a
a
a
a
a
a
a
a
a
a
a
a
a
a
a
a
a
a
a
a
a
a
a
a
a
a
a
a
a
a
a
a
a
a
a
a
a
a
a
a
a
a
a
a
a
a
a
a
a
a
"}
(94,1,1) = {"
a
a
a
a
a
a
a
a
a
a
a
a
a
a
a
a
a
a
a
a
a
a
a
a
a
a
a
a
a
a
a
a
a
a
a
a
a
a
a
a
a
a
a
a
a
a
a
a
a
a
a
a
a
a
a
a
a
a
a
a
a
a
a
a
a
a
a
a
a
a
a
a
a
a
"}
(95,1,1) = {"
a
a
a
a
a
a
a
a
a
a
a
a
a
a
a
a
a
a
a
a
a
a
a
a
a
a
a
a
a
a
a
a
a
a
a
a
a
a
a
a
a
a
a
a
a
a
a
a
a
a
a
a
a
a
a
a
a
a
a
a
a
a
a
a
a
a
a
a
a
a
a
a
a
a
"}
