//MAP CONVERTED BY dmm2tgm.py THIS HEADER COMMENT PREVENTS RECONVERSION, DO NOT REMOVE
"cC" = (
/obj/structure/chair/fancy/comfy{
	dir = 8
	},
/obj/machinery/light/small{
	dir = 4
	},
/turf/open/indestructible/hotelwood,
/area/misc/hilbertshotel)
"eK" = (
/turf/closed/indestructible/hoteldoor,
/area/misc/hilbertshotel)
"fb" = (
/obj/structure/closet/crate/bin,
/obj/machinery/light/small{
	dir = 4
	},
/turf/open/indestructible/hotelwood,
/area/misc/hilbertshotel)
"gq" = (
/obj/structure/table/wood,
/obj/structure/showcase/machinery/tv,
/obj/machinery/light/small{
	dir = 1
	},
/turf/open/indestructible/hotelwood,
/area/misc/hilbertshotel)
"gG" = (
/obj/structure/toilet{
	dir = 8
	},
/obj/structure/window/reinforced/tinted/spawner/directional/north,
/obj/structure/window/reinforced/tinted/spawner/directional/west,
/turf/open/indestructible/hoteltile,
/area/misc/hilbertshotel)
"iI" = (
/obj/machinery/shower{
	dir = 8
	},
/obj/effect/decal/cleanable/dirt,
/turf/open/indestructible/hoteltile,
/area/misc/hilbertshotel)
"iO" = (
/obj/structure/table/wood/poker,
/turf/open/indestructible/hotelwood,
/area/misc/hilbertshotel)
"jH" = (
/obj/machinery/light/small,
/turf/open/indestructible/hoteltile,
/area/misc/hilbertshotel)
"le" = (
/obj/effect/decal/cleanable/dirt,
/turf/open/indestructible/hotelwood,
/area/misc/hilbertshotel)
"mv" = (
/obj/structure/table/wood/fancy,
/obj/structure/mirror{
	broken = 1;
	desc = "Oh no, seven years of bad luck!";
	icon_state = "mirror_broke";
	pixel_y = 24
	},
/obj/machinery/light/small{
	dir = 1
	},
/turf/open/indestructible/hotelwood,
/area/misc/hilbertshotel)
"my" = (
/obj/structure/mineral_door/wood,
/turf/open/indestructible/hotelwood,
/area/misc/hilbertshotel)
"nA" = (
/obj/machinery/light_switch{
	pixel_x = -32
	},
/turf/open/indestructible/hotelwood,
/area/misc/hilbertshotel)
"nI" = (
/turf/open/indestructible/hotelwood,
/area/misc/hilbertshotel)
"oa" = (
/obj/structure/window/reinforced/tinted/spawner/directional/west,
/obj/structure/window/reinforced/tinted/spawner/directional/south,
/turf/open/indestructible/hoteltile,
/area/misc/hilbertshotel)
"pA" = (
/obj/structure/table/reinforced,
/obj/item/paper/crumpled/bloody/docsdeathnote,
/turf/open/indestructible/hotelwood,
/area/misc/hilbertshotel)
"pR" = (
/obj/structure/curtain,
/turf/open/indestructible/hoteltile,
/area/misc/hilbertshotel)
"ql" = (
/obj/structure/bed,
/obj/item/bedsheet/random,
/turf/open/indestructible/hotelwood,
/area/misc/hilbertshotel)
"ru" = (
/obj/structure/table/reinforced,
/obj/machinery/light/small{
	dir = 4
	},
/obj/effect/decal/cleanable/dirt,
/turf/open/indestructible/hotelwood,
/area/misc/hilbertshotel)
"rK" = (
/turf/closed/indestructible/hotelwall,
/area/misc/hilbertshotel)
"rN" = (
/obj/effect/decal/cleanable/cobweb,
/turf/open/indestructible/hotelwood,
/area/misc/hilbertshotel)
"sh" = (
/obj/structure/table/reinforced,
/turf/open/indestructible/hotelwood,
/area/misc/hilbertshotel)
"sk" = (
/turf/open/space/bluespace,
/area/misc/hilbertshotel)
"sH" = (
/obj/item/bikehorn/rubberducky,
/obj/machinery/light/small{
	dir = 4
	},
/turf/open/indestructible/hoteltile,
/area/misc/hilbertshotel)
"tM" = (
/obj/structure/table/reinforced,
/obj/structure/sink/kitchen/directional/south,
/obj/machinery/light/small,
/turf/open/indestructible/hotelwood,
/area/misc/hilbertshotel)
"tY" = (
/obj/effect/decal/cleanable/dirt,
/turf/open/indestructible/hoteltile,
/area/misc/hilbertshotel)
"vM" = (
/obj/structure/table/reinforced,
/obj/item/soap/homemade{
	name = "used soap"
	},
/turf/open/indestructible/hoteltile,
/area/misc/hilbertshotel)
"wt" = (
/obj/structure/window/reinforced/tinted/spawner/directional/west,
/turf/open/indestructible/hoteltile,
/area/misc/hilbertshotel)
"wV" = (
/obj/structure/table/reinforced,
/obj/machinery/microwave,
/turf/open/indestructible/hotelwood,
/area/misc/hilbertshotel)
"xq" = (
/obj/structure/chair/fancy/comfy{
	dir = 4
	},
/obj/machinery/light/small{
	dir = 8
	},
/turf/open/indestructible/hotelwood,
/area/misc/hilbertshotel)
"zy" = (
/turf/open/indestructible/hoteltile,
/area/misc/hilbertshotel)
"Ai" = (
/obj/machinery/light/small{
	dir = 1
	},
/turf/open/indestructible/hoteltile,
/area/misc/hilbertshotel)
"Bn" = (
/obj/structure/chair/stool/bar,
/obj/effect/decal/cleanable/blood,
/obj/effect/decal/cleanable/vomit,
/obj/effect/mob_spawn/human/doctorhilbert,
/turf/open/indestructible/hotelwood,
/area/misc/hilbertshotel)
"Bw" = (
/obj/structure/table/wood,
/turf/open/indestructible/hotelwood,
/area/misc/hilbertshotel)
"BN" = (
/obj/structure/mirror{
	pixel_x = -32
	},
/obj/structure/sink/directional/east,
/obj/effect/decal/cleanable/dirt,
/turf/open/indestructible/hoteltile,
/area/misc/hilbertshotel)
"BO" = (
/obj/structure/table/wood/fancy,
/obj/item/flashlight/lamp/green,
/turf/open/indestructible/hotelwood,
/area/misc/hilbertshotel)
"Ex" = (
/obj/effect/decal/cleanable/dirt,
/obj/effect/decal/cleanable/cobweb/cobweb2,
/turf/open/indestructible/hotelwood,
/area/misc/hilbertshotel)
"EB" = (
/obj/structure/bed,
/obj/item/bedsheet/random,
/obj/effect/decal/cleanable/dirt,
/turf/open/indestructible/hotelwood,
/area/misc/hilbertshotel)
"FN" = (
/obj/structure/window/reinforced/tinted/spawner/directional/west,
/obj/structure/window/reinforced/tinted/spawner/directional/north,
/turf/open/indestructible/hoteltile,
/area/misc/hilbertshotel)
"Gm" = (
/obj/structure/closet/cabinet{
	anchored = 1
	},
/turf/open/indestructible/hotelwood,
/area/misc/hilbertshotel)
"GR" = (
/obj/structure/table/wood/poker,
/obj/item/toy/cards/deck,
/turf/open/indestructible/hotelwood,
/area/misc/hilbertshotel)
"Hm" = (
/obj/machinery/light/small,
/turf/open/indestructible/hotelwood,
/area/misc/hilbertshotel)
"Iy" = (
/obj/structure/chair/stool/bar,
/turf/open/indestructible/hotelwood,
/area/misc/hilbertshotel)
"KZ" = (
/obj/effect/decal/cleanable/dirt,
/obj/effect/decal/cleanable/cobweb/cobweb2,
/turf/open/indestructible/hoteltile,
/area/misc/hilbertshotel)
"LB" = (
/obj/effect/decal/cleanable/dirt,
/obj/effect/decal/cleanable/dirt,
/turf/open/indestructible/hotelwood,
/area/misc/hilbertshotel)
"MA" = (
/obj/structure/table/reinforced,
/obj/item/pen,
/turf/open/indestructible/hotelwood,
/area/misc/hilbertshotel)
"MD" = (
/obj/structure/extinguisher_cabinet{
	pixel_x = 32
	},
/turf/open/indestructible/hotelwood,
/area/misc/hilbertshotel)
"NT" = (
/obj/structure/table/reinforced,
/obj/machinery/light/small{
	dir = 8
	},
/obj/item/soap/homemade{
	name = "used soap"
	},
/turf/open/indestructible/hoteltile,
/area/misc/hilbertshotel)
"PQ" = (
/obj/machinery/jukebox{
	req_access = null
	},
/turf/open/indestructible/hotelwood,
/area/misc/hilbertshotel)
"Qh" = (
/obj/structure/table/wood/poker,
/obj/effect/decal/cleanable/dirt,
/turf/open/indestructible/hotelwood,
/area/misc/hilbertshotel)
"RI" = (
/obj/structure/mineral_door/paperframe,
/turf/open/indestructible/hotelwood,
/area/misc/hilbertshotel)
"RJ" = (
/obj/structure/table/wood/fancy,
/turf/open/indestructible/hotelwood,
/area/misc/hilbertshotel)
"RX" = (
/obj/machinery/light/small{
	dir = 8
	},
/turf/open/indestructible/hotelwood,
/area/misc/hilbertshotel)
"Sq" = (
/obj/effect/decal/cleanable/blood,
/turf/open/indestructible/hoteltile,
/area/misc/hilbertshotel)
"Sy" = (
/obj/structure/chair/fancy/comfy{
	dir = 1
	},
/turf/open/indestructible/hotelwood,
/area/misc/hilbertshotel)
"SI" = (
/obj/machinery/shower{
	dir = 8
	},
/turf/open/indestructible/hoteltile,
/area/misc/hilbertshotel)
"Uw" = (
/obj/structure/table/reinforced,
/obj/item/analyzer/hilbertsanalyzer,
/turf/open/indestructible/hotelwood,
/area/misc/hilbertshotel)
"VG" = (
/obj/effect/decal/cleanable/vomit,
/turf/open/indestructible/hoteltile,
/area/misc/hilbertshotel)
"WC" = (
/obj/structure/mirror{
	pixel_x = -32
	},
/obj/structure/sink/directional/east,
/turf/open/indestructible/hoteltile,
/area/misc/hilbertshotel)
"WJ" = (
/obj/machinery/light/small{
	dir = 8
	},
/obj/effect/decal/cleanable/dirt,
/turf/open/indestructible/hotelwood,
/area/misc/hilbertshotel)
"YM" = (
/obj/machinery/light_switch{
	pixel_x = 32
	},
/obj/effect/decal/cleanable/dirt,
/turf/open/indestructible/hotelwood,
/area/misc/hilbertshotel)
"Zx" = (
/obj/structure/dresser,
/turf/open/indestructible/hotelwood,
/area/misc/hilbertshotel)
"ZK" = (
/obj/machinery/door/window/northleft,
/turf/open/indestructible/hotelwood,
/area/misc/hilbertshotel)
"ZT" = (
/obj/machinery/smartfridge/food,
/turf/open/indestructible/hotelwood,
/area/misc/hilbertshotel)

(1,1,1) = {"
sk
sk
sk
sk
sk
sk
sk
sk
sk
sk
sk
sk
sk
sk
sk
"}
(2,1,1) = {"
sk
rK
rK
rK
rK
rK
eK
rK
rK
rK
rK
rK
rK
rK
sk
"}
(3,1,1) = {"
sk
rK
rN
le
xq
nI
le
RX
nI
ZK
WJ
wV
sh
rK
sk
"}
(4,1,1) = {"
sk
rK
Bw
nI
iO
Sy
nI
nI
Iy
MA
nI
le
sh
rK
sk
"}
(5,1,1) = {"
sk
rK
gq
nI
GR
Sy
le
nI
Bn
pA
nI
le
tM
rK
sk
"}
(6,1,1) = {"
sk
rK
Bw
nI
Qh
Sy
nI
nI
Iy
Uw
LB
LB
sh
rK
sk
"}
(7,1,1) = {"
sk
rK
PQ
le
cC
nI
YM
fb
MD
sh
ru
ZT
sh
rK
sk
"}
(8,1,1) = {"
sk
rK
rK
rK
rK
my
rK
rK
rK
rK
rK
rK
rK
rK
sk
"}
(9,1,1) = {"
sk
rK
Zx
nI
RX
nI
nA
RI
zy
BN
NT
WC
vM
rK
sk
"}
(10,1,1) = {"
sk
rK
RJ
nI
le
le
nI
rK
tY
tY
zy
tY
tY
rK
sk
"}
(11,1,1) = {"
sk
rK
mv
nI
nI
le
Hm
rK
Ai
zy
gG
VG
jH
rK
sk
"}
(12,1,1) = {"
sk
rK
RJ
nI
le
nI
Gm
rK
pR
FN
wt
oa
pR
rK
sk
"}
(13,1,1) = {"
sk
rK
nI
nI
le
nI
nI
rK
zy
Sq
tY
tY
zy
rK
sk
"}
(14,1,1) = {"
sk
rK
Ex
BO
ql
EB
RJ
rK
KZ
iI
sH
SI
zy
rK
sk
"}
(15,1,1) = {"
sk
rK
rK
rK
rK
rK
rK
rK
rK
rK
rK
rK
rK
rK
sk
"}
(16,1,1) = {"
sk
sk
sk
sk
sk
sk
sk
sk
sk
sk
sk
sk
sk
sk
sk
"}
