//MAP CONVERTED BY dmm2tgm.py THIS HEADER COMMENT PREVENTS RECONVERSION, DO NOT REMOVE
"aa" = (
/turf/open/space/bluespace,
/area/hilbertshotel)
"ab" = (
/turf/closed/indestructible/hotelwall,
/area/hilbertshotel)
"ac" = (
/obj/structure/table/wood/fancy{
	dir = 1
	},
/obj/structure/mirror{
	broken = 1;
	desc = "Oh no, seven years of bad luck!";
	icon_state = "mirror_broke";
	pixel_y = -24;
	dir = 1
	},
/obj/machinery/light/small{
	dir = 2
	},
/turf/open/indestructible/hotelwood,
/area/hilbertshotel)
"ad" = (
/turf/open/indestructible/hotelwood,
/area/hilbertshotel)
"ae" = (
/obj/structure/table/wood{
	dir = 1
	},
/turf/open/indestructible/hotelwood,
/area/hilbertshotel)
"af" = (
/obj/structure/table/wood{
	dir = 1
	},
/obj/structure/showcase/machinery/tv{
	dir = 1
	},
/obj/machinery/light/small{
	dir = 2
	},
/turf/open/indestructible/hotelwood,
/area/hilbertshotel)
"ag" = (
/obj/structure/dresser{
	dir = 1
	},
/turf/open/indestructible/hotelwood,
/area/hilbertshotel)
"ah" = (
/obj/structure/table/wood/fancy{
	dir = 1
	},
/turf/open/indestructible/hotelwood,
/area/hilbertshotel)
"ai" = (
/obj/structure/table/wood/poker{
	dir = 1
	},
/obj/item/toy/cards/deck{
	dir = 1
	},
/turf/open/indestructible/hotelwood,
/area/hilbertshotel)
"aj" = (
/obj/structure/table/wood/fancy{
	dir = 1
	},
/obj/item/flashlight/lamp/green{
	dir = 1
	},
/turf/open/indestructible/hotelwood,
/area/hilbertshotel)
"ak" = (
/obj/structure/chair/comfy/brown{
	dir = 4
	},
/obj/machinery/light/small{
	dir = 8
	},
/turf/open/indestructible/hotelwood,
/area/hilbertshotel)
"al" = (
/obj/structure/table/wood/poker{
	dir = 1
	},
/turf/open/indestructible/hotelwood,
/area/hilbertshotel)
"am" = (
/obj/structure/chair/comfy/brown{
	dir = 8
	},
/obj/machinery/light/small{
	dir = 4
	},
/turf/open/indestructible/hotelwood,
/area/hilbertshotel)
"an" = (
/obj/machinery/light/small{
	dir = 8
	},
/turf/open/indestructible/hotelwood,
/area/hilbertshotel)
"ap" = (
/obj/structure/bed{
	dir = 1
	},
/obj/item/bedsheet/random{
	dir = 1
	},
/turf/open/indestructible/hotelwood,
/area/hilbertshotel)
"aq" = (
/obj/structure/chair/comfy/brown{
	dir = 2
	},
/turf/open/indestructible/hotelwood,
/area/hilbertshotel)
"ar" = (
/obj/structure/mineral_door/wood{
	dir = 1
	},
/turf/open/indestructible/hotelwood,
/area/hilbertshotel)
"as" = (
/turf/closed/indestructible/hoteldoor,
/area/hilbertshotel)
"at" = (
/obj/effect/decal/cleanable/cobweb{
	dir = 4
	},
/turf/open/indestructible/hotelwood,
/area/hilbertshotel)
"au" = (
/obj/machinery/light_switch{
	pixel_x = -32;
	dir = 1
	},
/turf/open/indestructible/hotelwood,
/area/hilbertshotel)
"av" = (
/obj/machinery/light/small{
	dir = 1
	},
/turf/open/indestructible/hotelwood,
/area/hilbertshotel)
"aw" = (
/obj/structure/closet/cabinet{
	anchored = 1;
	dir = 1
	},
/turf/open/indestructible/hotelwood,
/area/hilbertshotel)
"ax" = (
/obj/effect/decal/cleanable/dirt{
	dir = 4
	},
/obj/effect/decal/cleanable/cobweb/cobweb2{
	dir = 4
	},
/turf/open/indestructible/hotelwood,
/area/hilbertshotel)
"ay" = (
/obj/structure/closet/crate/bin{
	dir = 1
	},
/obj/machinery/light/small{
	dir = 4
	},
/turf/open/indestructible/hotelwood,
/area/hilbertshotel)
"az" = (
/obj/structure/mineral_door/paperframe{
	dir = 1
	},
/turf/open/indestructible/hotelwood,
/area/hilbertshotel)
"aA" = (
/obj/structure/chair/stool/bar{
	dir = 1
	},
/turf/open/indestructible/hotelwood,
/area/hilbertshotel)
"aB" = (
/obj/structure/extinguisher_cabinet{
	pixel_x = 32;
	dir = 1
	},
/turf/open/indestructible/hotelwood,
/area/hilbertshotel)
"aC" = (
/turf/open/indestructible/hoteltile,
/area/hilbertshotel)
"aD" = (
/obj/machinery/light/small{
	dir = 2
	},
/turf/open/indestructible/hoteltile,
/area/hilbertshotel)
"aE" = (
/obj/structure/curtain{
	dir = 1
	},
/turf/open/indestructible/hoteltile,
/area/hilbertshotel)
"aF" = (
/obj/machinery/door/window/southleft,
/turf/open/indestructible/hotelwood,
/area/hilbertshotel)
"aG" = (
/obj/structure/table/reinforced{
	dir = 1
	},
/turf/open/indestructible/hotelwood,
/area/hilbertshotel)
"aH" = (
/obj/structure/table/reinforced{
	dir = 1
	},
/obj/item/pen{
	dir = 1
	},
/turf/open/indestructible/hotelwood,
/area/hilbertshotel)
"aI" = (
/obj/structure/mirror{
	pixel_x = -32;
	dir = 1
	},
/obj/structure/sink{
	dir = 8;
	pixel_x = -12;
	pixel_y = -2
	},
/turf/open/indestructible/hoteltile,
/area/hilbertshotel)
"aJ" = (
/obj/structure/window/reinforced/tinted{
	dir = 8
	},
/obj/structure/window/reinforced/tinted{
	dir = 2
	},
/turf/open/indestructible/hoteltile,
/area/hilbertshotel)
"aK" = (
/obj/machinery/shower{
	dir = 8
	},
/turf/open/indestructible/hoteltile,
/area/hilbertshotel)
"aL" = (
/obj/effect/decal/cleanable/dirt{
	dir = 4
	},
/turf/open/indestructible/hotelwood,
/area/hilbertshotel)
"aM" = (
/obj/structure/table/wood/poker{
	dir = 1
	},
/obj/effect/decal/cleanable/dirt{
	dir = 4
	},
/turf/open/indestructible/hotelwood,
/area/hilbertshotel)
"aN" = (
/obj/structure/toilet{
	dir = 8
	},
/obj/structure/window/reinforced/tinted{
	dir = 2
	},
/obj/structure/window/reinforced/tinted{
	dir = 8
	},
/turf/open/indestructible/hoteltile,
/area/hilbertshotel)
"aO" = (
/obj/structure/window/reinforced/tinted{
	dir = 8
	},
/turf/open/indestructible/hoteltile,
/area/hilbertshotel)
"aP" = (
/obj/item/bikehorn/rubberducky{
	dir = 1
	},
/obj/machinery/light/small{
	dir = 4
	},
/turf/open/indestructible/hoteltile,
/area/hilbertshotel)
"aQ" = (
/obj/structure/table/reinforced{
	dir = 1
	},
/obj/machinery/microwave{
	dir = 1
	},
/turf/open/indestructible/hotelwood,
/area/hilbertshotel)
"aR" = (
/obj/machinery/smartfridge/food{
	dir = 1
	},
/turf/open/indestructible/hotelwood,
/area/hilbertshotel)
"aS" = (
/obj/structure/window/reinforced/tinted{
	dir = 8
	},
/obj/structure/window/reinforced/tinted{
	dir = 1
	},
/turf/open/indestructible/hoteltile,
/area/hilbertshotel)
"aT" = (
/obj/structure/table/reinforced{
	dir = 1
	},
/obj/structure/sink/kitchen{
	dir = 1
	},
/obj/machinery/light/small{
	dir = 1
	},
/turf/open/indestructible/hotelwood,
/area/hilbertshotel)
"aU" = (
/obj/structure/bed{
	dir = 1
	},
/obj/item/bedsheet/random{
	dir = 1
	},
/obj/effect/decal/cleanable/dirt{
	dir = 4
	},
/turf/open/indestructible/hotelwood,
/area/hilbertshotel)
"aV" = (
/obj/machinery/light/small{
	dir = 1
	},
/turf/open/indestructible/hoteltile,
/area/hilbertshotel)
"aW" = (
/obj/machinery/jukebox{
	req_access = null;
	dir = 1
	},
/turf/open/indestructible/hotelwood,
/area/hilbertshotel)
"aX" = (
/obj/machinery/light_switch{
	pixel_x = 32;
	dir = 1
	},
/obj/effect/decal/cleanable/dirt{
	dir = 4
	},
/turf/open/indestructible/hotelwood,
/area/hilbertshotel)
"aY" = (
/obj/structure/chair/stool/bar{
	dir = 1
	},
/obj/effect/decal/cleanable/blood{
	dir = 4
	},
/obj/effect/decal/cleanable/vomit{
	dir = 4
	},
/obj/effect/mob_spawn/human/doctorhilbert{
	dir = 1
	},
/turf/open/indestructible/hotelwood,
/area/hilbertshotel)
"aZ" = (
/obj/effect/decal/cleanable/dirt{
	dir = 4
	},
/turf/open/indestructible/hoteltile,
/area/hilbertshotel)
"ba" = (
/obj/effect/decal/cleanable/dirt{
	dir = 4
	},
/obj/effect/decal/cleanable/cobweb/cobweb2{
	dir = 4
	},
/turf/open/indestructible/hoteltile,
/area/hilbertshotel)
"bb" = (
/obj/structure/mirror{
	pixel_x = -32;
	dir = 1
	},
/obj/structure/sink{
	dir = 8;
	pixel_x = -12;
	pixel_y = -2
	},
/obj/effect/decal/cleanable/dirt{
	dir = 4
	},
/turf/open/indestructible/hoteltile,
/area/hilbertshotel)
"bc" = (
/obj/effect/decal/cleanable/blood{
	dir = 4
	},
/turf/open/indestructible/hoteltile,
/area/hilbertshotel)
"bd" = (
/obj/machinery/shower{
	dir = 8
	},
/obj/effect/decal/cleanable/dirt{
	dir = 4
	},
/turf/open/indestructible/hoteltile,
/area/hilbertshotel)
"be" = (
/obj/machinery/light/small{
	dir = 8
	},
/obj/effect/decal/cleanable/dirt{
	dir = 4
	},
/turf/open/indestructible/hotelwood,
/area/hilbertshotel)
"bf" = (
/obj/effect/decal/cleanable/dirt{
	dir = 4
	},
/obj/effect/decal/cleanable/dirt{
	dir = 4
	},
/turf/open/indestructible/hotelwood,
/area/hilbertshotel)
"bg" = (
/obj/structure/table/reinforced{
	dir = 1
	},
/obj/machinery/light/small{
	dir = 4
	},
/obj/effect/decal/cleanable/dirt{
	dir = 4
	},
/turf/open/indestructible/hotelwood,
/area/hilbertshotel)
"bh" = (
/obj/structure/table/reinforced{
	dir = 1
	},
/obj/machinery/light/small{
	dir = 8
	},
/obj/item/soap/homemade{
	name = "used soap";
	dir = 1
	},
/turf/open/indestructible/hoteltile,
/area/hilbertshotel)
"bi" = (
/obj/effect/decal/cleanable/vomit{
	dir = 4
	},
/turf/open/indestructible/hoteltile,
/area/hilbertshotel)
"bj" = (
/obj/structure/table/reinforced{
	dir = 1
	},
/obj/item/soap/homemade{
	name = "used soap";
	dir = 1
	},
/turf/open/indestructible/hoteltile,
/area/hilbertshotel)
"bk" = (
/obj/structure/table/reinforced{
	dir = 1
	},
/obj/item/analyzer/hilbertsanalyzer{
	dir = 1
	},
/turf/open/indestructible/hotelwood,
/area/hilbertshotel)
"bl" = (
/obj/structure/table/reinforced{
	dir = 1
	},
/obj/item/paper/crumpled/bloody/docsdeathnote{
	dir = 1
	},
/turf/open/indestructible/hotelwood,
/area/hilbertshotel)

(1,1,1) = {"
aa
aa
aa
aa
aa
aa
aa
aa
aa
aa
aa
aa
aa
aa
aa"}(2,1,1) = {"
aa
ab
ab
ab
ab
ab
ab
ab
as
ab
ab
ab
ab
ab
aa"}(3,1,1) = {"
aa
ab
aG
aQ
be
aF
ad
an
aL
ad
ak
aL
at
ab
aa"}(4,1,1) = {"
aa
ab
aG
aL
ad
aH
aA
ad
ad
aq
al
ad
ae
ab
aa"}(5,1,1) = {"
aa
ab
aT
aL
ad
bl
aY
ad
aL
aq
ai
ad
af
ab
aa"}(6,1,1) = {"
aa
ab
aG
bf
bf
bk
aA
ad
ad
aq
aM
ad
ae
ab
aa"}(7,1,1) = {"
aa
ab
aG
aR
bg
aG
aB
ay
aX
ad
am
aL
aW
ab
aa"}(8,1,1) = {"
aa
ab
ab
ab
ab
ab
ab
ab
ab
ar
ab
ab
ab
ab
aa"}(9,1,1) = {"
aa
ab
bj
aI
bh
bb
aC
az
au
ad
an
ad
ag
ab
aa"}(10,1,1) = {"
aa
ab
aZ
aZ
aC
aZ
aZ
ab
ad
aL
aL
ad
ah
ab
aa"}(11,1,1) = {"
aa
ab
aV
bi
aN
aC
aD
ab
av
aL
ad
ad
ac
ab
aa"}(12,1,1) = {"
aa
ab
aE
aS
aO
aJ
aE
ab
aw
ad
aL
ad
ah
ab
aa"}(13,1,1) = {"
aa
ab
aC
aZ
aZ
bc
aC
ab
ad
ad
aL
ad
ad
ab
aa"}(14,1,1) = {"
aa
ab
aC
aK
aP
bd
ba
ab
ah
aU
ap
aj
ax
ab
aa"}(15,1,1) = {"
aa
ab
ab
ab
ab
ab
ab
ab
ab
ab
ab
ab
ab
ab
aa"}(16,1,1) = {"
aa
aa
aa
aa
aa
aa
aa
aa
aa
aa
aa
aa
aa
aa
aa"}