//MAP CONVERTED BY dmm2tgm.py THIS HEADER COMMENT PREVENTS RECONVERSION, DO NOT REMOVE
"aX" = (
/turf/open/space/bluespace,
/area/misc/hilbertshotel)
"bv" = (
/turf/closed/indestructible/hotelwall,
/area/misc/hilbertshotel)
"bZ" = (
/obj/structure/table/reinforced,
/obj/machinery/light/small/directional/east,
/turf/open/indestructible/hotelwood,
/area/misc/hilbertshotel)
"dt" = (
/obj/structure/table/wood/poker,
/obj/item/gps{
	pixel_x = -5;
	pixel_y = 5
	},
/obj/item/reagent_containers/cup/glass/coffee{
	pixel_x = 9;
	pixel_y = 2
	},
/turf/open/indestructible/hotelwood,
/area/misc/hilbertshotel)
"eh" = (
/obj/item/bikehorn/rubberducky,
/obj/machinery/light/small/directional/east,
/turf/open/indestructible/hoteltile,
/area/misc/hilbertshotel)
"ex" = (
/obj/machinery/light_switch{
	pixel_x = -32
	},
/turf/open/indestructible/hotelwood,
/area/misc/hilbertshotel)
"gk" = (
/turf/open/indestructible/hotelwood,
/area/misc/hilbertshotel)
"it" = (
/obj/machinery/light/small/directional/west,
/turf/open/indestructible/hotelwood,
/area/misc/hilbertshotel)
"jh" = (
/obj/structure/table/reinforced,
/turf/open/indestructible/hotelwood,
/area/misc/hilbertshotel)
"kL" = (
/obj/machinery/light/small/directional/south,
/turf/open/indestructible/hoteltile,
/area/misc/hilbertshotel)
"le" = (
/obj/structure/chair/stool/bar,
/turf/open/indestructible/hotelwood,
/area/misc/hilbertshotel)
"ml" = (
/obj/structure/table/wood,
/obj/structure/showcase/machinery/tv,
/obj/machinery/light/small/directional/north,
/turf/open/indestructible/hotelwood,
/area/misc/hilbertshotel)
"mE" = (
/obj/structure/table/wood/poker,
/obj/item/reagent_containers/cup/glass/coffee{
	pixel_x = -6;
	pixel_y = 2
	},
/obj/item/gps{
	pixel_x = 5;
	pixel_y = 5
	},
/turf/open/indestructible/hotelwood,
/area/misc/hilbertshotel)
"tf" = (
/obj/structure/dresser,
/turf/open/indestructible/hotelwood,
/area/misc/hilbertshotel)
"tt" = (
/obj/structure/table/wood,
/turf/open/indestructible/hotelwood,
/area/misc/hilbertshotel)
"tW" = (
/obj/structure/window/reinforced/tinted/spawner/directional/west,
/obj/structure/window/reinforced/tinted/spawner/directional/north,
/turf/open/indestructible/hoteltile,
/area/misc/hilbertshotel)
"uB" = (
/obj/structure/extinguisher_cabinet{
	pixel_x = 32
	},
/turf/open/indestructible/hotelwood,
/area/misc/hilbertshotel)
"wp" = (
/obj/machinery/shower{
	dir = 8
	},
/turf/open/indestructible/hoteltile,
/area/misc/hilbertshotel)
"wP" = (
/obj/structure/chair/fancy/comfy{
	dir = 4
	},
/obj/machinery/light/small/directional/west,
/turf/open/indestructible/hotelwood,
/area/misc/hilbertshotel)
"yF" = (
/obj/structure/bed,
/obj/item/bedsheet/random,
/turf/open/indestructible/hotelwood,
/area/misc/hilbertshotel)
"yH" = (
/obj/structure/mineral_door/paperframe,
/turf/open/indestructible/hotelwood,
/area/misc/hilbertshotel)
"Ak" = (
/turf/closed/indestructible/hoteldoor,
/area/misc/hilbertshotel)
"An" = (
/obj/structure/mineral_door/wood,
/turf/open/indestructible/hotelwood,
/area/misc/hilbertshotel)
"Aw" = (
/obj/structure/table/reinforced,
/obj/machinery/microwave,
/turf/open/indestructible/hotelwood,
/area/misc/hilbertshotel)
"Cl" = (
/obj/machinery/smartfridge/food,
/turf/open/indestructible/hotelwood,
/area/misc/hilbertshotel)
"Gr" = (
/obj/machinery/light_switch{
	pixel_x = 32
	},
/turf/open/indestructible/hotelwood,
/area/misc/hilbertshotel)
"If" = (
/obj/structure/chair/fancy/comfy{
	dir = 8
	},
/obj/machinery/light/small/directional/east,
/turf/open/indestructible/hotelwood,
/area/misc/hilbertshotel)
"IA" = (
/obj/machinery/door/window/northleft,
/turf/open/indestructible/hotelwood,
/area/misc/hilbertshotel)
"IN" = (
/obj/structure/table/reinforced,
/obj/item/soap/deluxe,
/turf/open/indestructible/hoteltile,
/area/misc/hilbertshotel)
"Jw" = (
/obj/structure/toilet{
	dir = 8
	},
/obj/structure/window/reinforced/tinted/spawner/directional/north,
/obj/structure/window/reinforced/tinted/spawner/directional/west,
/turf/open/indestructible/hoteltile,
/area/misc/hilbertshotel)
"Kl" = (
/turf/open/indestructible/hoteltile,
/area/misc/hilbertshotel)
"KS" = (
/obj/structure/mirror{
	pixel_x = -32
	},
/obj/structure/sink/directional/east,
/turf/open/indestructible/hoteltile,
/area/misc/hilbertshotel)
"Mc" = (
/obj/structure/table/reinforced,
/obj/item/soap/deluxe,
/obj/machinery/light/small/directional/west,
/turf/open/indestructible/hoteltile,
/area/misc/hilbertshotel)
"Mv" = (
/obj/effect/spawner/xmastree,
/turf/open/indestructible/hotelwood,
/area/misc/hilbertshotel)
"Mz" = (
/obj/structure/closet/emcloset,
/turf/open/indestructible/hotelwood,
/area/misc/hilbertshotel)
"Oe" = (
/obj/machinery/light/small/directional/south,
/turf/open/indestructible/hotelwood,
/area/misc/hilbertshotel)
"OB" = (
/obj/structure/table/wood/fancy,
/obj/structure/mirror{
	pixel_y = 24
	},
/obj/machinery/light/small/directional/north,
/turf/open/indestructible/hotelwood,
/area/misc/hilbertshotel)
"Pb" = (
/obj/structure/chair/fancy/comfy{
	dir = 1
	},
/turf/open/indestructible/hotelwood,
/area/misc/hilbertshotel)
"Pj" = (
/obj/structure/closet/crate/bin,
/obj/machinery/light/small/directional/east,
/turf/open/indestructible/hotelwood,
/area/misc/hilbertshotel)
"Qd" = (
/obj/structure/window/reinforced/tinted/spawner/directional/west,
/obj/structure/window/reinforced/tinted/spawner/directional/south,
/turf/open/indestructible/hoteltile,
/area/misc/hilbertshotel)
"RP" = (
/obj/machinery/light/small/directional/north,
/turf/open/indestructible/hoteltile,
/area/misc/hilbertshotel)
"UC" = (
/obj/structure/table/wood/fancy,
/turf/open/indestructible/hotelwood,
/area/misc/hilbertshotel)
"VL" = (
/obj/structure/table/reinforced,
/obj/effect/spawner/random/food_or_drink/three_course_meal,
/turf/open/indestructible/hotelwood,
/area/misc/hilbertshotel)
"Wl" = (
/obj/structure/table/wood/poker,
/obj/item/paper/crumpled/hilbertsstaffnotice{
	pixel_y = 3
	},
/turf/open/indestructible/hotelwood,
/area/misc/hilbertshotel)
"WC" = (
/obj/machinery/jukebox{
	req_access = null
	},
/turf/open/indestructible/hotelwood,
/area/misc/hilbertshotel)
"WE" = (
/obj/structure/table/wood/fancy,
/obj/item/flashlight/lamp/green,
/turf/open/indestructible/hotelwood,
/area/misc/hilbertshotel)
"Xo" = (
/obj/structure/table/reinforced,
/obj/structure/sink/kitchen/directional/south,
/obj/machinery/light/small/directional/south,
/turf/open/indestructible/hotelwood,
/area/misc/hilbertshotel)
"Yl" = (
/obj/structure/table/wood/fancy,
/obj/item/food/grown/flower/poppy,
/turf/open/indestructible/hotelwood,
/area/misc/hilbertshotel)
"Yt" = (
/obj/structure/curtain,
/turf/open/indestructible/hoteltile,
/area/misc/hilbertshotel)
"Zm" = (
/obj/structure/closet/cabinet{
	anchored = 1
	},
/turf/open/indestructible/hotelwood,
/area/misc/hilbertshotel)
"ZW" = (
/obj/structure/window/reinforced/tinted/spawner/directional/west,
/turf/open/indestructible/hoteltile,
/area/misc/hilbertshotel)

(1,1,1) = {"
aX
aX
aX
aX
aX
aX
aX
aX
aX
aX
aX
aX
aX
aX
aX
"}
(2,1,1) = {"
aX
bv
bv
bv
bv
bv
Ak
bv
bv
bv
bv
bv
bv
bv
aX
"}
(3,1,1) = {"
aX
bv
Mz
gk
wP
gk
gk
it
gk
IA
it
Aw
jh
bv
aX
"}
(4,1,1) = {"
aX
bv
tt
gk
mE
Pb
gk
gk
le
jh
gk
gk
jh
bv
aX
"}
(5,1,1) = {"
aX
bv
ml
gk
Wl
Pb
gk
gk
le
VL
gk
gk
Xo
bv
aX
"}
(6,1,1) = {"
aX
bv
tt
gk
dt
Pb
gk
gk
le
jh
gk
gk
jh
bv
aX
"}
(7,1,1) = {"
aX
bv
WC
gk
If
gk
Gr
Pj
uB
jh
bZ
Cl
jh
bv
aX
"}
(8,1,1) = {"
aX
bv
bv
bv
bv
An
bv
bv
bv
bv
bv
bv
bv
bv
aX
"}
(9,1,1) = {"
aX
bv
tf
gk
it
gk
ex
yH
Kl
KS
Mc
KS
IN
bv
aX
"}
(10,1,1) = {"
aX
bv
UC
gk
gk
gk
gk
bv
Kl
Kl
Kl
Kl
Kl
bv
aX
"}
(11,1,1) = {"
aX
bv
OB
gk
Mv
gk
Oe
bv
RP
Kl
Jw
Kl
kL
bv
aX
"}
(12,1,1) = {"
aX
bv
UC
gk
gk
gk
Zm
bv
Yt
tW
ZW
Qd
Yt
bv
aX
"}
(13,1,1) = {"
aX
bv
gk
gk
gk
gk
gk
bv
Kl
Kl
Kl
Kl
Kl
bv
aX
"}
(14,1,1) = {"
aX
bv
gk
WE
yF
yF
Yl
bv
Kl
wp
eh
wp
Kl
bv
aX
"}
(15,1,1) = {"
aX
bv
bv
bv
bv
bv
bv
bv
bv
bv
bv
bv
bv
bv
aX
"}
(16,1,1) = {"
aX
aX
aX
aX
aX
aX
aX
aX
aX
aX
aX
aX
aX
aX
aX
"}
