//MAP CONVERTED BY dmm2tgm.py THIS HEADER COMMENT PREVENTS RECONVERSION, DO NOT REMOVE
"aa" = (
/obj/effect/holodeck_effect/mobspawner/psycho,
/turf/open/floor/holofloor/dark,
/area/template_noop)
"ab" = (
/obj/machinery/door/window{
	dir = 2
	},
/turf/open/floor/holofloor/dark,
/area/template_noop)
"ac" = (
/obj/structure/window/spawner/directional/north,
/turf/open/floor/holofloor/dark,
/area/template_noop)
"ad" = (
/obj/structure/window/spawner/directional/north,
/obj/structure/window/spawner/directional/west,
/turf/open/floor/holofloor/dark,
/area/template_noop)
"ae" = (
/obj/structure/window/spawner/directional/south,
/obj/structure/window/spawner/directional/west,
/turf/open/floor/holofloor/dark,
/area/template_noop)
"af" = (
/obj/structure/window/spawner/directional/south,
/turf/open/floor/holofloor/dark,
/area/template_noop)
"ag" = (
/obj/structure/bed,
/turf/open/floor/holofloor/dark,
/area/template_noop)
"ah" = (
/obj/structure/toilet,
/turf/open/floor/holofloor/dark,
/area/template_noop)
"ak" = (
/turf/open/floor/holofloor/white,
/area/template_noop)
"al" = (
/obj/machinery/igniter,
/obj/effect/holodeck_effect/mobspawner/psycho,
/turf/open/floor/holofloor/dark,
/area/template_noop)
"am" = (
/obj/structure/window/reinforced/spawner/directional/west,
/obj/structure/window/reinforced/spawner/directional/north,
/obj/effect/turf_decal/tile/red{
	dir = 1
	},
/turf/open/floor/holofloor/dark,
/area/template_noop)
"ar" = (
/obj/effect/decal/cleanable/dirt,
/turf/open/floor/holofloor/white,
/area/template_noop)
"as" = (
/obj/structure/bed,
/obj/effect/decal/cleanable/vomit,
/turf/open/floor/holofloor/dark,
/area/template_noop)
"av" = (
/obj/structure/window/spawner/directional/south,
/obj/effect/decal/cleanable/vomit,
/turf/open/floor/holofloor/dark,
/area/template_noop)
"aw" = (
/obj/structure/table/glass,
/obj/item/clothing/glasses/blindfold,
/obj/item/clothing/glasses/blindfold,
/obj/item/clothing/glasses/blindfold,
/obj/effect/decal/cleanable/dirt,
/turf/open/floor/holofloor/white,
/area/template_noop)
"az" = (
/obj/structure/table/glass,
/obj/item/clothing/mask/muzzle,
/obj/item/clothing/mask/muzzle,
/obj/effect/decal/cleanable/dirt,
/obj/effect/decal/cleanable/dirt,
/turf/open/floor/holofloor/white,
/area/template_noop)
"aC" = (
/obj/structure/window/spawner/directional/west,
/obj/structure/toilet,
/turf/open/floor/holofloor/dark,
/area/template_noop)
"aE" = (
/obj/machinery/door/window{
	dir = 2
	},
/obj/effect/decal/cleanable/blood,
/turf/open/floor/holofloor/dark,
/area/template_noop)
"aF" = (
/obj/structure/window/spawner/directional/west,
/obj/structure/toilet{
	dir = 1
	},
/turf/open/floor/holofloor/dark,
/area/template_noop)
"aG" = (
/obj/machinery/door/window{
	dir = 1
	},
/turf/open/floor/holofloor/dark,
/area/template_noop)
"aH" = (
/obj/structure/table/glass,
/obj/item/reagent_containers/syringe,
/obj/item/reagent_containers/syringe,
/obj/item/reagent_containers/syringe,
/obj/item/reagent_containers/cup/beaker,
/obj/effect/decal/cleanable/dirt,
/turf/open/floor/holofloor/white,
/area/template_noop)
"aK" = (
/obj/structure/window/spawner/directional/north,
/obj/structure/window/spawner/directional/west,
/obj/effect/decal/cleanable/vomit,
/turf/open/floor/holofloor/dark,
/area/template_noop)
"aL" = (
/obj/structure/toilet{
	dir = 1
	},
/obj/effect/decal/cleanable/vomit,
/turf/open/floor/holofloor/dark,
/area/template_noop)
"aM" = (
/obj/structure/bed,
/obj/effect/decal/cleanable/blood,
/turf/open/floor/holofloor/dark,
/area/template_noop)
"aN" = (
/obj/structure/window/reinforced/spawner/directional/east,
/obj/structure/window/reinforced/spawner/directional/south,
/obj/effect/turf_decal/tile/red,
/turf/open/floor/holofloor/dark,
/area/template_noop)
"aO" = (
/obj/effect/decal/cleanable/dirt/dust,
/turf/open/floor/holofloor/white,
/area/template_noop)
"aQ" = (
/obj/structure/sink{
	dir = 8;
	pixel_x = -12
	},
/turf/open/floor/holofloor/white,
/area/template_noop)
"aS" = (
/obj/structure/window/reinforced/spawner/directional/west,
/obj/structure/window/reinforced/spawner/directional/east,
/obj/machinery/door/window/brigdoor,
/obj/effect/decal/cleanable/blood/tracks,
/obj/effect/decal/cleanable/blood/footprints,
/turf/open/floor/holofloor/white,
/area/template_noop)
"aV" = (
/obj/machinery/door/window{
	dir = 1
	},
/obj/effect/decal/cleanable/blood/tracks,
/turf/open/floor/holofloor/dark,
/area/template_noop)
"aW" = (
/obj/effect/decal/cleanable/blood,
/turf/open/floor/holofloor/dark,
/area/template_noop)
"aX" = (
/obj/effect/turf_decal/tile/yellow/half/contrasted{
	dir = 8
	},
/turf/open/floor/holofloor/white,
/area/template_noop)
"aY" = (
/obj/effect/decal/cleanable/dirt/dust,
/obj/effect/decal/cleanable/blood/drip,
/obj/effect/decal/cleanable/blood/tracks,
/obj/effect/turf_decal/tile/yellow/half/contrasted{
	dir = 8
	},
/turf/open/floor/holofloor/white,
/area/template_noop)
"aZ" = (
/obj/effect/decal/cleanable/blood/drip,
/obj/effect/turf_decal/tile/yellow/half/contrasted{
	dir = 8
	},
/turf/open/floor/holofloor/white,
/area/template_noop)
"eI" = (
/obj/structure/window/reinforced/spawner/directional/north,
/obj/effect/decal/cleanable/blood/drip,
/obj/effect/turf_decal/tile/red{
	dir = 1
	},
/turf/open/floor/holofloor/dark,
/area/template_noop)
"fF" = (
/obj/effect/decal/cleanable/dirt/dust,
/obj/effect/turf_decal/tile/yellow/half/contrasted{
	dir = 4
	},
/turf/open/floor/holofloor/white,
/area/template_noop)
"om" = (
/obj/structure/curtain,
/obj/effect/turf_decal/tile/blue/half/contrasted{
	dir = 1
	},
/turf/open/floor/holofloor/white,
/area/template_noop)
"pV" = (
/obj/effect/turf_decal/tile/yellow/half/contrasted{
	dir = 4
	},
/turf/open/floor/holofloor/white,
/area/template_noop)
"ul" = (
/obj/structure/window/reinforced/spawner/directional/east,
/obj/effect/decal/cleanable/blood/drip,
/obj/effect/turf_decal/tile/red,
/turf/open/floor/holofloor/dark,
/area/template_noop)
"wV" = (
/obj/structure/window/reinforced/spawner/directional/west,
/obj/structure/window/reinforced/spawner/directional/south,
/obj/effect/decal/cleanable/blood,
/obj/effect/turf_decal/tile/red/opposingcorners,
/turf/open/floor/holofloor/dark,
/area/template_noop)
"zS" = (
/obj/structure/window/reinforced/spawner/directional/north,
/obj/structure/window/reinforced/spawner/directional/east,
/obj/effect/decal/cleanable/blood,
/obj/effect/turf_decal/tile/red/opposingcorners,
/turf/open/floor/holofloor/dark,
/area/template_noop)
"Cp" = (
/obj/structure/window/spawner/directional/south,
/obj/structure/curtain,
/obj/effect/turf_decal/tile/blue/anticorner/contrasted{
	dir = 8
	},
/turf/open/floor/holofloor/white,
/area/template_noop)
"FT" = (
/obj/structure/window/reinforced/spawner/directional/west,
/obj/effect/decal/cleanable/blood/drip,
/obj/effect/turf_decal/tile/red{
	dir = 1
	},
/turf/open/floor/holofloor/dark,
/area/template_noop)
"ID" = (
/obj/structure/window/spawner/directional/south,
/obj/structure/table/optable,
/obj/effect/decal/cleanable/blood/old,
/obj/effect/turf_decal/tile/blue/half/contrasted{
	dir = 8
	},
/turf/open/floor/holofloor/white,
/area/template_noop)
"KB" = (
/obj/effect/decal/cleanable/blood/old,
/obj/effect/turf_decal/tile/blue/half/contrasted,
/turf/open/floor/holofloor/white,
/area/template_noop)
"Pd" = (
/obj/structure/window/spawner/directional/north,
/obj/structure/table,
/obj/item/clothing/suit/jacket/straight_jacket,
/obj/item/assembly/flash,
/obj/effect/turf_decal/tile/blue/anticorner/contrasted{
	dir = 4
	},
/turf/open/floor/holofloor/white,
/area/template_noop)
"Ps" = (
/obj/structure/window/spawner/directional/south,
/obj/machinery/computer/operating{
	dir = 8
	},
/obj/effect/turf_decal/tile/blue/anticorner/contrasted,
/turf/open/floor/holofloor/white,
/area/template_noop)
"Sy" = (
/obj/machinery/door/window/brigdoor,
/obj/effect/decal/cleanable/blood/tracks,
/obj/effect/turf_decal/tile/red,
/turf/open/floor/holofloor/dark,
/area/template_noop)
"Wv" = (
/obj/structure/window/spawner/directional/north,
/obj/structure/curtain,
/obj/effect/turf_decal/tile/blue/anticorner/contrasted{
	dir = 1
	},
/turf/open/floor/holofloor/white,
/area/template_noop)
"YF" = (
/obj/structure/window/spawner/directional/north,
/obj/structure/table,
/obj/item/bedsheet,
/obj/item/screwdriver,
/obj/item/wirecutters,
/obj/item/hatchet,
/obj/item/lighter,
/obj/item/healthanalyzer,
/obj/effect/turf_decal/tile/blue/half/contrasted{
	dir = 4
	},
/turf/open/floor/holofloor/white,
/area/template_noop)

(1,1,1) = {"
ah
af
pV
ar
ar
ar
ak
aX
ac
aL
"}
(2,1,1) = {"
aa
ab
pV
Wv
om
Cp
ak
aX
aG
aa
"}
(3,1,1) = {"
ag
av
fF
YF
ar
ID
aO
aX
ac
aM
"}
(4,1,1) = {"
aC
ae
pV
Pd
KB
Ps
aO
aX
ad
aF
"}
(5,1,1) = {"
aa
aE
pV
am
FT
wV
ak
aZ
aV
aW
"}
(6,1,1) = {"
ag
af
fF
eI
al
Sy
aS
aY
ac
ag
"}
(7,1,1) = {"
aC
ae
fF
zS
ul
aN
aQ
aZ
aK
aF
"}
(8,1,1) = {"
aa
aE
pV
aw
az
aH
aO
aX
aG
aa
"}
(9,1,1) = {"
as
af
pV
ak
ar
ak
ak
aX
ac
ag
"}
