//MAP CONVERTED BY dmm2tgm.py THIS HEADER COMMENT PREVENTS RECONVERSION, DO NOT REMOVE
"aa" = (
/turf/template_noop,
/area/template_noop)
"ab" = (
/turf/open/floor/plating/asteroid/basalt,
/area/template_noop)
"ac" = (
/obj/machinery/light,
/turf/open/floor/plating/asteroid/basalt,
/area/survivalpod)
"ad" = (
/obj/machinery/light{
	dir = 4
	},
/turf/open/floor/plating/asteroid/basalt,
/area/survivalpod)
"ae" = (
/turf/closed/wall/mineral/titanium/survival/pod,
/area/survivalpod)
"af" = (
/obj/structure/sink,
/turf/closed/wall/mineral/titanium/survival/pod,
/area/survivalpod)
"ag" = (
/turf/closed/wall/mineral/titanium/survival,
/area/survivalpod)
"ah" = (
/obj/item/gps/computer,
/turf/open/floor/pod/dark,
/area/survivalpod)
"ai" = (
/turf/closed/wall/mineral/titanium/survival/nodiagonal,
/area/survivalpod)
"aj" = (
/obj/structure/sign/mining/survival{
	dir = 8
	},
/turf/closed/wall/mineral/titanium/survival/pod,
/area/survivalpod)
"ak" = (
/turf/open/floor/pod/light,
/area/survivalpod)
"al" = (
/obj/structure/toilet/secret,
/turf/open/floor/pod/light,
/area/survivalpod)
"am" = (
/obj/structure/fence{
	dir = 4
	},
/turf/open/floor/plating/asteroid/basalt,
/area/template_noop)
"an" = (
/obj/structure/fence/door,
/turf/open/floor/plating/asteroid/basalt,
/area/template_noop)
"ao" = (
/obj/effect/decal/cleanable/cobweb,
/obj/structure/fans,
/turf/open/floor/pod/dark,
/area/survivalpod)
"ap" = (
/turf/open/floor/pod/dark,
/area/survivalpod)
"aq" = (
/obj/machinery/smartfridge/survival_pod/preloaded,
/turf/open/floor/pod/dark,
/area/survivalpod)
"ar" = (
/obj/structure/sign/poster/official/random,
/turf/closed/wall/mineral/titanium/survival/pod,
/area/survivalpod)
"as" = (
/obj/machinery/light/small,
/turf/open/floor/pod/light,
/area/survivalpod)
"at" = (
/obj/effect/decal/cleanable/dirt/dust,
/turf/open/floor/pod/light,
/area/survivalpod)
"au" = (
/obj/machinery/door/airlock/survival_pod,
/obj/structure/fans/tiny,
/turf/open/floor/pod/light,
/area/survivalpod)
"av" = (
/obj/structure/barricade/sandbags,
/turf/open/floor/plating/asteroid/basalt,
/area/template_noop)
"aw" = (
/obj/machinery/stasis/survival_pod,
/turf/open/floor/pod/dark,
/area/survivalpod)
"ax" = (
/obj/structure/extinguisher_cabinet,
/turf/closed/wall/mineral/titanium/survival,
/area/survivalpod)
"ay" = (
/obj/structure/mirror,
/turf/closed/wall/mineral/titanium/survival/pod,
/area/survivalpod)
"az" = (
/obj/effect/turf_decal/box,
/obj/structure/safe/floor,
/turf/open/floor/pod/dark,
/area/survivalpod)
"aA" = (
/obj/effect/decal/cleanable/dirt,
/turf/open/floor/pod/dark,
/area/survivalpod)
"aB" = (
/obj/structure/rack,
/obj/item/mop,
/obj/item/reagent_containers/cup/bucket,
/obj/machinery/light/small,
/obj/item/paper/fluff/itemnotice,
/turf/open/floor/pod/dark,
/area/survivalpod)
"aC" = (
/obj/structure/fence,
/turf/open/floor/plating/asteroid/basalt,
/area/template_noop)
"aD" = (
/obj/structure/chair/stool,
/turf/open/floor/plating/asteroid/basalt,
/area/template_noop)
"aE" = (
/obj/effect/decal/cleanable/dirt,
/obj/machinery/door/airlock/survival_pod,
/obj/structure/fans/tiny,
/turf/open/floor/pod/dark,
/area/survivalpod)
"aF" = (
/obj/structure/table,
/obj/item/storage/bag/tray,
/obj/item/kitchen/fork,
/turf/open/floor/plating/asteroid/basalt,
/area/template_noop)
"aG" = (
/obj/structure/fence/door{
	dir = 4
	},
/turf/open/floor/plating/asteroid/basalt,
/area/template_noop)
"aH" = (
/obj/structure/bonfire,
/turf/open/floor/plating/asteroid/basalt,
/area/template_noop)
"aI" = (
/obj/structure/table,
/obj/item/stack/sheet/mineral/coal,
/turf/open/floor/plating/asteroid/basalt,
/area/template_noop)
"aJ" = (
/obj/structure/sign/poster/official/random,
/turf/closed/wall/mineral/titanium/survival,
/area/survivalpod)
"aK" = (
/obj/machinery/door/airlock/survival_pod/glass,
/obj/structure/fans/tiny,
/turf/open/floor/pod/light,
/area/survivalpod)
"aL" = (
/obj/structure/chair{
	dir = 4
	},
/turf/open/floor/pod/light,
/area/survivalpod)
"aM" = (
/obj/structure/table,
/obj/item/lighter/greyscale,
/obj/item/toy/cards/deck/cas,
/turf/open/floor/pod/light,
/area/survivalpod)
"aN" = (
/obj/structure/sign/mining/survival{
	dir = 4
	},
/turf/closed/wall/mineral/titanium/survival,
/area/survivalpod)
"aO" = (
/obj/structure/closet/crate,
/obj/item/mecha_parts/mecha_equipment/drill,
/turf/open/floor/pod/light,
/area/survivalpod)
"aP" = (
/obj/machinery/suit_storage_unit,
/turf/open/floor/pod/light,
/area/survivalpod)
"aQ" = (
/obj/effect/decal/cleanable/generic,
/turf/open/floor/plating/asteroid/basalt,
/area/template_noop)
"aS" = (
/obj/structure/sign/mining/survival{
	dir = 8
	},
/turf/closed/wall/mineral/titanium/survival,
/area/survivalpod)
"aT" = (
/obj/structure/closet,
/obj/item/clothing/shoes/workboots/mining,
/obj/item/clothing/gloves/fingerless,
/obj/item/reagent_containers/cup/glass/bottle/beer,
/obj/machinery/light{
	dir = 8
	},
/obj/item/pickaxe/mini,
/obj/item/clothing/under/rank/cargo/miner/lavaland,
/turf/open/floor/pod/light,
/area/survivalpod)
"aU" = (
/obj/structure/bed/pod,
/turf/open/floor/pod/light,
/area/survivalpod)
"aV" = (
/obj/structure/closet/crate/bin,
/obj/machinery/light{
	dir = 8
	},
/turf/open/floor/pod/light,
/area/survivalpod)
"aW" = (
/obj/machinery/vending/mining,
/turf/open/floor/pod/light,
/area/survivalpod)
"aX" = (
/obj/structure/closet,
/obj/item/clothing/shoes/workboots/mining,
/obj/item/clothing/gloves/fingerless,
/obj/item/reagent_containers/cup/glass/bottle/beer,
/obj/item/pickaxe/mini,
/obj/item/clothing/under/rank/cargo/miner/lavaland,
/turf/open/floor/pod/light,
/area/survivalpod)
"aY" = (
/obj/structure/ore_box,
/turf/open/floor/plating/asteroid/basalt,
/area/template_noop)
"aZ" = (
/obj/structure/sign/mining,
/turf/closed/wall/mineral/titanium/survival,
/area/survivalpod)
"ba" = (
/obj/machinery/vending/wallmed/survival_pod,
/turf/closed/wall/mineral/titanium/survival,
/area/survivalpod)
"bb" = (
/obj/structure/table,
/obj/item/healthanalyzer,
/obj/item/gps/mining,
/obj/item/paper/fluff/encampmentwelcome,
/turf/open/floor/pod/light,
/area/survivalpod)
"bc" = (
/obj/item/trash/raisins,
/turf/open/floor/plating/asteroid/basalt,
/area/template_noop)
"bd" = (
/obj/effect/decal/cleanable/dirt,
/turf/open/floor/plating/asteroid/basalt,
/area/template_noop)
"be" = (
/obj/machinery/sleeper/survival_pod,
/turf/open/floor/pod/light,
/area/survivalpod)
"bf" = (
/obj/structure/noticeboard{
	dir = 1;
	pixel_y = -32
	},
/turf/open/floor/pod/light,
/area/survivalpod)
"bg" = (
/obj/structure/table,
/obj/machinery/light{
	dir = 4
	},
/obj/structure/bedsheetbin,
/turf/open/floor/pod/light,
/area/survivalpod)
"bh" = (
/obj/structure/fence/corner,
/turf/open/floor/plating/asteroid/basalt,
/area/template_noop)
"bi" = (
/obj/item/clothing/head/costume/kitty/genuine,
/turf/open/floor/plating/asteroid/basalt,
/area/template_noop)
"bj" = (
/obj/effect/decal/cleanable/ash,
/turf/open/floor/plating/asteroid/basalt,
/area/template_noop)
"bk" = (
/obj/machinery/light{
	dir = 8
	},
/turf/open/floor/plating/asteroid/basalt,
/area/survivalpod)
"bl" = (
/obj/item/trash/sosjerky,
/turf/open/floor/plating/asteroid/basalt,
/area/template_noop)
"bm" = (
/obj/machinery/light/floor,
/turf/open/floor/plating/asteroid/basalt,
/area/survivalpod)
"bn" = (
/obj/machinery/light{
	dir = 1
	},
/turf/open/floor/plating/asteroid/basalt,
/area/survivalpod)
"bo" = (
/obj/item/rollerbed,
/obj/structure/closet/crate,
/obj/item/stack/sheet/iron/ten,
/obj/item/storage/toolbox/mechanical,
/turf/open/floor/pod/dark,
/area/survivalpod)
"bp" = (
/obj/structure/chair{
	dir = 1
	},
/turf/open/floor/pod/light,
/area/survivalpod)
"QN" = (
/obj/machinery/gear_requisition/mining,
/turf/open/floor/pod/light,
/area/survivalpod)

(1,1,1) = {"
aa
aa
ad
aa
aa
aa
ab
ab
aa
aa
aa
aa
ad
aa
aa
aa
"}
(2,1,1) = {"
aa
ae
aj
ar
ae
ab
ab
bm
ag
ag
aS
ag
ag
ag
ag
aa
"}
(3,1,1) = {"
aa
af
ak
as
ae
aC
aG
aC
ag
aO
aT
aX
ba
be
ag
aa
"}
(4,1,1) = {"
aa
ae
al
at
ay
aF
ab
ab
aK
ak
ak
ak
ak
bf
ag
aa
"}
(5,1,1) = {"
aa
ae
ae
au
ae
aI
ab
ab
ag
aP
aU
QN
bb
bg
aZ
bn
"}
(6,1,1) = {"
aa
ab
am
ab
ab
ab
aD
ab
ag
ag
ag
ag
ag
ag
ag
ab
"}
(7,1,1) = {"
ab
ab
an
ab
ab
aD
aH
ab
ab
ab
ab
aY
aY
am
ab
ab
"}
(8,1,1) = {"
ab
ab
am
av
av
ab
ab
ab
ab
ab
ab
ab
ab
an
ab
ab
"}
(9,1,1) = {"
aa
ag
ag
ag
ag
ag
ab
ab
ab
aQ
ab
ab
av
am
ab
ab
"}
(10,1,1) = {"
ac
ag
ao
aw
bo
ag
ab
ag
ag
aK
ag
ag
av
am
ab
ab
"}
(11,1,1) = {"
aa
ai
ah
ap
aA
aE
ab
aJ
aL
ak
aV
ag
aC
bh
ab
ab
"}
(12,1,1) = {"
aa
ai
aq
az
aB
ag
aC
ag
aM
bp
aW
ag
bc
bd
bj
ab
"}
(13,1,1) = {"
aa
ag
ag
ax
ag
ag
ab
ag
aN
ag
ag
aZ
bd
ab
ab
ab
"}
(14,1,1) = {"
aa
aa
aa
aa
bk
aa
aa
aa
aa
aa
aa
aa
aa
bi
bd
bl
"}
