//MAP CONVERTED BY dmm2tgm.py THIS HEADER COMMENT PREVENTS RECONVERSION, DO NOT REMOVE
"a" = (
/turf/closed/wall/mineral/titanium/survival/pod,
/area/survivalpod)
"b" = (
/obj/structure/sign/mining/survival{
	dir = 2
	},
/turf/closed/wall/mineral/titanium/survival/pod,
/area/survivalpod)
"c" = (
/turf/closed/wall/mineral/titanium/survival/nodiagonal,
/area/survivalpod)
"d" = (
/obj/structure/sign/mining/survival{
	dir = 2
	},
/turf/closed/wall/mineral/titanium/survival/nodiagonal,
/area/survivalpod)
"e" = (
/obj/structure/sign/mining/survival{
	dir = 8
	},
/turf/closed/wall/mineral/titanium/survival/nodiagonal,
/area/survivalpod)
"f" = (
/obj/structure/table/wood/fancy/black{
	dir = 1
	},
/obj/machinery/chem_dispenser/drinks{
	dir = 1
	},
/turf/open/floor/pod/dark,
/area/survivalpod)
"g" = (
/obj/structure/table/wood/fancy/black{
	dir = 1
	},
/obj/machinery/chem_dispenser/drinks/beer{
	dir = 1
	},
/obj/machinery/light{
	dir = 2
	},
/turf/open/floor/pod/dark,
/area/survivalpod)
"h" = (
/obj/machinery/vending/boozeomat{
	dir = 1
	},
/turf/open/floor/pod/dark,
/area/survivalpod)
"i" = (
/obj/item/book/manual/wiki/barman_recipes{
	dir = 1
	},
/obj/item/reagent_containers/food/drinks/shaker{
	dir = 1
	},
/obj/item/reagent_containers/glass/rag{
	dir = 1
	},
/obj/structure/table/wood/fancy/black{
	dir = 1
	},
/turf/open/floor/pod/dark,
/area/survivalpod)
"j" = (
/obj/structure/table/wood/fancy/black{
	dir = 1
	},
/obj/item/clipboard{
	dir = 1
	},
/obj/item/toy/figure/bartender{
	dir = 1
	},
/turf/open/floor/pod/dark,
/area/survivalpod)
"k" = (
/obj/structure/table/wood/fancy/black{
	dir = 1
	},
/obj/item/storage/fancy/cigarettes/cigars{
	dir = 1
	},
/obj/item/storage/fancy/cigarettes/cigars/cohiba{
	pixel_y = -4;
	dir = 1
	},
/obj/item/storage/fancy/cigarettes/cigars/havana{
	pixel_y = -8;
	dir = 1
	},
/turf/open/floor/pod/dark,
/area/survivalpod)
"l" = (
/obj/structure/table/wood/fancy/black{
	dir = 1
	},
/obj/structure/reagent_dispensers/beerkeg{
	dir = 1
	},
/turf/open/floor/pod/dark,
/area/survivalpod)
"m" = (
/obj/structure/closet/secure_closet/bar{
	dir = 1
	},
/obj/machinery/light{
	dir = 2
	},
/turf/open/floor/pod/dark,
/area/survivalpod)
"n" = (
/obj/structure/disposalpipe/trunk{
	dir = 4
	},
/obj/machinery/disposal/bin{
	dir = 1
	},
/turf/open/floor/pod/dark,
/area/survivalpod)
"o" = (
/obj/structure/sign/mining/survival{
	dir = 4
	},
/obj/structure/disposalpipe/junction/flip{
	dir = 4
	},
/turf/closed/wall/mineral/titanium/survival/pod,
/area/survivalpod)
"p" = (
/obj/machinery/door/airlock/survival_pod/glass{
	req_access_txt = "25";
	dir = 1
	},
/obj/structure/fans/tiny{
	dir = 1
	},
/turf/open/floor/pod/dark,
/area/survivalpod)
"q" = (
/turf/open/floor/pod/dark,
/area/survivalpod)
"r" = (
/obj/structure/disposalpipe/segment{
	dir = 1
	},
/turf/closed/wall/mineral/titanium/survival/nodiagonal,
/area/survivalpod)
"s" = (
/obj/structure/table/reinforced{
	dir = 1
	},
/obj/item/lighter{
	pixel_x = -4;
	pixel_y = -4;
	dir = 1
	},
/obj/item/lighter{
	dir = 1
	},
/turf/open/floor/pod/dark,
/area/survivalpod)
"t" = (
/obj/structure/table/reinforced{
	dir = 1
	},
/turf/open/floor/pod/dark,
/area/survivalpod)
"u" = (
/obj/structure/table/reinforced{
	dir = 1
	},
/obj/item/storage/box/matches{
	pixel_x = -4;
	pixel_y = -8;
	dir = 1
	},
/turf/open/floor/pod/dark,
/area/survivalpod)
"v" = (
/obj/machinery/door/window/survival_pod{
	req_access_txt = "25";
	dir = 1
	},
/turf/open/floor/pod/dark,
/area/survivalpod)
"w" = (
/obj/structure/sign/mining/survival{
	dir = 4
	},
/obj/structure/disposalpipe/segment{
	dir = 1
	},
/turf/closed/wall/mineral/titanium/survival/nodiagonal,
/area/survivalpod)
"x" = (
/obj/structure/chair/stool/bar{
	dir = 1
	},
/turf/open/floor/carpet/black,
/area/survivalpod)
"y" = (
/turf/open/floor/carpet/black,
/area/survivalpod)
"z" = (
/obj/machinery/vending/cigarette/beach{
	dir = 1
	},
/turf/open/floor/carpet/black,
/area/survivalpod)
"A" = (
/obj/structure/disposalpipe/trunk{
	dir = 4
	},
/obj/machinery/disposal/bin{
	dir = 1
	},
/turf/open/floor/carpet/black,
/area/survivalpod)
"B" = (
/obj/structure/sign/mining/survival{
	dir = 4
	},
/obj/structure/disposalpipe/segment{
	dir = 10
	},
/turf/closed/wall/mineral/titanium/survival/nodiagonal,
/area/survivalpod)
"C" = (
/obj/structure/window/reinforced/survival_pod{
	dir = 8
	},
/obj/structure/window/reinforced/survival_pod{
	dir = 4
	},
/obj/structure/window/reinforced/survival_pod{
	dir = 2
	},
/obj/structure/window/reinforced/survival_pod{
	dir = 1
	},
/obj/structure/grille{
	dir = 1
	},
/turf/open/floor/pod/dark,
/area/survivalpod)
"D" = (
/obj/structure/chair/comfy/black{
	dir = 1
	},
/turf/open/floor/carpet/black,
/area/survivalpod)
"E" = (
/obj/machinery/door/airlock/survival_pod{
	dir = 1
	},
/turf/open/floor/pod/light,
/area/survivalpod)
"F" = (
/obj/structure/table/wood/fancy{
	dir = 1
	},
/obj/item/reagent_containers/food/condiment/peppermill{
	pixel_x = -4;
	pixel_y = -12;
	dir = 1
	},
/obj/item/reagent_containers/food/condiment/saltshaker{
	pixel_x = 4;
	pixel_y = -4;
	dir = 1
	},
/turf/open/floor/carpet/black,
/area/survivalpod)
"G" = (
/obj/structure/urinal{
	pixel_y = -24;
	dir = 1
	},
/turf/open/floor/pod/light,
/area/survivalpod)
"H" = (
/turf/open/floor/pod/light,
/area/survivalpod)
"I" = (
/obj/structure/sink{
	dir = 4;
	pixel_x = 11
	},
/obj/machinery/light/small{
	dir = 4
	},
/turf/open/floor/pod/light,
/area/survivalpod)
"J" = (
/obj/structure/sign/mining/survival{
	dir = 4
	},
/turf/closed/wall/mineral/titanium/survival/nodiagonal,
/area/survivalpod)
"K" = (
/obj/structure/chair/comfy/black{
	dir = 2
	},
/turf/open/floor/carpet/black,
/area/survivalpod)
"L" = (
/obj/machinery/vending/snack/random{
	dir = 1
	},
/turf/open/floor/carpet/black,
/area/survivalpod)
"M" = (
/obj/machinery/light{
	dir = 1
	},
/turf/open/floor/carpet/black,
/area/survivalpod)
"N" = (
/obj/structure/toilet{
	dir = 8
	},
/obj/machinery/light/small{
	dir = 4
	},
/turf/open/floor/pod/light,
/area/survivalpod)
"O" = (
/obj/structure/sign/mining/survival{
	dir = 4
	},
/turf/closed/wall/mineral/titanium/survival/pod,
/area/survivalpod)
"P" = (
/obj/structure/sign/mining/survival{
	dir = 1
	},
/turf/closed/wall/mineral/titanium/survival/pod,
/area/survivalpod)
"Q" = (
/obj/structure/sign/mining/survival{
	dir = 1
	},
/turf/closed/wall/mineral/titanium/survival/nodiagonal,
/area/survivalpod)
"R" = (
/obj/machinery/door/airlock/survival_pod/glass{
	dir = 1
	},
/obj/structure/fans/tiny{
	dir = 1
	},
/turf/open/floor/carpet/black,
/area/survivalpod)

(1,1,1) = {"
a
e
C
e
C
e
c
e
p
e
a"}(2,1,1) = {"
P
L
K
F
D
y
x
s
q
f
b"}(3,1,1) = {"
c
M
y
y
y
y
x
t
q
g
c"}(4,1,1) = {"
Q
y
K
F
D
y
x
t
q
h
d"}(5,1,1) = {"
c
y
K
F
D
y
x
u
q
i
c"}(6,1,1) = {"
R
y
y
y
y
y
x
t
q
j
d"}(7,1,1) = {"
c
c
c
c
c
y
x
t
q
k
c"}(8,1,1) = {"
Q
H
H
G
c
y
x
t
q
l
d"}(9,1,1) = {"
c
E
c
H
E
y
y
v
q
m
c"}(10,1,1) = {"
P
N
c
I
c
A
z
t
q
n
b"}(11,1,1) = {"
a
O
c
J
c
B
r
w
r
o
a"}