//MAP CONVERTED BY dmm2tgm.py THIS HEADER COMMENT PREVENTS RECONVERSION, DO NOT REMOVE
"aa" = (
/turf/template_noop,
/area/template_noop)
"ab" = (
/turf/open/floor/plating/asteroid/basalt,
/area/template_noop)
"ac" = (
/obj/machinery/light{
	dir = 1
	},
/turf/open/floor/plating/asteroid/basalt,
/area/survivalpod)
"ad" = (
/obj/machinery/light{
	dir = 4
	},
/turf/open/floor/plating/asteroid/basalt,
/area/survivalpod)
"ae" = (
/turf/closed/wall/mineral/titanium/survival/pod,
/area/survivalpod)
"af" = (
/obj/structure/sink{
	dir = 1
	},
/turf/closed/wall/mineral/titanium/survival/pod,
/area/survivalpod)
"ag" = (
/turf/closed/wall/mineral/titanium/survival,
/area/survivalpod)
"ah" = (
/obj/item/gps/computer{
	dir = 1
	},
/turf/closed/wall/mineral/titanium/survival/nodiagonal,
/area/survivalpod)
"ai" = (
/turf/closed/wall/mineral/titanium/survival/nodiagonal,
/area/survivalpod)
"aj" = (
/obj/structure/sign/mining/survival{
	dir = 8
	},
/turf/closed/wall/mineral/titanium/survival/pod,
/area/survivalpod)
"ak" = (
/turf/open/floor/pod/light,
/area/survivalpod)
"al" = (
/obj/structure/toilet/secret{
	dir = 1
	},
/turf/open/floor/pod/light,
/area/survivalpod)
"am" = (
/obj/structure/fence{
	dir = 4
	},
/turf/open/floor/plating/asteroid/basalt,
/area/template_noop)
"an" = (
/obj/structure/fence/door{
	dir = 1
	},
/turf/open/floor/plating/asteroid/basalt,
/area/template_noop)
"ao" = (
/obj/structure/closet/crate{
	dir = 1
	},
/obj/effect/decal/cleanable/cobweb{
	dir = 4
	},
/obj/item/mecha_parts/mecha_equipment/drill{
	dir = 1
	},
/turf/open/floor/pod/dark,
/area/survivalpod)
"ap" = (
/turf/open/floor/pod/dark,
/area/survivalpod)
"aq" = (
/obj/machinery/vendor/mining{
	dir = 1
	},
/turf/open/floor/pod/dark,
/area/survivalpod)
"ar" = (
/obj/structure/sign/poster/official/random{
	dir = 1
	},
/turf/closed/wall/mineral/titanium/survival/pod,
/area/survivalpod)
"as" = (
/obj/machinery/light/small{
	dir = 1
	},
/turf/open/floor/pod/light,
/area/survivalpod)
"at" = (
/obj/effect/decal/cleanable/dirt/dust{
	dir = 4
	},
/turf/open/floor/pod/light,
/area/survivalpod)
"au" = (
/obj/machinery/door/airlock/survival_pod{
	dir = 1
	},
/obj/structure/fans/tiny{
	dir = 1
	},
/turf/open/floor/pod/light,
/area/survivalpod)
"av" = (
/obj/structure/barricade/sandbags{
	dir = 1
	},
/turf/open/floor/plating/asteroid/basalt,
/area/template_noop)
"aw" = (
/obj/structure/closet/crate{
	dir = 1
	},
/obj/item/storage/toolbox/mechanical{
	dir = 1
	},
/obj/item/stack/sheet/iron/ten{
	dir = 1
	},
/turf/open/floor/pod/dark,
/area/survivalpod)
"ax" = (
/obj/structure/extinguisher_cabinet{
	dir = 1
	},
/turf/closed/wall/mineral/titanium/survival,
/area/survivalpod)
"ay" = (
/obj/structure/mirror{
	dir = 1
	},
/turf/closed/wall/mineral/titanium/survival/pod,
/area/survivalpod)
"az" = (
/obj/effect/turf_decal/box{
	dir = 4
	},
/obj/structure/safe/floor{
	dir = 1
	},
/turf/open/floor/pod/dark,
/area/survivalpod)
"aA" = (
/obj/effect/decal/cleanable/dirt{
	dir = 4
	},
/turf/open/floor/pod/dark,
/area/survivalpod)
"aB" = (
/obj/structure/rack{
	dir = 1
	},
/obj/item/mop{
	dir = 1
	},
/obj/item/reagent_containers/glass/bucket{
	dir = 1
	},
/obj/machinery/light/small{
	dir = 1
	},
/obj/item/paper/fluff/itemnotice{
	dir = 1
	},
/turf/open/floor/pod/dark,
/area/survivalpod)
"aC" = (
/obj/structure/fence{
	dir = 1
	},
/turf/open/floor/plating/asteroid/basalt,
/area/template_noop)
"aD" = (
/obj/structure/chair/stool{
	dir = 1
	},
/turf/open/floor/plating/asteroid/basalt,
/area/template_noop)
"aE" = (
/obj/effect/decal/cleanable/dirt{
	dir = 4
	},
/obj/machinery/door/airlock/survival_pod{
	dir = 1
	},
/obj/structure/fans/tiny{
	dir = 1
	},
/turf/open/floor/pod/dark,
/area/survivalpod)
"aF" = (
/obj/structure/table{
	dir = 1
	},
/obj/item/storage/bag/tray{
	dir = 1
	},
/obj/item/kitchen/fork{
	dir = 1
	},
/turf/open/floor/plating/asteroid/basalt,
/area/template_noop)
"aG" = (
/obj/structure/fence/door{
	dir = 4
	},
/turf/open/floor/plating/asteroid/basalt,
/area/template_noop)
"aH" = (
/obj/structure/bonfire{
	dir = 1
	},
/turf/open/floor/plating/asteroid/basalt,
/area/template_noop)
"aI" = (
/obj/structure/table{
	dir = 1
	},
/obj/item/trash/coal{
	dir = 1
	},
/turf/open/floor/plating/asteroid/basalt,
/area/template_noop)
"aJ" = (
/obj/structure/sign/poster/official/random{
	dir = 1
	},
/turf/closed/wall/mineral/titanium/survival,
/area/survivalpod)
"aK" = (
/obj/machinery/door/airlock/survival_pod/glass{
	dir = 1
	},
/obj/structure/fans/tiny{
	dir = 1
	},
/turf/open/floor/pod/light,
/area/survivalpod)
"aL" = (
/obj/structure/chair{
	dir = 4
	},
/turf/open/floor/pod/light,
/area/survivalpod)
"aM" = (
/obj/structure/table{
	dir = 1
	},
/obj/item/lighter/greyscale{
	dir = 1
	},
/obj/item/toy/cards/deck/cas{
	dir = 1
	},
/turf/open/floor/pod/light,
/area/survivalpod)
"aN" = (
/obj/structure/sign/mining/survival{
	dir = 4
	},
/turf/closed/wall/mineral/titanium/survival,
/area/survivalpod)
"aO" = (
/obj/structure/fans{
	dir = 1
	},
/turf/open/floor/pod/light,
/area/survivalpod)
"aP" = (
/obj/machinery/suit_storage_unit{
	dir = 1
	},
/turf/open/floor/pod/light,
/area/survivalpod)
"aQ" = (
/obj/effect/decal/cleanable/generic{
	dir = 4
	},
/turf/open/floor/plating/asteroid/basalt,
/area/template_noop)
"aS" = (
/obj/structure/sign/mining/survival{
	dir = 8
	},
/turf/closed/wall/mineral/titanium/survival,
/area/survivalpod)
"aT" = (
/obj/structure/closet{
	dir = 1
	},
/obj/item/clothing/shoes/workboots/mining{
	dir = 1
	},
/obj/item/clothing/gloves/fingerless{
	dir = 1
	},
/obj/item/reagent_containers/food/drinks/beer{
	dir = 1
	},
/obj/machinery/light{
	dir = 8
	},
/obj/item/pickaxe/mini{
	dir = 1
	},
/obj/item/clothing/under/rank/cargo/miner/lavaland{
	dir = 1
	},
/turf/open/floor/pod/light,
/area/survivalpod)
"aU" = (
/obj/structure/bed/pod{
	dir = 1
	},
/turf/open/floor/pod/light,
/area/survivalpod)
"aV" = (
/obj/structure/closet/crate/bin{
	dir = 1
	},
/obj/machinery/light{
	dir = 8
	},
/turf/open/floor/pod/light,
/area/survivalpod)
"aW" = (
/obj/machinery/vending/mining{
	dir = 1
	},
/turf/open/floor/pod/light,
/area/survivalpod)
"aX" = (
/obj/structure/closet{
	dir = 1
	},
/obj/item/clothing/shoes/workboots/mining{
	dir = 1
	},
/obj/item/clothing/gloves/fingerless{
	dir = 1
	},
/obj/item/reagent_containers/food/drinks/beer{
	dir = 1
	},
/obj/item/pickaxe/mini{
	dir = 1
	},
/obj/item/clothing/under/rank/cargo/miner/lavaland{
	dir = 1
	},
/turf/open/floor/pod/light,
/area/survivalpod)
"aY" = (
/obj/structure/ore_box{
	dir = 1
	},
/turf/open/floor/plating/asteroid/basalt,
/area/template_noop)
"aZ" = (
/obj/structure/sign/mining{
	dir = 1
	},
/turf/closed/wall/mineral/titanium/survival,
/area/survivalpod)
"ba" = (
/obj/machinery/vending/wallmed/survival_pod{
	dir = 1
	},
/turf/closed/wall/mineral/titanium/survival,
/area/survivalpod)
"bb" = (
/obj/structure/table{
	dir = 1
	},
/obj/item/healthanalyzer{
	dir = 1
	},
/obj/item/gps/mining{
	dir = 1
	},
/obj/item/paper/fluff/encampmentwelcome{
	dir = 1
	},
/turf/open/floor/pod/light,
/area/survivalpod)
"bc" = (
/obj/item/trash/raisins{
	dir = 1
	},
/turf/open/floor/plating/asteroid/basalt,
/area/template_noop)
"bd" = (
/obj/effect/decal/cleanable/dirt{
	dir = 4
	},
/turf/open/floor/plating/asteroid/basalt,
/area/template_noop)
"be" = (
/obj/machinery/sleeper/survival_pod{
	dir = 1
	},
/turf/open/floor/pod/light,
/area/survivalpod)
"bf" = (
/obj/structure/noticeboard{
	dir = 2;
	pixel_y = 32
	},
/turf/open/floor/pod/light,
/area/survivalpod)
"bg" = (
/obj/structure/table{
	dir = 1
	},
/obj/machinery/light{
	dir = 4
	},
/obj/structure/bedsheetbin{
	dir = 1
	},
/turf/open/floor/pod/light,
/area/survivalpod)
"bh" = (
/obj/structure/fence/corner{
	dir = 1
	},
/turf/open/floor/plating/asteroid/basalt,
/area/template_noop)
"bi" = (
/obj/item/clothing/head/kitty/genuine{
	dir = 1
	},
/turf/open/floor/plating/asteroid/basalt,
/area/template_noop)
"bj" = (
/obj/effect/decal/cleanable/ash{
	dir = 4
	},
/turf/open/floor/plating/asteroid/basalt,
/area/template_noop)
"bk" = (
/obj/machinery/light{
	dir = 8
	},
/turf/open/floor/plating/asteroid/basalt,
/area/survivalpod)
"bl" = (
/obj/item/trash/sosjerky{
	dir = 1
	},
/turf/open/floor/plating/asteroid/basalt,
/area/template_noop)
"bm" = (
/obj/machinery/light/floor{
	dir = 1
	},
/turf/open/floor/plating/asteroid/basalt,
/area/survivalpod)
"bn" = (
/obj/machinery/light{
	dir = 2
	},
/turf/open/floor/plating/asteroid/basalt,
/area/survivalpod)
"bo" = (
/obj/item/roller{
	dir = 1
	},
/turf/open/floor/pod/dark,
/area/survivalpod)
"bp" = (
/obj/structure/chair{
	dir = 2
	},
/turf/open/floor/pod/light,
/area/survivalpod)

(1,1,1) = {"
aa
aa
aa
ad
aa
aa
aa
aa
ab
ab
aa
aa
aa
ad
aa
aa"}(2,1,1) = {"
aa
ag
ag
ag
ag
aS
ag
ag
bm
ab
ab
ae
ar
aj
ae
aa"}(3,1,1) = {"
aa
ag
be
ba
aX
aT
aO
ag
aC
aG
aC
ae
as
ak
af
aa"}(4,1,1) = {"
aa
ag
bf
ak
ak
ak
ak
aK
ab
ab
aF
ay
at
al
ae
aa"}(5,1,1) = {"
bn
aZ
bg
bb
aU
aU
aP
ag
ab
ab
aI
ae
au
ae
ae
aa"}(6,1,1) = {"
ab
ag
ag
ag
ag
ag
ag
ag
ab
aD
ab
ab
ab
am
ab
aa"}(7,1,1) = {"
ab
ab
am
aY
aY
ab
ab
ab
ab
aH
aD
ab
ab
an
ab
ab"}(8,1,1) = {"
ab
ab
an
ab
ab
ab
ab
ab
ab
ab
ab
av
av
am
ab
ab"}(9,1,1) = {"
ab
ab
am
av
ab
ab
aQ
ab
ab
ab
ag
ag
ag
ag
ag
aa"}(10,1,1) = {"
ab
ab
am
av
ag
ag
aK
ag
ag
ab
ag
bo
aw
ao
ag
ac"}(11,1,1) = {"
ab
ab
bh
aC
ag
aV
ak
aL
aJ
ab
aE
aA
ap
ap
ah
aa"}(12,1,1) = {"
ab
bj
bd
bc
ag
aW
bp
aM
ag
aC
ag
aB
az
aq
ai
aa"}(13,1,1) = {"
ab
ab
ab
bd
aZ
ag
ag
aN
ag
ab
ag
ag
ax
ag
ag
aa"}(14,1,1) = {"
bl
bd
bi
aa
aa
aa
aa
aa
aa
aa
aa
bk
aa
aa
aa
aa"}