//MAP CONVERTED BY dmm2tgm.py THIS HEADER COMMENT PREVENTS RECONVERSION, DO NOT REMOVE
"a" = (
/turf/closed/wall/mineral/titanium/survival/pod,
/area/survivalpod)
"b" = (
/obj/structure/sign/mining/survival{
	dir = 2
	},
/turf/closed/wall/mineral/titanium/survival/pod,
/area/survivalpod)
"c" = (
/obj/structure/fans{
	dir = 1
	},
/turf/open/floor/pod,
/area/survivalpod)
"d" = (
/obj/machinery/smartfridge/survival_pod{
	dir = 1
	},
/turf/open/floor/pod,
/area/survivalpod)
"e" = (
/obj/item/gps/computer{
	dir = 1
	},
/turf/open/floor/pod,
/area/survivalpod)
"f" = (
/obj/structure/sign/mining/survival{
	dir = 8
	},
/turf/closed/wall/mineral/titanium/survival/pod,
/area/survivalpod)
"g" = (
/obj/machinery/stasis/survival_pod{
	dir = 1
	},
/obj/machinery/vending/wallmed/survival_pod{
	pixel_x = -24;
	dir = 1
	},
/turf/open/floor/pod,
/area/survivalpod)
"h" = (
/turf/open/floor/pod,
/area/survivalpod)
"i" = (
/obj/structure/bed/pod{
	dir = 1
	},
/obj/item/bedsheet/black{
	dir = 1
	},
/turf/open/floor/pod,
/area/survivalpod)
"j" = (
/obj/structure/sign/mining/survival{
	dir = 4
	},
/turf/closed/wall/mineral/titanium/survival/pod,
/area/survivalpod)
"k" = (
/obj/structure/table/survival_pod{
	dir = 1
	},
/turf/open/floor/pod,
/area/survivalpod)
"l" = (
/obj/structure/tubes{
	dir = 1
	},
/obj/structure/chair/comfy/black{
	dir = 8
	},
/turf/open/floor/pod,
/area/survivalpod)
"m" = (
/obj/structure/sign/mining/survival{
	dir = 1
	},
/turf/closed/wall/mineral/titanium/survival/pod,
/area/survivalpod)
"n" = (
/obj/structure/fans/tiny{
	dir = 1
	},
/obj/machinery/door/airlock/survival_pod/glass{
	dir = 1
	},
/turf/open/floor/pod,
/area/survivalpod)
"o" = (
/obj/structure/sign/mining{
	dir = 1
	},
/turf/closed/wall/mineral/titanium/survival/pod,
/area/survivalpod)

(1,1,1) = {"
a
a
f
a
a"}(2,1,1) = {"
m
k
g
c
a"}(3,1,1) = {"
n
h
h
d
b"}(4,1,1) = {"
o
l
i
e
a"}(5,1,1) = {"
a
a
j
a
a"}