//MAP CONVERTED BY dmm2tgm.py THIS HEADER COMMENT PREVENTS RECONVERSION, DO NOT REMOVE
"aa" = (
/turf/closed/wall/mineral/titanium/survival/pod,
/area/survivalpod)
"ab" = (
/obj/structure/sign/mining/survival{
	dir = 1
	},
/turf/closed/wall/mineral/titanium/survival/pod,
/area/survivalpod)
"ac" = (
/turf/closed/wall/mineral/titanium/survival/nodiagonal,
/area/survivalpod)
"ad" = (
/obj/structure/sign/mining/survival{
	dir = 1
	},
/turf/closed/wall/mineral/titanium/survival/nodiagonal,
/area/survivalpod)
"ae" = (
/obj/structure/sign/mining/survival{
	dir = 8
	},
/turf/closed/wall/mineral/titanium/survival/nodiagonal,
/area/survivalpod)
"af" = (
/obj/structure/table/wood/fancy/black,
/obj/machinery/chem_dispenser/drinks,
/turf/open/floor/pod/dark,
/area/survivalpod)
"ag" = (
/obj/structure/table/wood/fancy/black,
/obj/machinery/chem_dispenser/drinks/beer,
/obj/machinery/light{
	dir = 1
	},
/turf/open/floor/pod/dark,
/area/survivalpod)
"ah" = (
/obj/machinery/vending/boozeomat,
/turf/open/floor/pod/dark,
/area/survivalpod)
"ai" = (
/obj/item/book/manual/wiki/barman_recipes,
/obj/item/reagent_containers/food/drinks/shaker,
/obj/item/reagent_containers/glass/rag,
/obj/structure/table/wood/fancy/black,
/turf/open/floor/pod/dark,
/area/survivalpod)
"aj" = (
/obj/structure/table/wood/fancy/black,
/obj/item/clipboard,
/obj/item/toy/figure/bartender,
/turf/open/floor/pod/dark,
/area/survivalpod)
"ak" = (
/obj/structure/table/wood/fancy/black,
/obj/item/storage/fancy/cigarettes/cigars,
/obj/item/storage/fancy/cigarettes/cigars/cohiba{
	pixel_y = 4
	},
/obj/item/storage/fancy/cigarettes/cigars/havana{
	pixel_y = 8
	},
/turf/open/floor/pod/dark,
/area/survivalpod)
"al" = (
/obj/structure/table/wood/fancy/black,
/obj/structure/reagent_dispensers/beerkeg,
/turf/open/floor/pod/dark,
/area/survivalpod)
"am" = (
/obj/structure/closet/secure_closet/bar,
/obj/machinery/light{
	dir = 1
	},
/turf/open/floor/pod/dark,
/area/survivalpod)
"an" = (
/obj/structure/disposalpipe/trunk{
	dir = 4
	},
/obj/machinery/disposal/bin,
/turf/open/floor/pod/dark,
/area/survivalpod)
"ao" = (
/obj/structure/sign/mining/survival{
	dir = 4
	},
/obj/structure/disposalpipe/junction{
	dir = 4
	},
/turf/closed/wall/mineral/titanium/survival/pod,
/area/survivalpod)
"ap" = (
/obj/machinery/door/airlock/survival_pod/glass{
	req_access_txt = "25"
	},
/obj/structure/fans/tiny,
/turf/open/floor/pod/dark,
/area/survivalpod)
"aq" = (
/turf/open/floor/pod/dark,
/area/survivalpod)
"ar" = (
/obj/structure/disposalpipe/segment,
/turf/closed/wall/mineral/titanium/survival/nodiagonal,
/area/survivalpod)
"as" = (
/obj/structure/table/reinforced,
/obj/item/lighter{
	pixel_x = -4;
	pixel_y = 4
	},
/obj/item/lighter,
/turf/open/floor/pod/dark,
/area/survivalpod)
"at" = (
/obj/structure/table/reinforced,
/turf/open/floor/pod/dark,
/area/survivalpod)
"au" = (
/obj/structure/table/reinforced,
/obj/item/storage/box/matches{
	pixel_x = -4;
	pixel_y = 8
	},
/turf/open/floor/pod/dark,
/area/survivalpod)
"av" = (
/obj/machinery/door/window/survival_pod{
	req_access_txt = "25"
	},
/turf/open/floor/pod/dark,
/area/survivalpod)
"aw" = (
/obj/structure/sign/mining/survival{
	dir = 4
	},
/obj/structure/disposalpipe/segment,
/turf/closed/wall/mineral/titanium/survival/nodiagonal,
/area/survivalpod)
"ax" = (
/obj/structure/chair/stool/bar,
/turf/open/floor/carpet/black,
/area/survivalpod)
"ay" = (
/turf/open/floor/carpet/black,
/area/survivalpod)
"az" = (
/obj/machinery/vending/cigarette/beach,
/turf/open/floor/carpet/black,
/area/survivalpod)
"aA" = (
/obj/structure/disposalpipe/trunk{
	dir = 4
	},
/obj/machinery/disposal/bin,
/turf/open/floor/carpet/black,
/area/survivalpod)
"aB" = (
/obj/structure/sign/mining/survival{
	dir = 4
	},
/obj/structure/disposalpipe/segment{
	dir = 9
	},
/turf/closed/wall/mineral/titanium/survival/nodiagonal,
/area/survivalpod)
"aC" = (
/obj/structure/window/reinforced/survival_pod{
	dir = 8
	},
/obj/structure/window/reinforced/survival_pod{
	dir = 4
	},
/obj/structure/window/reinforced/survival_pod{
	dir = 1
	},
/obj/structure/window/reinforced/survival_pod,
/obj/structure/grille,
/turf/open/floor/pod/dark,
/area/survivalpod)
"aD" = (
/obj/structure/chair/fancy/comfy{
	color = "#666666"
	},
/turf/open/floor/carpet/black,
/area/survivalpod)
"aE" = (
/obj/machinery/door/airlock/survival_pod,
/turf/open/floor/pod/light,
/area/survivalpod)
"aF" = (
/obj/structure/table/wood/fancy,
/obj/item/reagent_containers/food/condiment/peppermill{
	pixel_x = -4;
	pixel_y = 12
	},
/obj/item/reagent_containers/food/condiment/saltshaker{
	pixel_x = 4;
	pixel_y = 4
	},
/turf/open/floor/carpet/black,
/area/survivalpod)
"aG" = (
/obj/structure/urinal{
	pixel_y = 24
	},
/turf/open/floor/pod/light,
/area/survivalpod)
"aH" = (
/turf/open/floor/pod/light,
/area/survivalpod)
"aI" = (
/obj/structure/sink{
	dir = 4;
	pixel_x = 11
	},
/obj/machinery/light/small{
	dir = 4
	},
/turf/open/floor/pod/light,
/area/survivalpod)
"aJ" = (
/obj/structure/sign/mining/survival{
	dir = 4
	},
/turf/closed/wall/mineral/titanium/survival/nodiagonal,
/area/survivalpod)
"aK" = (
/obj/structure/chair/fancy/comfy{
	color = "#666666";
	dir = 1
	},
/turf/open/floor/carpet/black,
/area/survivalpod)
"aL" = (
/obj/effect/spawner/randomvend/snack,
/turf/open/floor/carpet/black,
/area/survivalpod)
"aM" = (
/obj/machinery/light,
/turf/open/floor/carpet/black,
/area/survivalpod)
"aN" = (
/obj/structure/toilet{
	dir = 8
	},
/obj/machinery/light/small{
	dir = 4
	},
/turf/open/floor/pod/light,
/area/survivalpod)
"aO" = (
/obj/structure/sign/mining/survival{
	dir = 4
	},
/turf/closed/wall/mineral/titanium/survival/pod,
/area/survivalpod)
"aP" = (
/obj/structure/sign/mining/survival,
/turf/closed/wall/mineral/titanium/survival/pod,
/area/survivalpod)
"aQ" = (
/obj/structure/sign/mining/survival,
/turf/closed/wall/mineral/titanium/survival/nodiagonal,
/area/survivalpod)
"aR" = (
/obj/machinery/door/airlock/survival_pod/glass,
/obj/structure/fans/tiny,
/turf/open/floor/carpet/black,
/area/survivalpod)
"aS" = (
/turf/closed/wall/mineral/plastic/pod,
/area/survivalpod)
"aT" = (
/obj/structure/sign/mining/survival{
	dir = 8
	},
/turf/closed/wall/mineral/plastic/nodiagonal,
/area/survivalpod)
"aU" = (
/turf/closed/wall/mineral/plastic/nodiagonal,
/area/survivalpod)
"aV" = (
/obj/structure/sign/mining/survival{
	dir = 4
	},
/turf/closed/wall/mineral/plastic/nodiagonal,
/area/survivalpod)
"aW" = (
/obj/structure/sign/mining/survival,
/turf/closed/wall/mineral/plastic/nodiagonal,
/area/survivalpod)
"aX" = (
/obj/structure/table/wood/fancy,
/obj/item/reagent_containers/condiment/peppermill{
	pixel_x = -4;
	pixel_y = 12
	},
/obj/item/reagent_containers/condiment/saltshaker{
	pixel_x = 4;
	pixel_y = 4
	},
/turf/open/floor/carpet/black,
/area/survivalpod)
"aY" = (
/obj/structure/sign/mining/survival,
/turf/closed/wall/mineral/plastic/pod,
/area/survivalpod)
"aZ" = (
/obj/structure/sign/mining/survival{
	dir = 4
	},
/turf/closed/wall/mineral/plastic/pod,
/area/survivalpod)
"dK" = (
/obj/structure/disposalpipe/segment,
/turf/closed/wall/mineral/plastic/nodiagonal,
/area/survivalpod)
"lO" = (
/obj/item/book/manual/wiki/barman_recipes,
/obj/item/reagent_containers/cup/glass/shaker,
/obj/item/reagent_containers/cup/rag,
/obj/structure/table/wood/fancy/black,
/turf/open/floor/pod/dark,
/area/survivalpod)
"tr" = (
/obj/structure/sign/mining/survival{
	dir = 4
	},
/obj/structure/disposalpipe/segment,
/turf/closed/wall/mineral/plastic/nodiagonal,
/area/survivalpod)
"wv" = (
/obj/structure/sign/mining/survival{
	dir = 1
	},
/turf/closed/wall/mineral/plastic/nodiagonal,
/area/survivalpod)
"JA" = (
/obj/structure/sign/mining/survival{
	dir = 4
	},
/obj/structure/disposalpipe/junction{
	dir = 4
	},
/turf/closed/wall/mineral/plastic/pod,
/area/survivalpod)
"SE" = (
/obj/structure/sign/mining/survival{
	dir = 1
	},
/turf/closed/wall/mineral/plastic/pod,
/area/survivalpod)
"SN" = (
/obj/structure/sign/mining/survival{
	dir = 4
	},
/obj/structure/disposalpipe/segment{
	dir = 9
	},
/turf/closed/wall/mineral/plastic/nodiagonal,
/area/survivalpod)

(1,1,1) = {"
aS
aT
ap
aT
aU
aT
aC
aT
aC
aT
aS
"}
(2,1,1) = {"
SE
af
aq
as
ax
ay
aD
aX
aK
aL
aY
"}
(3,1,1) = {"
aU
ag
aq
at
ax
ay
ay
ay
ay
aM
aU
"}
(4,1,1) = {"
wv
ah
aq
at
ax
ay
aD
aX
aK
ay
aW
"}
(5,1,1) = {"
aU
lO
aq
au
ax
ay
aD
aX
aK
ay
aU
"}
(6,1,1) = {"
wv
aj
aq
at
ax
ay
ay
ay
ay
ay
aR
"}
(7,1,1) = {"
aU
ak
aq
at
ax
ay
aU
aU
aU
aU
aU
"}
(8,1,1) = {"
wv
al
aq
at
ax
ay
aU
aG
aH
aH
aW
"}
(9,1,1) = {"
aU
am
aq
av
ay
ay
aE
aH
aU
aE
aU
"}
(10,1,1) = {"
SE
an
aq
at
az
aA
aU
aI
aU
aN
aY
"}
(11,1,1) = {"
aS
JA
dK
tr
dK
SN
aU
aV
aU
aZ
aS
"}
