//MAP CONVERTED BY dmm2tgm.py THIS HEADER COMMENT PREVENTS RECONVERSION, DO NOT REMOVE
"a" = (
/turf/template_noop,
/area/template_noop)
"b" = (
/turf/closed/wall/mineral/titanium/overspace,
/area/space)
"c" = (
/obj/effect/spawner/structure/window/shuttle{
	dir = 1
	},
/turf/open/floor/plating/airless,
/area/space)
"d" = (
/turf/closed/wall/mineral/titanium,
/area/space)
"f" = (
/turf/open/floor/mineral/titanium/blue,
/area/space)
"g" = (
/obj/structure/chair{
	dir = 2
	},
/turf/open/floor/mineral/titanium/blue,
/area/space)
"j" = (
/obj/machinery/door/unpowered/shuttle{
	dir = 1
	},
/turf/open/floor/mineral/titanium/blue,
/area/space)
"l" = (
/obj/structure/chair{
	dir = 4
	},
/turf/open/floor/mineral/titanium/blue,
/area/space)
"m" = (
/obj/structure/chair{
	dir = 8
	},
/turf/open/floor/mineral/titanium/blue,
/area/space)
"n" = (
/obj/structure/shuttle/engine/heater{
	dir = 1
	},
/turf/open/floor/plating/airless,
/area/space)
"p" = (
/obj/structure/shuttle/engine/propulsion/left{
	dir = 1
	},
/turf/open/floor/plating/airless,
/area/space)
"q" = (
/obj/structure/shuttle/engine/propulsion{
	dir = 1
	},
/turf/open/floor/plating/airless,
/area/space)
"r" = (
/obj/structure/shuttle/engine/propulsion/right{
	dir = 1
	},
/turf/open/floor/plating/airless,
/area/space)

(1,1,1) = {"
b
d
d
j
j
d
d
b
a
a
a"}(2,1,1) = {"
p
n
f
f
f
l
l
d
d
d
b"}(3,1,1) = {"
q
n
f
f
f
f
f
d
f
f
c"}(4,1,1) = {"
q
n
f
f
f
f
f
j
f
g
c"}(5,1,1) = {"
q
n
f
f
f
f
f
d
f
f
c"}(6,1,1) = {"
r
n
f
f
f
m
m
d
d
d
b"}(7,1,1) = {"
b
d
d
j
j
d
d
b
a
a
a"}