//MAP CONVERTED BY dmm2tgm.py THIS HEADER COMMENT PREVENTS RECONVERSION, DO NOT REMOVE
"a" = (
/turf/template_noop,
/area/template_noop)
"b" = (
/turf/closed/mineral,
/area/space)
"c" = (
/turf/closed/mineral/random/low_chance,
/area/space)

(1,1,1) = {"
a
b
b
b
c
b
a
a"}(2,1,1) = {"
a
c
c
c
c
b
b
a"}(3,1,1) = {"
b
b
c
c
c
c
b
b"}(4,1,1) = {"
b
c
c
c
c
c
b
b"}(5,1,1) = {"
a
b
c
c
c
c
c
a"}(6,1,1) = {"
a
b
b
c
b
c
a
a"}(7,1,1) = {"
a
a
b
b
b
a
a
a"}