//MAP CONVERTED BY dmm2tgm.py THIS HEADER COMMENT PREVENTS RECONVERSION, DO NOT REMOVE
"a" = (
/turf/closed/indestructible/necropolis,
/area/shuttle_arena)
"b" = (
/turf/open/indestructible/necropolis/air,
/area/shuttle_arena)
"c" = (
/obj/effect/forcefield/arena_shuttle{
	dir = 1
	},
/turf/open/indestructible/necropolis/air,
/area/shuttle_arena)
"d" = (
/turf/open/lava/smooth,
/area/shuttle_arena)
"e" = (
/obj/effect/landmark/shuttle_arena_entrance{
	dir = 1
	},
/turf/open/indestructible/necropolis/air,
/area/shuttle_arena)
"f" = (
/turf/template_noop,
/area/template_noop)

(1,1,1) = {"
f
f
f
f
f
f
f
f
f
f
f
f
f
f
f
f
f
f
f
f
f
f
f
a
a
a
a
a
a
a
a
a
a
a
a
a
a
a
a
a
a
a
a
a
a
a
a
a
a
a"}(2,1,1) = {"
f
f
f
f
f
f
f
f
f
f
f
f
f
f
f
f
f
f
f
f
f
f
f
a
b
b
b
b
b
b
b
b
b
b
b
b
b
b
b
b
b
b
b
b
b
a
b
b
b
a"}(3,1,1) = {"
f
f
f
f
f
f
f
f
f
f
f
f
f
f
f
f
f
f
f
f
f
f
f
a
b
b
b
b
b
b
b
b
b
b
b
b
b
b
b
b
b
b
b
b
b
b
b
b
b
a"}(4,1,1) = {"
f
f
f
f
f
f
f
f
f
f
f
f
f
f
f
f
f
f
f
f
f
f
f
a
b
e
b
b
b
b
b
b
b
b
b
b
b
b
e
b
b
b
b
b
b
b
b
b
b
a"}(5,1,1) = {"
f
f
f
f
f
f
f
f
f
f
f
f
f
f
f
f
f
f
f
f
f
f
f
a
b
b
b
b
b
b
b
b
a
b
b
b
b
b
b
b
b
b
b
b
b
b
b
e
b
a"}(6,1,1) = {"
f
f
f
f
f
f
f
f
f
f
f
f
f
f
f
f
f
f
f
f
f
f
f
a
b
b
b
b
b
b
b
b
a
b
b
b
b
b
b
b
b
b
b
b
b
a
b
b
a
a"}(7,1,1) = {"
f
f
f
f
f
f
f
f
f
f
f
f
f
f
f
f
f
f
f
f
f
f
f
a
b
b
b
b
e
b
b
a
a
b
b
b
d
d
d
b
a
b
b
b
b
b
b
b
b
a"}(8,1,1) = {"
f
f
f
f
f
f
f
f
f
f
f
f
f
f
f
f
f
f
f
f
f
f
f
a
b
b
b
b
b
b
b
b
b
b
b
d
d
d
d
b
b
b
b
b
b
b
b
b
b
a"}(9,1,1) = {"
f
f
f
f
f
f
f
f
f
f
f
f
f
f
f
f
f
f
f
f
f
f
f
a
b
b
b
b
b
b
b
b
b
b
d
d
d
d
d
b
b
b
b
b
b
b
b
b
b
a"}(10,1,1) = {"
f
f
f
f
f
f
f
f
f
f
f
f
f
f
f
f
f
f
f
f
f
f
f
a
b
b
b
b
b
b
b
b
b
b
b
b
b
b
b
b
b
b
b
b
b
b
b
b
b
a"}(11,1,1) = {"
f
f
f
f
f
f
f
f
f
f
f
f
f
f
f
f
f
f
f
f
f
f
f
a
b
b
b
b
b
b
b
b
b
b
b
b
b
b
b
b
b
b
b
b
b
b
b
b
b
a"}(12,1,1) = {"
f
f
f
f
f
f
f
f
f
f
f
f
f
f
f
f
f
f
f
f
f
f
f
a
b
b
b
b
b
b
b
b
b
b
b
b
b
b
b
b
b
b
b
b
b
b
b
b
b
a"}(13,1,1) = {"
a
a
a
a
a
a
a
a
a
a
a
a
a
a
a
a
a
a
a
a
a
a
a
a
d
b
b
b
b
b
b
b
b
b
b
b
b
b
b
b
b
b
b
b
b
b
b
b
b
a"}(14,1,1) = {"
a
b
b
b
b
b
b
b
b
b
b
b
b
b
b
b
b
b
b
b
b
a
b
d
d
d
b
b
b
b
b
b
b
b
b
b
a
b
b
e
b
b
b
a
b
b
b
b
b
a"}(15,1,1) = {"
a
b
b
b
b
b
b
b
b
b
b
b
b
b
b
b
b
b
b
b
b
a
b
b
d
d
b
b
b
b
b
b
b
b
b
b
a
b
b
b
b
b
b
b
b
b
b
b
b
a"}(16,1,1) = {"
a
b
b
b
b
b
b
b
b
b
b
b
e
b
b
b
b
b
b
b
b
a
b
b
d
d
d
d
b
b
b
b
b
b
b
b
b
b
b
b
b
b
b
b
b
b
b
e
b
a"}(17,1,1) = {"
a
b
b
b
b
b
b
b
b
b
b
b
b
b
b
b
b
b
b
b
b
a
b
b
b
b
d
d
b
b
b
b
b
e
b
b
b
b
b
b
b
b
b
b
b
b
b
b
b
a"}(18,1,1) = {"
a
b
b
b
b
b
b
b
b
b
b
b
b
b
b
b
b
b
b
b
b
a
b
b
b
b
b
b
b
b
b
b
b
b
b
b
b
b
b
b
b
b
b
b
b
b
a
a
a
a"}(19,1,1) = {"
a
b
b
b
b
b
b
b
b
b
b
b
b
b
b
b
b
b
b
b
b
b
b
b
b
b
b
b
b
b
b
b
b
b
b
b
b
b
b
b
b
b
b
b
b
a
a
a
a
a"}(20,1,1) = {"
a
b
b
b
a
a
b
b
a
b
b
b
b
b
b
b
b
b
b
b
b
b
b
b
b
b
b
b
b
b
b
b
b
b
b
b
b
b
b
b
b
b
b
b
b
a
a
a
a
a"}(21,1,1) = {"
a
b
b
b
a
b
b
b
a
b
b
b
b
d
d
b
b
b
b
b
b
b
b
b
b
b
b
b
b
b
b
b
b
b
b
b
b
b
b
b
b
b
b
b
b
b
b
b
c
a"}(22,1,1) = {"
a
b
b
b
a
b
b
b
a
b
b
b
b
b
d
d
b
b
b
b
b
b
b
b
b
b
b
b
b
d
d
b
b
b
b
b
b
b
d
d
b
b
b
b
b
b
b
b
c
a"}(23,1,1) = {"
a
b
b
b
a
b
e
b
a
b
b
b
b
b
b
d
b
b
b
b
b
e
b
b
b
b
b
b
b
d
d
b
b
b
b
b
b
d
d
d
b
b
b
b
b
b
b
b
c
a"}(24,1,1) = {"
a
b
b
b
a
b
b
b
a
b
b
b
b
b
b
d
b
b
b
b
b
b
b
b
b
b
b
b
b
d
d
b
b
b
b
b
d
d
b
b
b
b
b
b
b
b
b
b
c
a"}(25,1,1) = {"
a
b
b
b
a
a
a
a
a
b
b
b
b
b
b
d
b
b
b
b
b
b
b
b
b
b
b
b
b
d
d
b
b
b
b
b
d
b
b
b
b
b
b
b
b
a
a
a
a
a"}(26,1,1) = {"
a
e
b
b
b
b
b
b
b
b
b
b
b
b
d
d
d
b
b
b
b
b
b
b
b
b
b
b
b
b
b
b
b
b
b
b
b
b
b
b
b
b
b
b
b
a
a
a
a
a"}(27,1,1) = {"
a
b
b
b
b
b
b
b
b
b
b
b
b
b
d
d
d
b
b
b
b
b
b
a
a
b
b
b
b
b
b
b
b
b
b
b
b
b
b
b
b
e
b
b
b
b
a
a
a
a"}(28,1,1) = {"
a
b
b
b
b
b
b
b
b
b
b
b
b
b
d
d
d
b
b
b
b
b
b
a
a
b
b
b
b
b
b
b
b
b
b
b
b
b
b
b
b
b
b
b
b
b
b
b
b
a"}(29,1,1) = {"
a
b
b
b
b
b
b
b
b
b
b
b
b
b
b
b
b
b
b
b
b
b
b
a
a
b
b
b
b
b
b
b
b
b
b
b
b
b
b
b
b
b
b
b
b
b
b
b
b
a"}(30,1,1) = {"
a
b
b
b
b
b
b
b
b
b
b
b
b
b
b
b
b
b
b
b
b
b
b
a
a
a
a
a
a
a
a
b
b
b
b
b
b
b
b
b
b
a
b
b
b
b
b
b
b
a"}(31,1,1) = {"
a
b
b
b
b
b
b
b
b
b
b
b
b
b
b
b
b
b
b
b
b
b
b
a
a
b
b
b
b
b
b
b
b
b
b
b
b
b
b
b
b
a
b
b
b
b
b
b
b
a"}(32,1,1) = {"
a
b
b
b
b
b
b
b
b
b
e
b
b
b
b
b
b
b
b
b
b
b
b
b
b
b
b
b
b
b
b
e
b
b
b
b
b
b
b
b
b
b
b
b
b
b
b
b
b
a"}(33,1,1) = {"
a
b
b
b
b
b
b
b
b
b
b
b
b
b
b
b
b
b
b
b
b
e
b
b
b
b
b
b
b
b
b
b
b
b
b
b
b
b
b
b
b
b
b
b
b
b
b
b
b
a"}(34,1,1) = {"
a
b
b
b
b
b
b
b
b
b
b
b
b
b
b
b
b
b
b
b
b
b
b
b
b
b
b
b
b
b
b
b
b
b
b
b
b
b
b
b
b
b
b
b
b
b
b
b
b
a"}(35,1,1) = {"
a
b
b
b
b
b
b
a
a
a
a
a
a
a
a
b
b
b
b
b
b
b
b
b
b
b
b
b
b
b
b
b
b
a
a
a
a
a
b
b
b
b
b
b
b
b
e
b
b
a"}(36,1,1) = {"
a
b
b
b
b
b
b
b
b
a
b
b
b
b
b
b
b
b
b
b
b
b
b
b
b
b
b
b
b
b
b
b
b
a
a
a
a
a
b
b
b
b
b
b
b
b
b
b
b
a"}(37,1,1) = {"
a
b
b
b
b
b
b
b
b
a
b
b
a
b
b
b
b
b
b
b
b
b
b
b
b
b
b
b
b
b
b
b
b
b
b
b
b
b
b
b
b
b
b
b
b
b
b
b
b
a"}(38,1,1) = {"
a
b
b
b
b
b
b
b
b
a
e
b
a
b
b
b
b
b
b
b
b
b
b
b
b
b
b
b
b
b
b
b
b
b
b
b
b
b
b
b
b
b
b
b
b
b
b
b
b
a"}(39,1,1) = {"
a
b
b
b
b
b
b
b
b
a
a
a
a
b
b
b
b
b
b
b
b
b
b
b
b
b
b
e
b
b
b
b
b
b
b
b
b
b
b
b
b
b
b
b
b
b
b
b
b
a"}(40,1,1) = {"
a
b
b
b
b
b
b
b
b
a
b
b
b
b
b
b
b
b
b
b
b
b
b
b
b
b
b
b
b
b
b
b
b
b
b
b
b
b
b
b
b
b
b
b
b
b
b
b
b
a"}(41,1,1) = {"
a
e
b
b
b
b
b
b
b
a
b
b
b
b
b
d
d
d
d
d
b
b
b
b
b
b
b
b
b
b
b
b
b
b
b
b
b
b
b
b
b
a
a
a
a
a
b
b
b
a"}(42,1,1) = {"
a
b
b
b
b
b
b
b
b
b
b
b
b
b
b
d
d
d
d
d
b
b
b
b
b
b
b
b
b
b
b
b
b
b
b
b
b
b
b
b
b
a
b
b
b
b
b
b
b
a"}(43,1,1) = {"
a
b
b
b
b
b
b
b
b
b
b
b
b
b
b
d
d
d
d
d
b
b
b
b
b
b
b
b
b
b
b
b
b
b
b
b
b
b
b
b
b
a
b
b
b
b
b
b
b
a"}(44,1,1) = {"
a
b
b
a
b
b
b
b
b
b
b
b
b
b
b
d
d
d
d
d
a
a
a
a
b
b
b
b
b
b
b
b
b
e
b
b
b
b
b
b
b
a
b
b
b
b
b
b
b
a"}(45,1,1) = {"
a
b
b
a
b
b
b
b
b
b
b
b
b
b
b
d
d
d
d
d
b
b
e
a
b
b
b
b
b
b
b
b
b
b
b
b
b
b
b
b
b
a
b
b
e
b
b
b
b
a"}(46,1,1) = {"
a
b
b
a
b
b
b
b
b
b
b
b
d
d
d
d
d
d
d
d
b
b
b
b
b
b
b
b
b
b
b
b
b
b
b
b
b
b
b
b
b
a
b
b
b
b
b
b
b
a"}(47,1,1) = {"
a
b
b
b
b
b
e
b
b
b
b
b
d
d
d
d
d
d
d
d
d
d
d
d
d
d
d
b
b
b
b
b
b
b
b
b
b
b
b
b
b
b
b
b
b
b
b
b
b
a"}(48,1,1) = {"
a
b
b
b
b
b
b
b
b
b
d
d
d
d
d
d
d
d
d
d
d
d
d
d
d
d
d
b
b
b
b
b
b
b
b
b
b
b
b
b
b
b
b
b
b
b
b
d
d
a"}(49,1,1) = {"
a
b
b
b
b
b
b
b
b
b
d
d
d
d
d
d
d
d
d
d
d
d
d
d
d
d
d
b
b
b
b
b
b
b
b
b
b
b
b
b
b
b
b
b
b
b
b
d
d
a"}(50,1,1) = {"
a
a
a
a
a
a
a
a
a
a
a
a
a
a
a
a
a
a
a
a
a
a
a
a
a
a
a
a
a
a
a
a
a
a
a
a
a
a
a
a
a
a
a
a
a
a
a
a
a
a"}