//MAP CONVERTED BY dmm2tgm.py THIS HEADER COMMENT PREVENTS RECONVERSION, DO NOT REMOVE
"a" = (
/turf/closed/wall,
/area/testroom)
"m" = (
/turf/open/floor/plasteel,
/area/testroom)
"r" = (
/obj/effect/landmark/unit_test_top_right{
	dir = 1
	},
/turf/open/floor/plasteel,
/area/testroom)
"L" = (
/obj/effect/landmark/unit_test_bottom_left{
	dir = 1
	},
/turf/open/floor/plasteel,
/area/testroom)

(1,1,1) = {"
a
a
a
a
a
a
a"}(2,1,1) = {"
a
L
m
m
m
m
a"}(3,1,1) = {"
a
m
m
m
m
m
a"}(4,1,1) = {"
a
m
m
m
m
m
a"}(5,1,1) = {"
a
m
m
m
m
m
a"}(6,1,1) = {"
a
m
m
m
m
r
a"}(7,1,1) = {"
a
a
a
a
a
a
a"}