//MAP CONVERTED BY dmm2tgm.py THIS HEADER COMMENT PREVENTS RECONVERSION, DO NOT REMOVE
"aa" = (
/turf/open/floor/mineral/plastitanium,
/area/shuttle/arrival)
"ab" = (
/obj/structure/shuttle/engine/propulsion{
	dir = 1
	},
/obj/effect/turf_decal/stripes/line{
	dir = 1
	},
/obj/docking_port/mobile/arrivals{
	dir = 2;
	dwidth = 4;
	height = 13;
	name = "corg arrivals shuttle";
	width = 9
	},
/turf/open/floor/plating,
/area/shuttle/arrival)
"ac" = (
/obj/structure/sign/directions/security{
	dir = 1;
	pixel_x = -33
	},
/obj/structure/sign/directions/command{
	dir = 1;
	pixel_x = -33;
	pixel_y = -8
	},
/obj/structure/sign/directions/supply{
	dir = 4;
	pixel_x = -33;
	pixel_y = 8
	},
/obj/structure/chair/fancy/shuttle,
/obj/structure/window/reinforced{
	dir = 1
	},
/turf/open/floor/mineral/plastitanium,
/area/shuttle/arrival)
"ad" = (
/obj/structure/sign/directions/medical{
	dir = 4;
	pixel_x = 33
	},
/obj/structure/sign/directions/engineering{
	dir = 1;
	pixel_x = 33;
	pixel_y = -8
	},
/obj/structure/sign/directions/science{
	dir = 1;
	pixel_x = 33;
	pixel_y = 8
	},
/obj/structure/chair/fancy/shuttle{
	dir = 1
	},
/obj/structure/window/reinforced,
/turf/open/floor/mineral/plastitanium,
/area/shuttle/arrival)
"af" = (
/obj/structure/extinguisher_cabinet{
	pixel_x = 25
	},
/obj/machinery/status_display/evac{
	pixel_y = 32
	},
/obj/machinery/light{
	dir = 1
	},
/obj/structure/table/reinforced,
/obj/item/paper/pamphlet/centcom/visitor_info{
	pixel_x = -3;
	pixel_y = -1
	},
/obj/item/paper/pamphlet/centcom/visitor_info,
/obj/item/paper/pamphlet/centcom/visitor_info{
	pixel_x = 3;
	pixel_y = 1
	},
/turf/open/floor/mineral/plastitanium,
/area/shuttle/arrival)
"ak" = (
/obj/structure/sign/nanotrasen,
/turf/closed/wall/mineral/titanium/nodiagonal,
/area/shuttle/arrival)
"al" = (
/obj/machinery/computer{
	dir = 4;
	name = "Shuttle computer"
	},
/turf/open/floor/mineral/titanium/white,
/area/shuttle/arrival)
"am" = (
/turf/closed/wall/mineral/titanium,
/area/shuttle/arrival)
"ao" = (
/obj/structure/shuttle/engine/heater{
	dir = 1
	},
/obj/structure/window/reinforced/survival_pod,
/turf/open/floor/plating,
/area/shuttle/arrival)
"ap" = (
/turf/closed/wall/mineral/plastitanium,
/area/shuttle/arrival)
"as" = (
/obj/effect/turf_decal/tile/blue/opposingcorners,
/obj/machinery/status_display/evac{
	pixel_y = -32
	},
/turf/open/floor/mineral/titanium/white,
/area/shuttle/arrival)
"at" = (
/obj/item/crowbar,
/obj/item/crowbar,
/obj/item/crowbar,
/obj/structure/closet/crate/internals,
/obj/effect/spawner/lootdrop/glowstick,
/obj/effect/spawner/lootdrop/glowstick,
/obj/effect/spawner/lootdrop/glowstick,
/obj/item/gps,
/turf/open/floor/mineral/plastitanium,
/area/shuttle/arrival)
"au" = (
/obj/structure/chair/fancy/shuttle{
	dir = 8
	},
/turf/open/floor/mineral/titanium/white,
/area/shuttle/arrival)
"av" = (
/turf/template_noop,
/area/template_noop)
"az" = (
/obj/effect/turf_decal/tile/blue/opposingcorners,
/turf/open/floor/mineral/titanium/white,
/area/shuttle/arrival)
"aA" = (
/obj/effect/turf_decal/tile/blue/opposingcorners,
/obj/machinery/vending/wallmed{
	name = "Emergency NanoMed";
	use_power = 0;
	pixel_y = -32
	},
/turf/open/floor/mineral/titanium/white,
/area/shuttle/arrival)
"aC" = (
/obj/structure/shuttle/engine/propulsion{
	dir = 1
	},
/obj/effect/turf_decal/stripes/line{
	dir = 1
	},
/turf/open/floor/plating,
/area/shuttle/arrival)
"aH" = (
/obj/structure/chair/fancy/shuttle{
	dir = 1
	},
/obj/structure/window/reinforced,
/turf/open/floor/mineral/plastitanium,
/area/shuttle/arrival)
"aL" = (
/obj/structure/chair/fancy/shuttle,
/obj/structure/window/reinforced{
	dir = 1
	},
/turf/open/floor/mineral/plastitanium,
/area/shuttle/arrival)
"aN" = (
/obj/machinery/computer/crew{
	dir = 8
	},
/turf/open/floor/mineral/titanium/white,
/area/shuttle/arrival)
"aO" = (
/obj/structure/fans/tiny,
/obj/effect/turf_decal/stripes/closeup{
	dir = 1
	},
/obj/machinery/door/airlock/shuttle{
	name = "Arrival Shuttle Airlock"
	},
/turf/open/floor/mineral/titanium/white,
/area/shuttle/arrival)
"aQ" = (
/obj/effect/turf_decal/tile/blue/opposingcorners,
/obj/machinery/light,
/turf/open/floor/mineral/titanium/white,
/area/shuttle/arrival)
"aS" = (
/obj/structure/extinguisher_cabinet{
	pixel_x = -25
	},
/obj/machinery/status_display/evac{
	pixel_y = 32
	},
/obj/machinery/light{
	dir = 1
	},
/obj/structure/table/reinforced,
/obj/item/paicard,
/turf/open/floor/mineral/plastitanium,
/area/shuttle/arrival)
"aT" = (
/obj/structure/table/reinforced,
/obj/item/storage/briefcase{
	pixel_x = -2;
	pixel_y = 4
	},
/obj/item/storage/briefcase{
	pixel_x = 1;
	pixel_y = 1
	},
/obj/item/storage/firstaid/regular,
/turf/open/floor/mineral/plastitanium,
/area/shuttle/arrival)
"aV" = (
/obj/structure/window/shuttle,
/turf/open/floor/plating,
/area/shuttle/arrival)
"aW" = (
/obj/structure/table/reinforced,
/obj/item/paper_bin,
/obj/item/pen,
/turf/open/floor/mineral/plastitanium,
/area/shuttle/arrival)
"aX" = (
/obj/effect/turf_decal/stripes/closeup,
/obj/machinery/door/airlock/shuttle{
	name = "Arrival Shuttle Airlock"
	},
/turf/open/floor/mineral/titanium/white,
/area/shuttle/arrival)
"jV" = (
/obj/structure/sign/directions/security{
	dir = 1;
	pixel_x = 33
	},
/obj/structure/sign/directions/supply{
	dir = 4;
	pixel_x = 33;
	pixel_y = 8
	},
/obj/structure/sign/directions/command{
	dir = 1;
	pixel_x = 33;
	pixel_y = -8
	},
/obj/structure/chair/fancy/shuttle,
/obj/structure/window/reinforced{
	dir = 1
	},
/turf/open/floor/mineral/plastitanium,
/area/shuttle/arrival)
"rd" = (
/obj/structure/sign/directions/medical{
	dir = 4;
	pixel_x = -33
	},
/obj/structure/sign/directions/science{
	dir = 1;
	pixel_x = -33;
	pixel_y = 8
	},
/obj/structure/sign/directions/engineering{
	dir = 1;
	pixel_x = -33;
	pixel_y = -8
	},
/obj/structure/chair/fancy/shuttle{
	dir = 1
	},
/obj/structure/window/reinforced,
/turf/open/floor/mineral/plastitanium,
/area/shuttle/arrival)

(1,1,1) = {"
av
ap
am
aO
am
aV
am
aO
ak
av
av
"}
(2,1,1) = {"
ap
ap
aS
az
ac
aa
rd
aQ
am
am
am
"}
(3,1,1) = {"
aC
ao
aW
az
aL
aa
aH
aA
am
al
aV
"}
(4,1,1) = {"
ab
ao
at
az
az
az
az
az
aX
au
aV
"}
(5,1,1) = {"
aC
ao
aT
az
aL
aa
aH
as
am
aN
aV
"}
(6,1,1) = {"
ap
ap
af
az
jV
aa
ad
aQ
am
am
am
"}
(7,1,1) = {"
av
ap
am
aO
am
aV
am
aO
ak
av
av
"}
