//MAP CONVERTED BY dmm2tgm.py THIS HEADER COMMENT PREVENTS RECONVERSION, DO NOT REMOVE
"aa" = (
/turf/closed/wall/mineral/plastitanium,
/area/shuttle/arrival)
"ab" = (
/turf/closed/wall/mineral/titanium/nodiagonal,
/area/shuttle/arrival)
"ac" = (
/turf/closed/wall/mineral/titanium,
/area/shuttle/arrival)
"ad" = (
/obj/machinery/door/airlock/shuttle{
	name = "Arrival Shuttle Airlock"
	},
/obj/structure/fans/tiny,
/obj/effect/turf_decal/stripes/closeup,
/turf/open/floor/mineral/plastitanium,
/area/shuttle/arrival)
"ae" = (
/obj/structure/sign/nanotrasen,
/turf/closed/wall/mineral/titanium,
/area/shuttle/arrival)
"af" = (
/obj/structure/window/reinforced/shuttle,
/obj/structure/grille,
/turf/open/floor/plating,
/area/shuttle/arrival)
"ag" = (
/turf/template_noop,
/area/template_noop)
"ah" = (
/obj/structure/sign/warning/fire,
/turf/closed/wall/mineral/titanium,
/area/shuttle/arrival)
"ai" = (
/obj/item/clothing/suit/hazardvest{
	desc = "A high-visibility lifejacket complete with whistle and slot for oxygen tanks.";
	name = "emergency lifejacket"
	},
/obj/item/clothing/suit/hazardvest{
	desc = "A high-visibility lifejacket complete with whistle and slot for oxygen tanks.";
	name = "emergency lifejacket"
	},
/obj/item/tank/internals/emergency_oxygen{
	pixel_x = 3
	},
/obj/item/tank/internals/emergency_oxygen{
	pixel_x = 3
	},
/obj/item/clothing/mask/breath{
	pixel_x = -3;
	pixel_y = -3
	},
/obj/item/clothing/mask/breath{
	pixel_x = -3;
	pixel_y = -3
	},
/obj/item/clothing/head/utility/hardhat/orange{
	name = "protective hat";
	pixel_y = 9
	},
/obj/item/clothing/head/utility/hardhat/orange{
	name = "protective hat";
	pixel_y = 9
	},
/obj/structure/closet/crate/internals,
/obj/effect/turf_decal/bot,
/obj/effect/turf_decal/siding/dark{
	dir = 4
	},
/turf/open/floor/mineral/plastitanium,
/area/shuttle/arrival)
"ak" = (
/obj/structure/chair/fancy/shuttle,
/obj/effect/turf_decal/siding/dark,
/turf/open/floor/mineral/plastitanium,
/area/shuttle/arrival)
"al" = (
/obj/structure/chair/fancy/shuttle,
/obj/machinery/status_display/evac{
	pixel_y = 32
	},
/obj/machinery/light{
	dir = 1
	},
/obj/effect/turf_decal/siding/dark{
	dir = 6
	},
/turf/open/floor/mineral/plastitanium,
/area/shuttle/arrival)
"an" = (
/obj/structure/shuttle/engine/propulsion/left{
	dir = 8
	},
/obj/effect/turf_decal/stripes/line{
	dir = 8
	},
/turf/open/floor/plating/airless,
/area/shuttle/arrival)
"ao" = (
/obj/structure/window/reinforced/shuttle,
/obj/structure/grille,
/obj/structure/shuttle/engine/heater{
	dir = 8
	},
/turf/open/floor/plating,
/area/shuttle/arrival)
"ap" = (
/obj/structure/table,
/obj/item/flashlight{
	pixel_y = 8
	},
/obj/item/flashlight,
/obj/effect/turf_decal/siding/dark{
	dir = 4
	},
/turf/open/floor/mineral/plastitanium,
/area/shuttle/arrival)
"at" = (
/obj/structure/chair/fancy/shuttle,
/obj/machinery/light/small{
	dir = 8
	},
/obj/effect/turf_decal/siding/dark,
/turf/open/floor/mineral/plastitanium,
/area/shuttle/arrival)
"au" = (
/obj/structure/shuttle/engine/propulsion{
	dir = 8
	},
/obj/effect/turf_decal/stripes/line{
	dir = 8
	},
/obj/docking_port/mobile/arrivals{
	dir = 4;
	name = "kilo arrivals shuttle"
	},
/turf/open/floor/plating/airless,
/area/shuttle/arrival)
"ay" = (
/obj/machinery/requests_console{
	department = "Arrival shuttle";
	name = "Arrivals Shuttle console"
	},
/turf/closed/wall/mineral/titanium/nodiagonal,
/area/shuttle/arrival)
"az" = (
/obj/structure/flora/ausbushes/grassybush,
/obj/structure/flora/ausbushes/lavendergrass,
/obj/structure/flora/ausbushes/ywflowers,
/obj/structure/flora/ausbushes/fernybush,
/obj/structure/window/reinforced/shuttle,
/turf/open/floor/grass,
/area/shuttle/arrival)
"aA" = (
/obj/machinery/vending/wallmed{
	name = "Emergency NanoMed";
	use_power = 0
	},
/turf/closed/wall/mineral/titanium/nodiagonal,
/area/shuttle/arrival)
"aD" = (
/obj/machinery/door/airlock/shuttle{
	name = "Arrival Shuttle Airlock"
	},
/obj/effect/turf_decal/stripes/closeup{
	dir = 1
	},
/turf/open/floor/mineral/plastitanium,
/area/shuttle/arrival)
"aG" = (
/obj/structure/shuttle/engine/propulsion/right{
	dir = 8
	},
/obj/effect/turf_decal/stripes/line{
	dir = 8
	},
/turf/open/floor/plating/airless,
/area/shuttle/arrival)
"aH" = (
/obj/structure/table,
/obj/item/storage/toolbox/emergency,
/obj/item/crowbar/red,
/obj/effect/turf_decal/siding/dark{
	dir = 4
	},
/turf/open/floor/mineral/plastitanium,
/area/shuttle/arrival)
"aL" = (
/obj/machinery/status_display/ai,
/turf/closed/wall/mineral/titanium,
/area/shuttle/arrival)
"aM" = (
/obj/structure/chair/fancy/shuttle{
	dir = 1
	},
/obj/machinery/light/small{
	dir = 8
	},
/obj/effect/turf_decal/siding/dark{
	dir = 1
	},
/turf/open/floor/mineral/plastitanium,
/area/shuttle/arrival)
"aN" = (
/obj/structure/chair/fancy/shuttle{
	dir = 1
	},
/obj/effect/turf_decal/siding/dark{
	dir = 1
	},
/turf/open/floor/mineral/plastitanium,
/area/shuttle/arrival)
"aP" = (
/obj/structure/chair/fancy/shuttle{
	dir = 1
	},
/obj/machinery/status_display/evac{
	pixel_y = -32
	},
/obj/machinery/light,
/obj/effect/turf_decal/siding/dark{
	dir = 5
	},
/turf/open/floor/mineral/plastitanium,
/area/shuttle/arrival)
"aQ" = (
/obj/structure/rack,
/obj/effect/turf_decal/bot,
/obj/item/radio{
	pixel_x = -6;
	pixel_y = 6
	},
/obj/item/radio{
	pixel_x = 6;
	pixel_y = 6
	},
/obj/item/radio{
	pixel_y = 4
	},
/obj/effect/turf_decal/tile/neutral/half/contrasted{
	dir = 4
	},
/obj/effect/turf_decal/siding/dark{
	dir = 4
	},
/turf/open/floor/mineral/plastitanium,
/area/shuttle/arrival)
"aR" = (
/obj/effect/turf_decal/tile/blue/opposingcorners,
/turf/open/floor/mineral/titanium/white,
/area/shuttle/arrival)
"aS" = (
/obj/structure/chair/fancy/shuttle{
	dir = 1
	},
/obj/machinery/light,
/obj/effect/turf_decal/siding/dark{
	dir = 9
	},
/turf/open/floor/mineral/plastitanium,
/area/shuttle/arrival)
"aZ" = (
/obj/structure/chair/fancy/shuttle,
/obj/machinery/light{
	dir = 1
	},
/obj/effect/turf_decal/siding/dark{
	dir = 10
	},
/turf/open/floor/mineral/plastitanium,
/area/shuttle/arrival)
"mB" = (
/obj/effect/turf_decal/arrows{
	dir = 1
	},
/obj/effect/turf_decal/tile/blue/opposingcorners,
/turf/open/floor/mineral/titanium/white,
/area/shuttle/arrival)
"SZ" = (
/obj/item/radio/intercom{
	pixel_x = 28
	},
/obj/effect/turf_decal/arrows{
	dir = 1
	},
/obj/effect/turf_decal/tile/blue/opposingcorners,
/turf/open/floor/mineral/titanium/white,
/area/shuttle/arrival)

(1,1,1) = {"
aa
aa
an
au
aG
aa
aa
"}
(2,1,1) = {"
ab
ah
ao
ao
ao
ah
ab
"}
(3,1,1) = {"
ac
ai
ap
aQ
aH
ai
ac
"}
(4,1,1) = {"
ad
mB
mB
aR
aR
aR
af
"}
(5,1,1) = {"
ae
aZ
aR
aR
aR
aS
ae
"}
(6,1,1) = {"
af
ak
aR
ay
aR
aN
af
"}
(7,1,1) = {"
af
ak
aR
az
aR
aN
af
"}
(8,1,1) = {"
af
ak
aR
aA
aR
aN
af
"}
(9,1,1) = {"
ac
al
aR
aR
aR
aP
ac
"}
(10,1,1) = {"
ad
mB
SZ
aR
aR
aR
af
"}
(11,1,1) = {"
ab
ac
ac
aD
aL
ac
ab
"}
(12,1,1) = {"
ac
ae
at
aR
aM
ae
ac
"}
(13,1,1) = {"
ag
ac
ak
aR
aN
ac
ag
"}
(14,1,1) = {"
ag
ac
af
af
af
ac
ag
"}
