//MAP CONVERTED BY dmm2tgm.py THIS HEADER COMMENT PREVENTS RECONVERSION, DO NOT REMOVE
"ah" = (
/obj/machinery/atmospherics/pipe/smart/manifold4w/purple/visible,
/obj/structure/lattice/catwalk,
/turf/open/space/basic,
/area/template_noop)
"ap" = (
/obj/structure/lattice/catwalk,
/turf/open/space/basic,
/area/template_noop)
"cd" = (
/obj/machinery/atmospherics/pipe/smart/manifold4w/purple/visible,
/obj/machinery/atmospherics/pipe/smart/manifold4w/purple/visible/layer2,
/obj/machinery/atmospherics/pipe/smart/manifold4w/purple/visible/layer4,
/obj/structure/lattice/catwalk,
/turf/open/space/basic,
/area/template_noop)
"cn" = (
/obj/machinery/atmospherics/components/unary/vent_scrubber/on/layer5{
	dir = 8
	},
/obj/machinery/atmospherics/pipe/heat_exchanging/manifold/layer2{
	dir = 8
	},
/obj/machinery/atmospherics/pipe/heat_exchanging/manifold{
	dir = 8
	},
/obj/machinery/atmospherics/pipe/heat_exchanging/manifold/layer4{
	dir = 8
	},
/turf/open/floor/engine/airless,
/area/template_noop)
"cX" = (
/obj/machinery/door/poddoor/shutters/radiation/preopen{
	id = "engsm";
	name = "Radiation Chamber Shutters"
	},
/obj/structure/cable{
	icon_state = "4-8"
	},
/obj/structure/cable{
	icon_state = "1-8"
	},
/obj/structure/cable{
	icon_state = "2-8"
	},
/obj/machinery/atmospherics/pipe/heat_exchanging/simple/layer4{
	dir = 4
	},
/obj/machinery/atmospherics/pipe/heat_exchanging/simple/layer2{
	dir = 4
	},
/obj/machinery/atmospherics/pipe/heat_exchanging/simple{
	dir = 4
	},
/turf/open/floor/plating/airless,
/area/template_noop)
"dN" = (
/obj/machinery/atmospherics/pipe/heat_exchanging/simple/layer4,
/obj/machinery/atmospherics/pipe/heat_exchanging/simple,
/obj/machinery/atmospherics/pipe/heat_exchanging/simple/layer2,
/obj/structure/lattice/catwalk,
/obj/structure/cable{
	icon_state = "1-2"
	},
/turf/open/space/basic,
/area/template_noop)
"dP" = (
/obj/machinery/atmospherics/pipe/layer_manifold/scrubbers/visible,
/obj/effect/spawner/structure/window/plasma/reinforced,
/turf/open/floor/plating/airless,
/area/template_noop)
"ff" = (
/obj/machinery/airalarm/directional/west,
/obj/effect/mapping_helpers/airalarm/engine_access,
/obj/effect/mapping_helpers/airalarm/unlocked,
/obj/effect/mapping_helpers/airalarm/link{
	chamber_id = "engine"
	},
/obj/effect/mapping_helpers/airalarm/tlv_no_checks,
/obj/machinery/atmospherics/pipe/smart/manifold4w/green/hidden/layer1,
/obj/structure/lattice/catwalk,
/turf/open/space/basic,
/area/template_noop)
"fi" = (
/obj/structure/cable{
	icon_state = "1-8"
	},
/obj/structure/lattice/catwalk,
/obj/machinery/atmospherics/pipe/heat_exchanging/manifold/layer4{
	dir = 4
	},
/obj/machinery/atmospherics/pipe/heat_exchanging/manifold/layer2{
	dir = 4
	},
/obj/machinery/atmospherics/pipe/heat_exchanging/manifold{
	dir = 4
	},
/turf/open/space/basic,
/area/template_noop)
"fZ" = (
/obj/machinery/atmospherics/components/unary/vent_scrubber/on/layer1,
/obj/machinery/atmospherics/pipe/smart/manifold4w/green/hidden/layer1,
/obj/machinery/atmospherics/pipe/smart/manifold4w/scrubbers/hidden/layer5,
/obj/machinery/atmospherics/pipe/heat_exchanging/simple{
	dir = 4
	},
/obj/machinery/atmospherics/pipe/heat_exchanging/simple/layer2{
	dir = 8
	},
/obj/machinery/atmospherics/pipe/heat_exchanging/simple/layer4{
	dir = 4
	},
/turf/open/floor/engine/airless,
/area/template_noop)
"gv" = (
/obj/machinery/atmospherics/components/unary/vent_scrubber/on/layer1{
	dir = 4
	},
/obj/machinery/atmospherics/pipe/heat_exchanging/simple/layer4{
	dir = 5
	},
/obj/machinery/atmospherics/pipe/heat_exchanging/simple/layer2{
	dir = 5
	},
/obj/machinery/atmospherics/pipe/heat_exchanging/simple{
	dir = 5
	},
/turf/open/floor/engine/airless,
/area/template_noop)
"hf" = (
/obj/machinery/atmospherics/pipe/heat_exchanging/simple/layer2{
	dir = 10
	},
/obj/machinery/atmospherics/pipe/heat_exchanging/simple/layer4{
	dir = 10
	},
/obj/machinery/atmospherics/pipe/heat_exchanging/simple{
	dir = 10
	},
/obj/structure/lattice/catwalk,
/turf/open/space/basic,
/area/template_noop)
"id" = (
/obj/machinery/door/poddoor/shutters/radiation/preopen{
	id = "engsm";
	name = "Radiation Chamber Shutters"
	},
/obj/structure/cable{
	icon_state = "1-4"
	},
/obj/structure/cable{
	icon_state = "2-4"
	},
/obj/structure/cable{
	icon_state = "4-8"
	},
/obj/machinery/atmospherics/pipe/heat_exchanging/simple/layer4{
	dir = 4
	},
/obj/machinery/atmospherics/pipe/heat_exchanging/simple/layer2{
	dir = 4
	},
/obj/machinery/atmospherics/pipe/heat_exchanging/simple{
	dir = 4
	},
/turf/open/floor/plating/airless,
/area/template_noop)
"iK" = (
/obj/machinery/atmospherics/pipe/smart/manifold4w/cyan/visible,
/obj/machinery/light/small,
/obj/structure/lattice/catwalk,
/turf/open/space/basic,
/area/template_noop)
"iU" = (
/obj/machinery/power/rad_collector/anchored,
/obj/structure/window/plasma/reinforced{
	dir = 8
	},
/obj/item/tank/internals/plasma/full,
/obj/structure/cable{
	icon_state = "0-4"
	},
/obj/machinery/atmospherics/pipe/heat_exchanging/simple/layer4{
	dir = 4
	},
/obj/machinery/atmospherics/pipe/heat_exchanging/simple/layer2{
	dir = 4
	},
/obj/machinery/atmospherics/pipe/heat_exchanging/simple{
	dir = 4
	},
/turf/open/floor/circuit/green/airless,
/area/template_noop)
"jA" = (
/obj/machinery/portable_atmospherics/pump,
/turf/open/floor/engine/airless,
/area/template_noop)
"lS" = (
/obj/structure/lattice/catwalk,
/obj/machinery/atmospherics/components/unary/outlet_injector/on/layer4{
	dir = 8
	},
/turf/open/space/basic,
/area/template_noop)
"mf" = (
/obj/structure/cable{
	icon_state = "1-4"
	},
/obj/structure/lattice/catwalk,
/obj/machinery/atmospherics/pipe/heat_exchanging/manifold4w,
/obj/machinery/atmospherics/pipe/heat_exchanging/manifold4w/layer2,
/obj/machinery/atmospherics/pipe/heat_exchanging/manifold4w/layer4,
/turf/open/space/basic,
/area/template_noop)
"mE" = (
/obj/structure/lattice/catwalk,
/obj/machinery/atmospherics/components/unary/outlet_injector/on/layer2{
	dir = 4
	},
/turf/open/space/basic,
/area/template_noop)
"nQ" = (
/obj/machinery/atmospherics/pipe/smart/manifold4w/green/hidden/layer1,
/obj/machinery/atmospherics/pipe/smart/manifold4w/cyan/visible,
/turf/open/floor/engine/airless,
/area/template_noop)
"pg" = (
/obj/structure/cable{
	icon_state = "1-4"
	},
/turf/open/floor/plating/airless,
/area/template_noop)
"pW" = (
/obj/structure/table,
/obj/item/pipe_dispenser/debug,
/obj/item/clothing/glasses/meson/night,
/obj/item/storage/part_replacer/bluespace/tier4,
/turf/open/floor/engine/airless,
/area/template_noop)
"qK" = (
/obj/machinery/atmospherics/components/unary/portables_connector/visible,
/obj/machinery/portable_atmospherics/canister/plasma,
/turf/open/floor/engine/airless,
/area/template_noop)
"sv" = (
/obj/machinery/door/poddoor/shutters/radiation/preopen{
	id = "engsm";
	name = "Radiation Chamber Shutters"
	},
/obj/structure/cable{
	icon_state = "2-8"
	},
/turf/open/floor/plating/airless,
/area/template_noop)
"vd" = (
/obj/machinery/atmospherics/pipe/heat_exchanging/simple{
	dir = 6
	},
/obj/machinery/atmospherics/pipe/heat_exchanging/simple/layer2{
	dir = 6
	},
/obj/machinery/atmospherics/pipe/heat_exchanging/simple/layer4{
	dir = 6
	},
/obj/structure/lattice/catwalk,
/turf/open/space/basic,
/area/template_noop)
"vs" = (
/obj/structure/cable{
	icon_state = "4-8"
	},
/obj/structure/lattice/catwalk,
/obj/machinery/atmospherics/components/binary/pump{
	name = "CO2 to Engine"
	},
/turf/open/space/basic,
/area/template_noop)
"wi" = (
/obj/machinery/atmospherics/pipe/heat_exchanging/simple/layer4{
	dir = 4
	},
/obj/machinery/atmospherics/pipe/heat_exchanging/simple{
	dir = 4
	},
/obj/machinery/atmospherics/pipe/heat_exchanging/simple/layer2{
	dir = 4
	},
/obj/structure/lattice/catwalk,
/turf/open/space/basic,
/area/template_noop)
"ws" = (
/obj/structure/lattice/catwalk,
/obj/machinery/atmospherics/pipe/smart/manifold4w/purple/visible,
/turf/open/space/basic,
/area/template_noop)
"wA" = (
/obj/machinery/atmospherics/pipe/heat_exchanging/simple/layer4{
	dir = 5
	},
/obj/machinery/atmospherics/pipe/heat_exchanging/simple{
	dir = 5
	},
/obj/machinery/atmospherics/pipe/heat_exchanging/simple/layer2{
	dir = 5
	},
/obj/structure/lattice/catwalk,
/turf/open/space/basic,
/area/template_noop)
"xt" = (
/obj/machinery/atmospherics/miner/station/carbon_dioxide,
/obj/structure/window/plasma/reinforced{
	dir = 8
	},
/obj/structure/window/plasma/reinforced,
/obj/structure/window/plasma/reinforced{
	dir = 4
	},
/obj/structure/window/plasma/reinforced{
	dir = 1
	},
/obj/machinery/atmospherics/components/unary/vent_pump/siphon/monitored/carbon_output,
/turf/open/floor/engine/airless,
/area/template_noop)
"xE" = (
/obj/machinery/atmospherics/pipe/heat_exchanging/junction{
	dir = 8
	},
/obj/machinery/atmospherics/pipe/heat_exchanging/junction/layer2{
	dir = 8
	},
/obj/machinery/atmospherics/pipe/heat_exchanging/junction/layer4{
	dir = 8
	},
/obj/structure/cable{
	icon_state = "1-2"
	},
/obj/structure/lattice/catwalk,
/turf/open/space/basic,
/area/template_noop)
"xI" = (
/obj/machinery/portable_atmospherics/scrubber/huge/movable,
/turf/open/floor/engine/airless,
/area/template_noop)
"yb" = (
/obj/machinery/atmospherics/pipe/smart/manifold4w/green/hidden/layer1,
/obj/machinery/atmospherics/pipe/smart/manifold4w/scrubbers/hidden/layer5,
/obj/machinery/atmospherics/components/unary/vent_pump/on{
	dir = 1
	},
/turf/open/floor/engine/airless,
/area/template_noop)
"Aw" = (
/obj/machinery/atmospherics/pipe/layer_manifold/general/visible{
	dir = 4
	},
/turf/closed/wall/r_wall,
/area/template_noop)
"CL" = (
/obj/machinery/door/poddoor/shutters/radiation/preopen{
	id = "engsm";
	name = "Radiation Chamber Shutters"
	},
/obj/structure/cable{
	icon_state = "2-4"
	},
/turf/open/floor/plating/airless,
/area/template_noop)
"CN" = (
/obj/machinery/atmospherics/pipe/heat_exchanging/simple/layer4,
/obj/machinery/atmospherics/pipe/heat_exchanging/simple,
/obj/machinery/atmospherics/pipe/heat_exchanging/simple/layer2,
/obj/structure/lattice/catwalk,
/turf/open/space/basic,
/area/template_noop)
"Ex" = (
/obj/machinery/portable_atmospherics/canister/plasma,
/obj/machinery/atmospherics/pipe/smart/manifold4w/yellow/visible,
/turf/open/floor/engine/airless,
/area/template_noop)
"EN" = (
/obj/structure/cable{
	icon_state = "1-2"
	},
/obj/structure/lattice/catwalk,
/turf/open/space/basic,
/area/template_noop)
"ET" = (
/obj/structure/lattice/catwalk,
/obj/machinery/atmospherics/pipe/smart/manifold4w/yellow/visible,
/turf/open/space/basic,
/area/template_noop)
"Fa" = (
/obj/machinery/door/poddoor/shutters/radiation/preopen{
	id = "engsm";
	name = "Radiation Chamber Shutters"
	},
/obj/structure/cable{
	icon_state = "1-8"
	},
/turf/open/floor/plating/airless,
/area/template_noop)
"Fp" = (
/obj/machinery/door/airlock/engineering/glass/critical{
	heat_proof = 1;
	name = "Supermatter Chamber";
	req_access_txt = "10"
	},
/obj/effect/mapping_helpers/airlock/cyclelink_helper{
	dir = 1
	},
/obj/machinery/atmospherics/pipe/smart/manifold4w/green/hidden/layer1,
/obj/machinery/atmospherics/pipe/smart/manifold4w/cyan/visible,
/turf/open/floor/engine/airless,
/area/template_noop)
"Gy" = (
/obj/machinery/atmospherics/pipe/heat_exchanging/simple/layer4{
	dir = 9
	},
/obj/machinery/atmospherics/pipe/heat_exchanging/simple{
	dir = 9
	},
/obj/machinery/atmospherics/pipe/heat_exchanging/simple/layer2{
	dir = 9
	},
/obj/structure/lattice/catwalk,
/turf/open/space/basic,
/area/template_noop)
"GD" = (
/obj/machinery/atmospherics/components/unary/vent_scrubber/on/layer1{
	dir = 8
	},
/obj/machinery/atmospherics/pipe/heat_exchanging/simple/layer4{
	dir = 9
	},
/obj/machinery/atmospherics/pipe/heat_exchanging/simple/layer2{
	dir = 9
	},
/obj/machinery/atmospherics/pipe/heat_exchanging/simple{
	dir = 9
	},
/turf/open/floor/engine/airless,
/area/template_noop)
"Il" = (
/obj/machinery/atmospherics/components/unary/vent_scrubber/on/layer1{
	dir = 4
	},
/obj/machinery/atmospherics/pipe/heat_exchanging/simple/layer4{
	dir = 6
	},
/obj/machinery/atmospherics/pipe/heat_exchanging/simple{
	dir = 6
	},
/obj/machinery/atmospherics/pipe/heat_exchanging/simple/layer2{
	dir = 6
	},
/turf/open/floor/engine/airless,
/area/template_noop)
"Ip" = (
/obj/machinery/atmospherics/pipe/smart/manifold4w/cyan/visible,
/obj/machinery/atmospherics/pipe/smart/manifold4w/cyan/visible/layer2,
/obj/machinery/atmospherics/pipe/smart/manifold4w/cyan/visible/layer4,
/turf/open/floor/engine/airless,
/area/template_noop)
"Jq" = (
/obj/machinery/atmospherics/components/unary/vent_scrubber/on/layer1{
	dir = 8
	},
/obj/machinery/atmospherics/pipe/heat_exchanging/simple/layer4{
	dir = 10
	},
/obj/machinery/atmospherics/pipe/heat_exchanging/simple/layer2{
	dir = 10
	},
/obj/machinery/atmospherics/pipe/heat_exchanging/simple{
	dir = 10
	},
/turf/open/floor/engine/airless,
/area/template_noop)
"Ku" = (
/obj/machinery/atmospherics/components/unary/portables_connector/visible,
/obj/machinery/portable_atmospherics/canister/nitrogen,
/turf/open/floor/engine/airless,
/area/template_noop)
"KJ" = (
/obj/structure/cable{
	icon_state = "1-2"
	},
/obj/structure/cable{
	icon_state = "1-8"
	},
/obj/structure/lattice/catwalk,
/turf/open/space/basic,
/area/template_noop)
"Lh" = (
/obj/machinery/power/terminal{
	dir = 1
	},
/obj/structure/cable{
	icon_state = "0-2"
	},
/obj/machinery/atmospherics/pipe/smart/manifold4w/yellow/visible,
/turf/open/floor/engine/airless,
/area/template_noop)
"LC" = (
/obj/structure/closet/radiation,
/turf/open/floor/engine/airless,
/area/template_noop)
"LJ" = (
/obj/machinery/power/smes/engineering,
/turf/open/floor/engine/airless,
/area/template_noop)
"Me" = (
/obj/machinery/power/rad_collector/anchored,
/obj/structure/window/plasma/reinforced{
	dir = 4
	},
/obj/machinery/atmospherics/pipe/smart/manifold4w/green/visible,
/obj/item/tank/internals/plasma/full,
/obj/structure/cable{
	icon_state = "0-8"
	},
/turf/open/floor/circuit/green/airless,
/area/template_noop)
"MM" = (
/obj/structure/cable{
	icon_state = "4-8"
	},
/obj/structure/lattice/catwalk,
/turf/open/space/basic,
/area/template_noop)
"NM" = (
/obj/machinery/atmospherics/components/trinary/filter/critical{
	dir = 8
	},
/obj/machinery/atmospherics/pipe/smart/manifold4w/green/visible/layer2,
/obj/machinery/atmospherics/pipe/smart/manifold4w/green/visible/layer4,
/turf/open/floor/engine/airless,
/area/template_noop)
"NZ" = (
/obj/machinery/power/rad_collector/anchored,
/obj/structure/window/plasma/reinforced{
	dir = 8
	},
/obj/item/tank/internals/plasma/full,
/obj/structure/cable{
	icon_state = "0-4"
	},
/turf/open/floor/circuit/green/airless,
/area/template_noop)
"OH" = (
/obj/machinery/modular_computer/console/preset/engineering{
	dir = 4
	},
/turf/open/space/basic,
/area/template_noop)
"Pm" = (
/turf/open/floor/engine/airless,
/area/template_noop)
"Ps" = (
/obj/machinery/atmospherics/pipe/heat_exchanging/simple/layer4,
/obj/machinery/atmospherics/pipe/heat_exchanging/simple,
/obj/machinery/atmospherics/pipe/heat_exchanging/simple/layer2,
/obj/structure/lattice/catwalk,
/obj/machinery/atmospherics/pipe/heat_exchanging/junction/layer2{
	dir = 4
	},
/obj/machinery/atmospherics/pipe/heat_exchanging/junction/layer4{
	dir = 4
	},
/obj/machinery/atmospherics/pipe/heat_exchanging/junction{
	dir = 4
	},
/turf/open/space/basic,
/area/template_noop)
"Px" = (
/obj/machinery/atmospherics/components/unary/outlet_injector/on{
	dir = 1
	},
/obj/structure/lattice/catwalk,
/obj/machinery/atmospherics/pipe/smart/manifold4w/scrubbers/hidden/layer2,
/obj/machinery/atmospherics/pipe/smart/manifold4w/scrubbers/hidden/layer4,
/turf/open/space/basic,
/area/template_noop)
"PQ" = (
/obj/machinery/atmospherics/components/unary/portables_connector/visible,
/obj/machinery/portable_atmospherics/canister,
/turf/open/floor/engine/airless,
/area/template_noop)
"PR" = (
/obj/structure/cable{
	icon_state = "2-4"
	},
/obj/structure/lattice/catwalk,
/turf/open/space/basic,
/area/template_noop)
"RR" = (
/obj/machinery/shower{
	name = "emergency shower";
	pixel_y = 7
	},
/turf/open/floor/engine/airless,
/area/template_noop)
"Sh" = (
/obj/machinery/atmospherics/components/unary/thermomachine/freezer,
/turf/open/floor/engine/airless,
/area/template_noop)
"TL" = (
/obj/machinery/atmospherics/components/unary/vent_scrubber/on/layer5,
/obj/machinery/atmospherics/pipe/smart/manifold4w/green/hidden/layer1,
/obj/machinery/atmospherics/pipe/smart/manifold4w/cyan/visible,
/obj/machinery/atmospherics/pipe/heat_exchanging/simple{
	dir = 4
	},
/obj/machinery/atmospherics/pipe/heat_exchanging/simple/layer2{
	dir = 8
	},
/obj/machinery/atmospherics/pipe/heat_exchanging/simple/layer4{
	dir = 4
	},
/turf/open/floor/engine/airless,
/area/template_noop)
"Up" = (
/obj/machinery/power/rad_collector/anchored,
/obj/structure/window/plasma/reinforced{
	dir = 4
	},
/obj/item/tank/internals/plasma/full,
/obj/structure/cable{
	icon_state = "0-8"
	},
/obj/machinery/atmospherics/pipe/heat_exchanging/simple/layer4{
	dir = 4
	},
/obj/machinery/atmospherics/pipe/heat_exchanging/simple/layer2{
	dir = 4
	},
/obj/machinery/atmospherics/pipe/heat_exchanging/simple{
	dir = 4
	},
/turf/open/floor/circuit/green/airless,
/area/template_noop)
"UR" = (
/obj/structure/lattice/catwalk,
/obj/machinery/atmospherics/pipe/layer_manifold/general/visible,
/turf/open/space/basic,
/area/template_noop)
"VZ" = (
/turf/closed/wall/r_wall,
/area/template_noop)
"Wo" = (
/obj/machinery/atmospherics/components/unary/vent_scrubber/on/layer5{
	dir = 4
	},
/obj/machinery/atmospherics/pipe/heat_exchanging/manifold/layer2{
	dir = 4
	},
/obj/machinery/atmospherics/pipe/heat_exchanging/manifold{
	dir = 4
	},
/obj/machinery/atmospherics/pipe/heat_exchanging/manifold/layer4{
	dir = 4
	},
/turf/open/floor/engine/airless,
/area/template_noop)
"Ww" = (
/obj/machinery/power/rad_collector/anchored,
/obj/structure/window/plasma/reinforced{
	dir = 4
	},
/obj/item/tank/internals/plasma/full,
/obj/structure/cable{
	icon_state = "0-8"
	},
/turf/open/floor/circuit/green/airless,
/area/template_noop)
"Wx" = (
/obj/machinery/atmospherics/pipe/heat_exchanging/junction/layer4{
	dir = 4
	},
/obj/machinery/atmospherics/pipe/heat_exchanging/junction/layer2{
	dir = 4
	},
/obj/machinery/atmospherics/pipe/heat_exchanging/junction{
	dir = 4
	},
/obj/structure/cable{
	icon_state = "1-2"
	},
/obj/structure/lattice/catwalk,
/turf/open/space/basic,
/area/template_noop)
"YA" = (
/obj/machinery/door/airlock/engineering/glass/critical{
	heat_proof = 1;
	name = "Supermatter Chamber";
	req_access_txt = "10"
	},
/obj/effect/mapping_helpers/airlock/cyclelink_helper,
/obj/machinery/atmospherics/pipe/smart/manifold4w/cyan/visible,
/turf/open/floor/engine/airless,
/area/template_noop)

(1,1,1) = {"
pW
OH
Sh
ah
ws
ws
UR
cd
ap
ap
ap
ap
"}
(2,1,1) = {"
RR
Pm
qK
ah
vd
CN
CN
Ps
CN
CN
CN
wA
"}
(3,1,1) = {"
ap
ap
PR
EN
xE
EN
dN
mf
CN
ap
ap
wi
"}
(4,1,1) = {"
ap
ap
MM
PQ
NM
VZ
CL
cX
pg
VZ
ap
wi
"}
(5,1,1) = {"
LC
ap
MM
VZ
Aw
VZ
Ww
Up
Me
VZ
ap
wi
"}
(6,1,1) = {"
LC
ap
MM
VZ
ff
VZ
Il
Wo
gv
VZ
mE
wi
"}
(7,1,1) = {"
ap
ET
vs
YA
nQ
Fp
TL
yb
fZ
dP
Px
wi
"}
(8,1,1) = {"
ap
ET
MM
VZ
iK
VZ
Jq
cn
GD
VZ
lS
wi
"}
(9,1,1) = {"
xI
ET
MM
VZ
Aw
VZ
NZ
iU
NZ
VZ
ap
wi
"}
(10,1,1) = {"
jA
ET
MM
Ku
Ip
VZ
sv
id
Fa
VZ
ap
wi
"}
(11,1,1) = {"
LJ
Lh
KJ
EN
Wx
EN
dN
fi
CN
ap
ap
wi
"}
(12,1,1) = {"
xt
Ex
ap
ap
hf
CN
CN
CN
CN
CN
CN
Gy
"}
