//MAP CONVERTED BY dmm2tgm.py THIS HEADER COMMENT PREVENTS RECONVERSION, DO NOT REMOVE
"a" = (
/turf/open/floor/engine,
/area/template_noop)
"f" = (
/obj/machinery/atmospherics/components/unary/outlet_injector/on{
	dir = 8
	},
/turf/open/floor/engine,
/area/template_noop)
"i" = (
/obj/machinery/door/airlock/engineering/glass/critical{
	name = "Fusion Airlock"
	},
/obj/structure/holosign/barrier/atmos/robust,
/turf/open/floor/engine,
/area/template_noop)
"j" = (
/obj/structure/window/depleteduranium{
	dir = 4
	},
/obj/machinery/atmospherics/components/trinary/mixer{
	dir = 4
	},
/turf/open/floor/engine,
/area/template_noop)
"s" = (
/obj/machinery/atmospherics/pipe/smart/manifold4w/general/visible,
/turf/open/floor/engine,
/area/template_noop)
"w" = (
/obj/machinery/door/airlock/engineering/glass/critical{
	name = "Tritium Airlock"
	},
/obj/structure/holosign/barrier/atmos/robust,
/turf/open/floor/engine,
/area/template_noop)
"y" = (
/obj/structure/window/depleteduranium{
	dir = 1
	},
/turf/open/floor/engine,
/area/template_noop)
"z" = (
/obj/machinery/atmospherics/pipe/smart/manifold4w/dark/visible,
/turf/open/floor/engine,
/area/template_noop)
"E" = (
/obj/machinery/atmospherics/pipe/smart/manifold4w/purple/visible,
/turf/open/floor/engine,
/area/template_noop)
"F" = (
/obj/structure/window/plasma/reinforced{
	dir = 8
	},
/obj/structure/window/plasma/reinforced{
	dir = 1
	},
/obj/structure/window/plasma/reinforced,
/obj/structure/window/plasma/reinforced{
	dir = 4
	},
/obj/machinery/atmospherics/components/unary/vent_scrubber/on{
	dir = 4
	},
/obj/machinery/atmospherics/miner/oxygen,
/obj/machinery/portable_atmospherics/canister/oxygen,
/turf/open/floor/engine,
/area/template_noop)
"K" = (
/obj/structure/window/plasma/reinforced{
	dir = 8
	},
/obj/structure/window/plasma/reinforced{
	dir = 1
	},
/obj/structure/window/plasma/reinforced,
/obj/structure/window/plasma/reinforced{
	dir = 4
	},
/obj/machinery/atmospherics/components/unary/vent_scrubber/on{
	dir = 4
	},
/obj/machinery/atmospherics/miner/plasma,
/obj/machinery/portable_atmospherics/canister/plasma,
/turf/open/floor/engine,
/area/template_noop)
"L" = (
/obj/machinery/portable_atmospherics/canister/tritium,
/turf/open/floor/engine,
/area/template_noop)
"M" = (
/obj/machinery/portable_atmospherics/canister/fusion_test,
/turf/open/floor/engine,
/area/template_noop)
"N" = (
/obj/machinery/atmospherics/pipe/smart/manifold4w/cyan/visible,
/turf/open/floor/engine,
/area/template_noop)
"O" = (
/obj/structure/window/depleteduranium{
	dir = 8
	},
/turf/open/floor/engine,
/area/template_noop)
"R" = (
/obj/machinery/atmospherics/components/unary/vent_scrubber/on{
	dir = 8
	},
/turf/open/floor/engine,
/area/template_noop)
"S" = (
/obj/structure/window/depleteduranium{
	dir = 4
	},
/turf/open/floor/engine,
/area/template_noop)
"T" = (
/obj/machinery/atmospherics/components/trinary/mixer{
	dir = 4
	},
/turf/open/floor/engine,
/area/template_noop)
"V" = (
/obj/structure/window/plasma/reinforced{
	dir = 8
	},
/obj/structure/window/plasma/reinforced{
	dir = 1
	},
/obj/structure/window/plasma/reinforced,
/obj/structure/window/plasma/reinforced{
	dir = 4
	},
/obj/machinery/atmospherics/components/unary/vent_scrubber/on{
	dir = 4
	},
/obj/machinery/atmospherics/miner/carbon_dioxide,
/obj/machinery/portable_atmospherics/canister/carbon_dioxide,
/turf/open/floor/engine,
/area/template_noop)
"W" = (
/obj/structure/window/depleteduranium{
	dir = 4
	},
/obj/machinery/atmospherics/pipe/smart/manifold4w/general/visible,
/turf/open/floor/engine,
/area/template_noop)
"Z" = (
/obj/structure/window/depleteduranium,
/turf/open/floor/engine,
/area/template_noop)

(1,1,1) = {"
a
a
K
E
V
a
a
K
E
F
a
a
"}
(2,1,1) = {"
a
a
a
T
z
a
a
a
T
N
a
a
"}
(3,1,1) = {"
a
a
S
j
W
s
s
W
W
S
a
a
"}
(4,1,1) = {"
a
Z
R
f
R
y
Z
R
f
R
y
a
"}
(5,1,1) = {"
a
a
O
i
O
a
a
O
w
O
a
a
"}
(6,1,1) = {"
a
a
a
M
a
a
a
a
L
a
a
a
"}
(7,1,1) = {"
a
a
a
a
a
a
a
a
a
a
a
a
"}
(8,1,1) = {"
a
a
a
a
a
a
a
a
a
a
a
a
"}
(9,1,1) = {"
a
a
a
a
a
a
a
a
a
a
a
a
"}
(10,1,1) = {"
a
a
a
a
a
a
a
a
a
a
a
a
"}
(11,1,1) = {"
a
a
a
a
a
a
a
a
a
a
a
a
"}
(12,1,1) = {"
a
a
a
a
a
a
a
a
a
a
a
a
"}
