//MAP CONVERTED BY dmm2tgm.py THIS HEADER COMMENT PREVENTS RECONVERSION, DO NOT REMOVE
"a" = (
/mob/living/simple_animal/hostile/syndicate/heavy,
/turf/open/floor/holofloor/dark,
/area/template_noop)
"c" = (
/obj/effect/turf_decal/tile/dark_red/anticorner_ramp/contrasted,
/mob/living/simple_animal/hostile/syndicate/heavy,
/turf/open/floor/holofloor/dark,
/area/template_noop)
"k" = (
/obj/effect/turf_decal/tile/dark_red/anticorner_ramp/contrasted{
	dir = 8
	},
/mob/living/simple_animal/hostile/syndicate/heavy,
/turf/open/floor/holofloor/dark,
/area/template_noop)
"q" = (
/obj/effect/turf_decal/tile/dark_red/anticorner_ramp/contrasted{
	dir = 4
	},
/mob/living/simple_animal/hostile/syndicate/heavy,
/turf/open/floor/holofloor/dark,
/area/template_noop)
"C" = (
/obj/effect/turf_decal/tile/dark_red/anticorner_ramp/contrasted{
	dir = 1
	},
/mob/living/simple_animal/hostile/syndicate/heavy,
/turf/open/floor/holofloor/dark,
/area/template_noop)
"K" = (
/obj/effect/turf_decal/tile/dark_red/fourcorners/contrasted,
/mob/living/simple_animal/hostile/syndicate/heavy,
/turf/open/floor/holofloor/dark,
/area/template_noop)

(1,1,1) = {"
a
a
a
a
a
a
a
a
a
a
a
a
"}
(2,1,1) = {"
a
a
a
a
a
a
a
a
a
a
a
a
"}
(3,1,1) = {"
a
a
a
K
K
K
K
K
K
a
a
a
"}
(4,1,1) = {"
a
a
a
C
a
a
a
a
k
a
a
a
"}
(5,1,1) = {"
a
a
a
a
K
q
a
q
a
a
a
a
"}
(6,1,1) = {"
a
a
a
a
K
K
q
K
a
a
a
a
"}
(7,1,1) = {"
a
a
a
a
K
k
K
K
a
a
a
a
"}
(8,1,1) = {"
a
a
a
a
k
a
k
K
a
a
a
a
"}
(9,1,1) = {"
a
a
a
q
a
a
a
a
c
a
a
a
"}
(10,1,1) = {"
a
a
a
K
K
K
K
K
K
a
a
a
"}
(11,1,1) = {"
a
a
a
a
a
a
a
a
a
a
a
a
"}
(12,1,1) = {"
a
a
a
a
a
a
a
a
a
a
a
a
"}
